# id = AmrShtk.1
jyA	jyA	pos=n,comp=y
kfzwi	kfzwi	pos=n,comp=y
badDa	banD	pos=va,comp=y,f=part
KawakA	KawakA	pos=n,comp=y
muKa	muKa	pos=n,comp=y
pARi	pARi	pos=n,comp=y
pfzWa	pfzWa	pos=n,comp=y
preNKat	preNK	pos=va,comp=y,f=part
naKa	naKa	pos=n,comp=y
aMSu	aMSu	pos=n,comp=y
caya	caya	pos=n,comp=y
saMvalitaH	saMval	pos=va,g=m,c=1,n=s,f=part
'mbikAyAH	ambikA	pos=n,g=f,c=6,n=s
tvAm	tvad	pos=n,g=,c=2,n=s
pAtu	pA	pos=v,p=3,n=s,l=lot
maYjarita	maYjarita	pos=a,comp=y
pallava	pallava	pos=n,comp=y
karRapUra	karRapUra	pos=n,comp=y
loBa	loBa	pos=n,comp=y
Bramat	Bram	pos=va,comp=y,f=part
Bramara	Bramara	pos=n,comp=y
viBrama	viBrama	pos=n,comp=y
Bft	Bft	pos=a,g=m,c=1,n=s
kawAkzaH	kawAkza	pos=n,g=m,c=1,n=s

# id = AmrShtk.2
kzipto	kzip	pos=va,g=m,c=1,n=s,f=part
hasta	hasta	pos=n,comp=y
avalagnaH	avalag	pos=va,g=m,c=1,n=s,f=part
prasaBam	prasaBam	pos=i
aBihato	aBihan	pos=va,g=m,c=1,n=s,f=part
'py	api	pos=i
AdadAno	AdA	pos=va,g=m,c=1,n=s,f=part
aMSuka	aMSuka	pos=n,comp=y
antam	anta	pos=n,g=m,c=2,n=s
gfhRan	grah	pos=va,g=m,c=1,n=s,f=part
keSezu	keSa	pos=n,g=m,c=7,n=p
apAstaH	apAs	pos=va,g=m,c=1,n=s,f=part
caraRa	caraRa	pos=n,comp=y
nipatitaH	nipat	pos=va,g=m,c=1,n=s,f=part
na	na	pos=i
IkzitaH	Ikz	pos=va,g=m,c=1,n=s,f=part
samBrameRa	samBrama	pos=n,g=m,c=3,n=s
AliNgan	AliNg	pos=va,g=m,c=1,n=s,f=part
yo	yad	pos=n,g=m,c=1,n=s
'vaDUtas	avaDU	pos=va,g=m,c=1,n=s,f=part
tripura	tripura	pos=n,comp=y
yuvatiBiH	yuvati	pos=n,g=f,c=3,n=p
sa	sa	pos=i
aSru	aSru	pos=n,comp=y
netra	netra	pos=n,comp=y
utpalABiH	utpala	pos=n,g=f,c=3,n=p
kAmI	kAmin	pos=n,g=m,c=1,n=s
iva	iva	pos=i
Ardra	Ardra	pos=a,comp=y
aparADaH	aparADa	pos=n,g=m,c=1,n=s
sa	tad	pos=n,g=m,c=1,n=s
dahatu	dah	pos=v,p=3,n=s,l=lot
duritam	durita	pos=n,g=n,c=2,n=s
SAmBavo	SAmBava	pos=a,g=m,c=1,n=s
vaH	tvad	pos=n,g=,c=6,n=p
Sara	Sara	pos=n,comp=y
agniH	agni	pos=n,g=m,c=1,n=s

# id = AmrShtk.3
AlolAm	Alola	pos=a,g=f,c=2,n=s
alaka	alaka	pos=n,comp=y
AvalIm	Avali	pos=n,g=f,c=2,n=s
vilulitAm	vilul	pos=va,g=f,c=2,n=s,f=part
Bf	Bf	ERR: va, Tense=Pres|VerbForm=Part
cal	cal	ERR: va, Tense=Pres|VerbForm=Part
kuRqalam	kuRqala	pos=n,g=n,c=2,n=s
kiMcin	kaScit	pos=n,g=n,c=2,n=s
mfzwa	mfj	pos=va,comp=y,f=part
viSezakam	viSezaka	pos=n,g=n,c=2,n=s
tanutarEH	tanutara	pos=a,g=m,c=3,n=p
Keda	Keda	pos=n,comp=y
amBasAm	amBas	pos=n,g=n,c=6,n=p
SIkarEH	SIkara	pos=n,g=m,c=3,n=p
tanvyA	tanvI	pos=n,g=f,c=6,n=s
yat	yad	pos=n,g=n,c=1,n=s
surata	surata	pos=n,comp=y
anta	anta	pos=n,comp=y
tam	tam	pos=va,comp=y,f=part
nayanam	nayana	pos=n,g=n,c=1,n=s
vaktram	vaktra	pos=n,g=n,c=1,n=s
rati	rati	pos=n,comp=y
vyatyaye	vyatyaya	pos=n,g=m,c=7,n=s
tat	tad	pos=n,g=n,c=1,n=s
tvA	tvad	pos=n,g=,c=2,n=s
pAtu	pA	pos=v,p=3,n=s,l=lot
cirAya	cira	pos=a,g=n,c=4,n=s
kim	ka	pos=n,g=n,c=1,n=s
hari	hari	pos=n,comp=y
hara	hara	pos=n,comp=y
brahma	brahman	pos=n,comp=y
AdiBiH	Adi	pos=n,g=n,c=3,n=p
dEvatEH	dEvata	pos=n,g=n,c=3,n=p

# id = AmrShtk.4
alasa	alasa	pos=a,comp=y
valitEH	val	pos=va,g=n,c=3,n=p,f=part
prema	preman	pos=n,comp=y
Ardra	Ardra	pos=a,comp=y
ArdrEH	Ardra	pos=a,g=n,c=3,n=p
muhuH	muhur	pos=i
mukulIkftEH	mukulIkfta	pos=a,g=n,c=3,n=p
kzaRam	kzaRa	pos=n,g=m,c=2,n=s
aBimuKEH	aBimuKa	pos=a,g=n,c=3,n=p
lajjA	lajjA	pos=n,comp=y
lolEH	lola	pos=a,g=n,c=3,n=p
nimeza	nimeza	pos=n,comp=y
parANmuKEH	parANmuKa	pos=a,g=n,c=3,n=p
hfdaya	hfdaya	pos=n,comp=y
nihitam	niDA	pos=va,g=n,c=2,n=s,f=part
BAvAkUtam	BAvAkUta	pos=n,g=n,c=2,n=s
vam	vam	pos=va,g=n,c=3,n=p,f=part
iva	iva	pos=i
IkzaREH	IkzaRa	pos=n,g=n,c=3,n=p
kaTaya	kaTay	pos=v,p=2,n=s,l=lot
sukftI	sukftin	pos=a,g=m,c=1,n=s
ko	ka	pos=n,g=m,c=1,n=s
'yam	idam	pos=n,g=m,c=1,n=s
mugDe	muh	pos=va,g=f,c=8,n=s,f=part
tvayA	tvad	pos=n,g=,c=3,n=s
adya	adya	pos=i
vilokyate	vilokay	pos=v,p=3,n=s,l=lat

# id = AmrShtk.5
dattaH	dA	pos=va,g=m,c=1,n=s,f=part
asyAH	idam	pos=n,g=f,c=6,n=s
praRayaH	praRaya	pos=n,g=m,c=1,n=s
tvayA	tvad	pos=n,g=,c=3,n=s
eva	eva	pos=i
BavatA	Bavat	pos=a,g=m,c=3,n=s
ca	ca	pos=i
iyam	idam	pos=n,g=f,c=1,n=s
ciram	ciram	pos=i
lAlitA	lAlay	pos=va,g=f,c=1,n=s,f=part
dEvAd	dEva	pos=n,g=n,c=5,n=s
adya	adya	pos=i
kila	kila	pos=i
tvam	tvad	pos=n,g=,c=1,n=s
eva	eva	pos=i
kftavAn	kf	pos=va,g=m,c=1,n=s,f=part
asyA	idam	pos=n,g=f,c=6,n=s
navam	nava	pos=a,g=n,c=2,n=s
vipriyam	vipriya	pos=n,g=n,c=2,n=s
manyuH	manyu	pos=n,g=m,c=1,n=s
duHsahaH	duHsaha	pos=a,g=m,c=1,n=s
eza	etad	pos=n,g=m,c=1,n=s
yAti	yA	pos=v,p=3,n=s,l=lat
upaSamam	upaSama	pos=n,g=m,c=2,n=s
no	no	pos=i
sAntva	sAntva	pos=n,comp=y
vAdAH	vAda	pos=n,g=m,c=1,n=p
sPuwam	sPuwa	pos=a,g=n,c=1,n=s
he	he	pos=i
nistraMSa	nistraMSa	pos=a,g=m,c=8,n=s
vimukta	vimuc	pos=va,comp=y,f=part
kaRWa	kaRWa	pos=n,comp=y
karuRam	karuRa	pos=n,g=n,c=1,n=s
tAvat	tAvat	pos=i
saKI	saKI	pos=n,g=f,c=1,n=s
roditu	rud	pos=v,p=3,n=s,l=lot

# id = AmrShtk.6
liKamAnaH	liK	pos=va,g=m,c=1,n=s,f=part
na	na	pos=i
Aste	As	pos=v,p=3,n=s,l=lat
BUmim	BUmi	pos=n,g=f,c=2,n=s
bahis	bahis	pos=i
avanataH	avanam	pos=va,g=m,c=1,n=s,f=part
prARadayito	prARadayita	pos=n,g=m,c=1,n=s
nirAhArAH	nirAhAra	pos=a,g=m,c=1,n=p
saKyaH	saKI	pos=n,g=f,c=1,n=p
satata	satata	pos=a,comp=y
rudita	rudita	pos=n,comp=y
ucCUna	ucCUna	pos=a,comp=y
nayana	nayana	pos=n,g=f,c=1,n=p
parityaktam	parityaj	pos=va,g=n,c=1,n=s,f=part
sarvam	sarva	pos=n,g=n,c=1,n=s
hasita	hasita	pos=n,comp=y
paWitam	paW	pos=va,g=n,c=1,n=s,f=part
paYjara	paYjara	pos=n,comp=y
SukEH	Suka	pos=n,g=m,c=3,n=p
te	tvad	pos=n,g=,c=6,n=s
avasTA	avasTA	pos=n,g=f,c=1,n=s
ca	ca	pos=i
iyam	idam	pos=n,g=f,c=1,n=s
visfja	visfj	pos=v,p=2,n=s,l=lot
kaWine	kaWina	pos=a,g=f,c=8,n=s
mAna	mAna	pos=n,comp=y
maDunA	maDu	pos=n,g=n,c=3,n=s

# id = AmrShtk.7
nAryaH	nArI	pos=n,g=f,c=1,n=p
tanvi	tanvI	pos=n,g=f,c=8,n=s
haWAt	haWa	pos=n,g=m,c=5,n=s
haranti	hf	pos=v,p=3,n=p,l=lat
ramaRam	ramaRa	pos=n,g=m,c=2,n=s
tizWanti	sTA	pos=v,p=3,n=p,l=lat
no	no	pos=i
vAritAs	vAray	pos=va,g=f,c=1,n=p,f=part
tat	tad	pos=n,g=n,c=2,n=s
kim	ka	pos=n,g=n,c=2,n=s
tAmyasi	tam	pos=v,p=2,n=s,l=lat
kim	ka	pos=n,g=n,c=2,n=s
ca	ca	pos=i
rodizi	rud	pos=v,p=2,n=s,l=lat
muDA	muDA	pos=i
tAsAm	tad	pos=n,g=f,c=6,n=p
priyam	priya	pos=n,g=n,c=2,n=s
mA	mA	pos=i
kfTAH	kf	pos=v,p=2,n=s,l=lun_unaug
kAntaH	kAnta	pos=n,g=m,c=1,n=s
keli	keli	pos=n,comp=y
ruci	ruci	pos=a,g=m,c=1,n=s
yuvA	yuvan	pos=n,g=m,c=1,n=s
sahfdayaH	sahfdaya	pos=a,g=m,c=1,n=s
tAdfH	tAdfS	pos=a,g=m,c=1,n=s
patiH	pati	pos=n,g=m,c=1,n=s
kAtare	kAtara	pos=a,g=f,c=8,n=s
kim	ka	pos=n,g=n,c=2,n=s
no	no	pos=i
barkarakarkarEH	barkarakarkara	pos=a,g=n,c=3,n=p
priya	priya	pos=n,comp=y
SatEH	Sata	pos=n,g=n,c=3,n=p
Akramya	Akram	pos=vi
vikrIyate	vikrI	pos=v,p=3,n=s,l=lat

# id = AmrShtk.8
kopAt	kopa	pos=n,g=m,c=5,n=s
komala	komala	pos=a,comp=y
lola	lola	pos=a,comp=y
bAhu	bAhu	pos=n,comp=y
latikA	latikA	pos=n,comp=y
pASena	pASa	pos=n,g=m,c=3,n=s
badDA	banD	pos=va,g=f,c=1,n=s,f=part
dfQam	dfQa	pos=a,g=n,c=2,n=s
nItvA	nI	pos=vi
keli	keli	pos=n,comp=y
niketanam	niketana	pos=n,g=n,c=2,n=s
dayitayA	dayitA	pos=n,g=f,c=3,n=s
sAyam	sAya	pos=n,g=n,c=2,n=s
saKInAm	saKI	pos=n,g=f,c=6,n=p
puraH	puras	pos=i
BUyaH	BUyas	pos=a,g=n,c=1,n=s
api	api	pos=i
evam	evam	pos=i
iti	iti	pos=i
sKalan	sKal	pos=va,g=m,c=1,n=s,f=part
mfdu	mfdu	pos=a,comp=y
girA	gir	pos=n,g=f,c=3,n=s
saMsUcya	saMsUcay	pos=vi
duScezwitam	duScezwita	pos=n,g=n,c=2,n=s
Danyo	Danya	pos=a,g=m,c=1,n=s
hanyata	han	pos=v,p=3,n=s,l=lat
eva	eva	pos=i
nihnuti	nihnuti	pos=n,comp=y
paraH	para	pos=n,g=m,c=1,n=s
preyAn	preyas	pos=a,g=m,c=1,n=s
rudatyA	rud	pos=va,g=f,c=3,n=s,f=part
hasan	has	pos=va,g=m,c=1,n=s,f=part

# id = AmrShtk.9
prahara	prahara	pos=n,comp=y
viratO	virati	pos=n,g=f,c=7,n=s
maDye	maDya	pos=n,g=n,c=7,n=s
vA	vA	pos=i
ahaH	ahar	pos=n,g=,c=6,n=s
tatas	tatas	pos=i
api	api	pos=i
pare	para	pos=n,g=m,c=1,n=p
aTavA	aTavA	pos=i
kim	ka	pos=n,g=n,c=1,n=s
uta	uta	pos=i
sakale	sakala	pos=a,g=n,c=7,n=s
jAte	jan	pos=va,g=n,c=7,n=s,f=part
vA	vA	pos=i
ahani	ahar	pos=n,g=n,c=7,n=s
priya	priya	pos=a,g=m,c=8,n=s
tvam	tvad	pos=n,g=,c=1,n=s
iha	iha	pos=i
ezyasi	i	pos=v,p=2,n=s,l=lrt
iti	iti	pos=i
dina	dina	pos=n,comp=y
Sata	Sata	pos=n,comp=y
prApyam	prAp	pos=va,g=m,c=2,n=s,f=krtya
deSam	deSa	pos=n,g=m,c=2,n=s
priyasya	priya	pos=a,g=m,c=6,n=s
yiyAsato	yiyAs	pos=va,g=m,c=6,n=s,f=part
harati	hf	pos=v,p=3,n=s,l=lat
gamanam	gamana	pos=n,g=n,c=2,n=s
bAla	bAla	pos=a,comp=y
AlApEH	AlApa	pos=n,g=m,c=3,n=p
sa	sa	pos=i
bAzpa	bAzpa	pos=n,comp=y
gal	gal	pos=va,comp=y,f=part
jalEH	jala	pos=n,g=m,c=3,n=p

# id = AmrShtk.10
yAtAH	yA	pos=va,g=m,c=1,n=p,f=part
kim	ka	pos=n,g=n,c=2,n=s
na	na	pos=i
milanti	mil	pos=v,p=3,n=p,l=lat
sundari	sundarI	pos=n,g=f,c=8,n=s
punaH	punar	pos=i
cintA	cintA	pos=n,g=f,c=1,n=s
tvayA	tvad	pos=n,g=,c=3,n=s
mad	mad	pos=n,comp=y
kfte	kf	pos=va,g=n,c=7,n=s,f=part
no	no	pos=i
kAryA	kf	pos=va,g=f,c=1,n=s,f=krtya
nitarAm	nitarAm	pos=i
kfSAmi	kfS	pos=v,p=1,n=s,l=lat
kaTayati	kaTay	pos=v,p=3,n=s,l=lat
evam	evam	pos=i
sa	sa	pos=i
bAzpe	bAzpa	pos=n,g=m,c=7,n=s
mayi	mad	pos=n,g=,c=7,n=s
lajjA	lajjA	pos=n,comp=y
manTara	manTara	pos=a,comp=y
tArakena	tAraka	pos=n,g=n,c=3,n=s
nipat	nipat	pos=va,comp=y,f=part
DAra	DArA	pos=n,comp=y
aSru	aSru	pos=n,g=n,c=3,n=s
cakzuzA	cakzus	pos=n,g=n,c=3,n=s
dfzwvA	dfS	pos=vi
mAm	mad	pos=n,g=,c=2,n=s
hasitena	hasita	pos=n,g=n,c=3,n=s
BAvi	BAvin	pos=a,comp=y
maraRa	maraRa	pos=n,comp=y
utsAhaH	utsAha	pos=n,g=m,c=1,n=s
tayA	tad	pos=n,g=f,c=3,n=s
sUcitaH	sUcay	pos=va,g=m,c=1,n=s,f=part

# id = AmrShtk.11
DIram	DIra	pos=a,g=m,c=2,n=s
vAriDarasya	vAriDara	pos=n,g=m,c=6,n=s
vAri	vAri	pos=n,g=n,c=2,n=s
kirataH	kf	pos=va,g=m,c=6,n=s,f=part
SrutvA	Sru	pos=vi
niSITe	niSITa	pos=n,g=m,c=7,n=s
Dvanim	Dvani	pos=n,g=m,c=2,n=s
dIrGa	dIrGa	pos=a,comp=y
ucCvAsam	ucCvAsa	pos=n,g=m,c=2,n=s
udaSrunA	udaSru	pos=a,g=m,c=3,n=s
virahiRIm	virahin	pos=a,g=f,c=2,n=s
bAlAm	bAla	pos=a,g=f,c=2,n=s
ciram	ciram	pos=i
DyAyatA	DyA	pos=va,g=m,c=3,n=s,f=part
aDvanyena	aDvanya	pos=n,g=m,c=3,n=s
vimukta	vimuc	pos=va,comp=y,f=part
kaRWam	kaRWa	pos=n,g=m,c=2,n=s
aKilAm	aKila	pos=a,g=f,c=2,n=s
rAtrim	rAtri	pos=n,g=f,c=2,n=s
taTA	taTA	pos=i
kranditam	krand	pos=va,g=n,c=1,n=s,f=part
grAmIREH	grAmIRa	pos=a,g=m,c=3,n=p
vraj	vraj	pos=va,g=m,c=6,n=s,f=part
janasya	jana	pos=n,g=m,c=6,n=s
vasatiH	vasati	pos=n,g=f,c=1,n=s
grAme	grAma	pos=n,g=m,c=7,n=s
nizidDA	niziD	pos=va,g=f,c=1,n=s,f=part
yaTA	yaTA	pos=i

# id = AmrShtk.12
kaTam	kaTam	pos=i
api	api	pos=i
saKi	saKI	pos=n,g=f,c=8,n=s
krIqA	krIqA	pos=n,comp=y
kopAt	kopa	pos=n,g=m,c=5,n=s
vraja	vraj	pos=v,p=2,n=s,l=lot
iti	iti	pos=i
mayA	mad	pos=n,g=,c=3,n=s
udite	vad	pos=va,g=n,c=7,n=s,f=part
kaWina	kaWina	pos=a,comp=y
hfdayaH	hfdaya	pos=n,g=m,c=1,n=s
tyaktvA	tyaj	pos=vi
SayyAm	SayyA	pos=n,g=f,c=2,n=s
balAd	bala	pos=n,g=n,c=5,n=s
gata	gam	pos=va,g=m,c=1,n=s,f=part
eva	eva	pos=i
saH	tad	pos=n,g=m,c=1,n=s
iti	iti	pos=i
saraBasam	saraBasa	pos=a,g=n,c=2,n=s
Dvasta	DvaMs	pos=va,comp=y,f=part
preman	preman	pos=n,g=,c=7,n=s
vyapeta	vyape	pos=va,comp=y,f=part
GfRe	GfRA	pos=n,g=m,c=7,n=s
jane	jan	pos=v,p=1,n=s,l=lat
punaH	punar	pos=i
api	api	pos=i
hatavrIqam	hatavrIqa	pos=a,g=n,c=1,n=s
cetaH	cetas	pos=n,g=n,c=1,n=s
prayAti	prayA	pos=v,p=3,n=s,l=lat
karomi	kf	pos=v,p=1,n=s,l=lat
kim	ka	pos=n,g=n,c=2,n=s

# id = AmrShtk.13
dampatyoH	dampati	pos=n,g=m,c=6,n=d
niSi	niS	pos=n,g=f,c=7,n=s
jalp	jalp	pos=va,g=m,c=6,n=d,f=part
gfhaSukena	gfhaSuka	pos=n,g=m,c=3,n=s
AkarRitam	AkarRay	pos=va,g=n,c=1,n=s,f=part
yat	yad	pos=n,g=n,c=1,n=s
vacaH	vacas	pos=n,g=n,c=1,n=s
tat	tad	pos=n,g=n,c=2,n=s
prAtaH	prAtar	pos=i
guru	guru	pos=n,comp=y
saMniDO	saMniDi	pos=n,g=m,c=7,n=s
nigad	nigad	pos=va,g=m,c=6,n=s,f=part
tasya	tad	pos=n,g=m,c=6,n=s
upahAram	upahAra	pos=n,g=m,c=2,n=s
vaDUH	vaDU	pos=n,g=f,c=1,n=s
karRAlaMkfti	karRAlaMkfti	pos=n,comp=y
padmarAga	padmarAga	pos=n,comp=y
Sakalam	Sakala	pos=n,g=n,c=1,n=s
vinyasya	vinyas	pos=vi
caYcU	caYcU	pos=n,comp=y
puwe	puwa	pos=n,g=m,c=7,n=s
vrIqA	vrIqA	pos=n,comp=y
ArtA	Arta	pos=a,g=f,c=1,n=s
prakaroti	prakf	pos=v,p=3,n=s,l=lat
dAqima	dAqima	pos=n,comp=y
Pala	Pala	pos=n,comp=y
vyAjena	vyAja	pos=n,g=m,c=3,n=s
vAgbanDanam	vAgbanDana	pos=n,g=n,c=2,n=s

# id = AmrShtk.14
ajYAnena	ajYAna	pos=n,g=n,c=3,n=s
parANmuKIm	parANmuKa	pos=a,g=f,c=2,n=s
pariBavAd	pariBava	pos=n,g=m,c=5,n=s
ASlizya	ASliz	pos=vi
mAm	mad	pos=n,g=,c=2,n=s
duHKitAm	duHKita	pos=a,g=f,c=2,n=s
kim	ka	pos=n,g=n,c=1,n=s
labDam	laB	pos=va,g=n,c=1,n=s,f=part
cawula	cawula	pos=a,g=m,c=8,n=s
tvayA	tvad	pos=n,g=,c=3,n=s
iha	iha	pos=i
nayatA	nI	pos=va,g=m,c=3,n=s,f=part
sOBAgyam	sOBAgya	pos=n,g=n,c=2,n=s
etAm	etad	pos=n,g=f,c=2,n=s
daSAm	daSA	pos=n,g=f,c=2,n=s
paSya	paS	pos=v,p=2,n=s,l=lot
etat	etad	pos=n,g=n,c=2,n=s
dayitA	dayitA	pos=n,comp=y
kuca	kuca	pos=n,comp=y
vyatikara	vyatikara	pos=n,comp=y
unmfH	unmfS	pos=va,comp=y,f=part
aNgarAga	aNgarAga	pos=n,comp=y
aruRam	aruRa	pos=a,g=n,c=2,n=s
vakzaH	vakzas	pos=n,g=n,c=2,n=s
te	tvad	pos=n,g=,c=6,n=s
mala	mala	pos=n,comp=y
tEla	tEla	pos=n,comp=y
paNka	paNka	pos=n,comp=y
SabalEH	Sabala	pos=a,g=m,c=3,n=p
veRI	veRI	pos=n,comp=y
padEH	pada	pos=n,g=m,c=3,n=p
aNkitam	aNkay	pos=va,g=n,c=2,n=s,f=part

# id = AmrShtk.15
ekatra	ekatra	pos=i
Asana	Asana	pos=n,comp=y
saMsTitiH	saMsTiti	pos=n,g=f,c=1,n=s
parihatA	parihan	pos=va,g=f,c=1,n=s,f=part
pratyudgamAd	pratyudgama	pos=n,g=m,c=5,n=s
dUratas	dUratas	pos=i
tAmbUla	tAmbUla	pos=n,comp=y
Anayana	Anayana	pos=n,comp=y
Calena	Cala	pos=n,g=m,c=3,n=s
raBasa	raBasa	pos=n,comp=y
ASlezaH	ASleza	pos=n,g=m,c=1,n=s
api	api	pos=i
saMviGnitaH	saMviGnita	pos=a,g=m,c=1,n=s
AlApaH	AlApa	pos=n,g=m,c=1,n=s
api	api	pos=i
na	na	pos=i
miSritaH	miSray	pos=va,g=m,c=1,n=s,f=part
parijanam	parijana	pos=n,g=m,c=2,n=s
vyApAray	vyApAray	pos=va,g=f,c=3,n=s,f=part
antike	antika	pos=n,g=n,c=7,n=s
kAntam	kAnta	pos=n,g=m,c=2,n=s
pratyupacArAt	pratyupacAra	pos=n,g=m,c=5,n=s
caturayA	catura	pos=a,g=f,c=3,n=s
kopaH	kopa	pos=n,g=m,c=1,n=s
kftArTIkftaH	kftArTIkf	pos=va,g=m,c=1,n=s,f=part

# id = AmrShtk.16
dfzwvA	dfS	pos=vi
eka	eka	pos=n,comp=y
Asana	Asana	pos=n,comp=y
saMsTite	saMsTA	pos=va,g=m,c=7,n=s,f=part
priyatame	priyatama	pos=a,g=m,c=7,n=s
paScAd	paScAt	pos=i
upetya	upe	pos=vi
AdarataH	Adara	pos=n,g=m,c=5,n=s
ekasyA	eka	pos=n,g=f,c=6,n=s
nayane	nayana	pos=n,g=n,c=2,n=d
piDAya	piDA	pos=vi
vihita	viDA	pos=va,comp=y,f=part
krIqA	krIqA	pos=n,comp=y
anubanDa	anubanDa	pos=n,comp=y
CalaH	Cala	pos=n,g=m,c=1,n=s
Izat	Izat	pos=i
vakrima	vakrima	pos=a,comp=y
kanDaraH	kaMDara	pos=n,g=m,c=1,n=s
sapulakaH	sapulaka	pos=a,g=m,c=1,n=s
prema	preman	pos=n,comp=y
ullasat	ullas	pos=va,comp=y,f=part
mAnasAm	mAnasa	pos=n,g=f,c=2,n=s
antarhAsa	antarhAsa	pos=n,comp=y
lasat	las	pos=va,comp=y,f=part
kapola	kapola	pos=n,comp=y
PalakAm	Palaka	pos=n,g=f,c=2,n=s
DUrtaH	DUrta	pos=n,g=m,c=1,n=s
aparAm	apara	pos=n,g=f,c=2,n=s
cumbati	cumb	pos=v,p=3,n=s,l=lat

# id = AmrShtk.17
caraRa	caraRa	pos=n,comp=y
patana	patana	pos=n,comp=y
pratyAKyAnAt	pratyAKyAna	pos=n,g=n,c=5,n=s
prasAda	prasAda	pos=n,comp=y
parANmuKe	parANmuKa	pos=a,g=m,c=7,n=s
niBfta	niBfta	pos=a,comp=y
kitava	kitava	pos=n,comp=y
AcArA	AcAra	pos=n,g=f,c=1,n=s
iti	iti	pos=i
uktvA	vac	pos=vi
ruzA	ruz	pos=n,g=f,c=3,n=s
paruzIkfte	paruzIkf	pos=va,g=m,c=7,n=s,f=part
vrajati	vraj	pos=va,g=m,c=7,n=s,f=part
ramaRe	ramaRa	pos=n,g=m,c=7,n=s
niHSvasya	niHSvas	pos=vi
uccEs	uccEs	pos=i
stana	stana	pos=n,comp=y
sTita	sTA	pos=va,comp=y,f=part
hastayA	hasta	pos=n,g=f,c=3,n=s
nayana	nayana	pos=n,comp=y
salila	salila	pos=n,comp=y
CannA	Cad	pos=va,g=f,c=1,n=s,f=part
dfzwiH	dfzwi	pos=n,g=f,c=1,n=s
saKIzu	saKI	pos=n,g=f,c=7,n=p
niveSitA	niveSay	pos=va,g=f,c=1,n=s,f=part

# id = AmrShtk.18
kAYcyA	kAYcI	pos=n,g=f,c=3,n=s
gAQatara	gAQatara	pos=i
avaruD	avaruD	pos=va,comp=y,f=part
vasana	vasana	pos=n,comp=y
prAntA	prAnta	pos=n,g=f,c=1,n=s
kimarTam	kimarTa	pos=a,g=n,c=2,n=s
punaH	punar	pos=i
mugDAkzI	mugDAkzI	pos=n,g=f,c=1,n=s
svapiti	svap	pos=v,p=3,n=s,l=lat
iti	iti	pos=i
tat	tad	pos=n,g=n,c=2,n=s
parijanam	parijana	pos=n,g=m,c=2,n=s
svEram	svEra	pos=a,g=m,c=2,n=s
priye	priya	pos=a,g=m,c=7,n=s
pfcCati	pracC	pos=va,g=m,c=7,n=s,f=part
mAtaH	mAtf	pos=n,g=f,c=8,n=s
svaptum	svap	pos=vi
api	api	pos=i
iha	iha	pos=i
vArayati	vAray	pos=v,p=3,n=s,l=lat
mAm	mad	pos=n,g=,c=2,n=s
iti	iti	pos=i
Ahita	ADA	pos=va,comp=y,f=part
kroDayA	kroDa	pos=n,g=f,c=3,n=s
paryasya	paryas	pos=vi
svapiti	svap	pos=v,p=3,n=s,l=lat
Calena	Cala	pos=n,g=m,c=3,n=s
Sayane	Sayana	pos=n,g=n,c=7,n=s
dattaH	dA	pos=va,g=m,c=1,n=s,f=part
avakASaH	avakASa	pos=n,g=m,c=1,n=s
tayA	tad	pos=n,g=f,c=3,n=s

# id = AmrShtk.19
ekasmin	eka	pos=n,g=n,c=7,n=s
Sayane	Sayana	pos=n,g=n,c=7,n=s
parANmuKatayA	parANmuKatA	pos=n,g=f,c=3,n=s
vItottaram	vItottara	pos=a,g=n,c=1,n=s
tAmyatoH	tam	pos=va,g=m,c=6,n=d,f=part
anyonyasya	anyonya	pos=n,g=m,c=6,n=s
hfdi	hfd	pos=n,g=n,c=7,n=s
sTite	sTA	pos=va,g=m,c=7,n=s,f=part
api	api	pos=i
anunaye	anunaya	pos=n,g=m,c=7,n=s
saMrakz	saMrakz	pos=va,g=m,c=6,n=d,f=part
gOravam	gOrava	pos=n,g=n,c=1,n=s
dampatyoH	dampati	pos=n,g=m,c=6,n=d
SanakEs	SanakEs	pos=i
apANga	apANga	pos=n,comp=y
valanAt	valana	pos=n,g=n,c=5,n=s
miSrIBU	miSrIBU	pos=va,comp=y,f=part
cakzus	cakzus	pos=n,g=m,c=6,n=d
Bagno	BaYj	pos=va,g=m,c=1,n=s,f=part
mAnakaliH	mAnakali	pos=n,g=m,c=1,n=s
sa	sa	pos=i
hAsa	hAsa	pos=n,comp=y
raBasam	raBasa	pos=n,g=m,c=2,n=s
vyAsakta	vyAsaYj	pos=va,comp=y,f=part
kaRWa	kaRWa	pos=n,comp=y
graham	graha	pos=n,g=m,c=2,n=s

# id = AmrShtk.20
paSyAmo	paS	pos=v,p=1,n=p,l=lat
mayi	mad	pos=n,g=,c=7,n=s
kim	ka	pos=n,g=n,c=1,n=s
prapadyata	prapad	pos=v,p=3,n=s,l=lat
iti	iti	pos=i
sTEryam	sTErya	pos=n,g=n,c=1,n=s
mayA	mad	pos=n,g=,c=3,n=s
Alambitam	Alamb	pos=va,g=n,c=1,n=s,f=part
kim	ka	pos=n,g=n,c=2,n=s
mAm	mad	pos=n,g=,c=2,n=s
Alapati	Alap	pos=v,p=3,n=s,l=lat
iti	iti	pos=i
ayam	idam	pos=n,g=m,c=1,n=s
Kalu	Kalu	pos=i
SaWaH	SaWa	pos=a,g=m,c=1,n=s
kopaH	kopa	pos=n,g=m,c=1,n=s
tayA	tad	pos=n,g=f,c=3,n=s
api	api	pos=i
ASritaH	ASri	pos=va,g=m,c=1,n=s,f=part
iti	iti	pos=i
anyonya	anyonya	pos=n,comp=y
vilakza	vilakza	pos=a,comp=y
dfzwi	dfzwi	pos=n,comp=y
cature	catura	pos=a,g=m,c=7,n=s
tasmin	tad	pos=n,g=n,c=7,n=s
avasTA	avasTA	pos=n,comp=y
antare	antara	pos=a,g=n,c=7,n=s
sa	sa	pos=i
vyAjam	vyAja	pos=n,g=n,c=1,n=s
hasitam	has	pos=va,g=n,c=1,n=s,f=part
mayA	mad	pos=n,g=,c=3,n=s
Dfti	Dfti	pos=n,comp=y
haraH	hara	pos=a,g=m,c=1,n=s
bAzpaH	bAzpa	pos=n,g=m,c=1,n=s
tu	tu	pos=i
muktaH	muc	pos=va,g=m,c=1,n=s,f=part
tayA	tad	pos=n,g=f,c=3,n=s

# id = AmrShtk.21
parimlAne	parimlA	pos=va,g=m,c=7,n=s,f=part
mAne	mAna	pos=n,g=m,c=7,n=s
muKa	muKa	pos=n,comp=y
SaSini	SaSin	pos=n,g=m,c=7,n=s
tasyAH	tad	pos=n,g=f,c=6,n=s
kara	kara	pos=n,comp=y
Dfte	Df	pos=va,g=m,c=7,n=s,f=part
mayi	mad	pos=n,g=,c=7,n=s
kzIRA	kzi	pos=va,g=f,c=1,n=s,f=part
upAye	upAya	pos=n,g=m,c=7,n=s
praRipatana	praRipatana	pos=n,comp=y
mAtra	mAtra	pos=n,comp=y
eka	eka	pos=n,comp=y
SaraRe	SaraRa	pos=n,g=m,c=7,n=s
tayA	tad	pos=n,g=f,c=3,n=s
pakzma	pakzman	pos=n,comp=y
prAnta	prAnta	pos=n,comp=y
vraja	vraja	pos=n,comp=y
puwa	puwa	pos=n,comp=y
nirudDena	niruD	pos=va,g=m,c=3,n=s,f=part
sahasA	sahas	pos=n,g=n,c=3,n=s
prasAdo	prasAda	pos=n,g=m,c=1,n=s
bAzpena	bAzpa	pos=n,g=m,c=3,n=s
stana	stana	pos=n,comp=y
tawa	tawa	pos=n,comp=y
viSIrRena	viSf	pos=va,g=m,c=3,n=s,f=part
kaTitaH	kaT	pos=va,g=m,c=1,n=s,f=part

# id = AmrShtk.22
tasyAH	tad	pos=n,g=f,c=6,n=s
sAndra	sAndra	pos=a,comp=y
vilepana	vilepana	pos=n,comp=y
stana	stana	pos=n,comp=y
tawa	tawa	pos=n,comp=y
praSleza	praSleza	pos=n,comp=y
mudrA	mudrA	pos=n,comp=y
aNkitam	aNkay	pos=va,g=n,c=1,n=s,f=part
kim	ka	pos=n,g=n,c=1,n=s
vakzaH	vakzas	pos=n,g=n,c=1,n=s
caraRAnati	caraRAnati	pos=n,comp=y
vyatikara	vyatikara	pos=n,comp=y
vyAjena	vyAja	pos=n,g=m,c=3,n=s
gopAyate	gopAy	pos=v,p=3,n=s,l=lat
iti	iti	pos=i
ukte	vac	pos=va,g=n,c=7,n=s,f=part
kva	kva	pos=i
tad	tad	pos=n,g=n,c=1,n=s
iti	iti	pos=i
udIrya	udIray	pos=vi
sahasA	sahas	pos=n,g=n,c=3,n=s
tat	tad	pos=n,g=n,c=2,n=s
sampramfj	sampramfj	pos=vi
mayA	mad	pos=n,g=,c=3,n=s
sA	tad	pos=n,g=f,c=1,n=s
ASlizwA	ASliz	pos=va,g=f,c=1,n=s,f=part
raBasena	raBasa	pos=n,g=m,c=3,n=s
tad	tad	pos=n,comp=y
suKa	suKa	pos=n,comp=y
vaSAt	vaSa	pos=n,g=m,c=5,n=s
tanvyA	tanvI	pos=n,g=f,c=3,n=s
api	api	pos=i
tad	tad	pos=n,g=n,c=1,n=s
vismftam	vismf	pos=va,g=n,c=1,n=s,f=part

# id = AmrShtk.23
tvam	tvad	pos=n,g=,c=1,n=s
mugDAkzi	mugDAkzI	pos=n,g=f,c=8,n=s
vinA	vinA	pos=i
eva	eva	pos=i
kaYculikayA	kaYculikA	pos=n,g=f,c=3,n=s
Datse	DA	pos=v,p=2,n=s,l=lat
manohAriRIm	manohArin	pos=a,g=f,c=2,n=s
lakzmyam	lakzmI	pos=n,g=f,c=2,n=s
iti	iti	pos=i
aBiDAyini	aBiDAyin	pos=a,g=m,c=7,n=s
priyatame	priyatama	pos=a,g=m,c=7,n=s
tad	tad	pos=n,comp=y
vIwikAm	vIwikA	pos=n,g=f,c=2,n=s
saMspfSi	saMspfS	pos=a,g=m,c=7,n=s
SayyA	SayyA	pos=n,comp=y
upAnta	upAnta	pos=n,comp=y
nivizwa	niviS	pos=va,comp=y,f=part
sasmita	sasmita	pos=a,comp=y
muKI	muKI	pos=n,comp=y
netrotsava	netrotsava	pos=n,comp=y
AnanditaH	Anand	pos=va,g=m,c=1,n=s,f=part
niryAtaH	niryA	pos=va,g=m,c=1,n=s,f=part
SanakEs	SanakEs	pos=i
alIka	alIka	pos=n,comp=y
vacanopanyAsam	vacanopanyAsa	pos=n,g=m,c=2,n=s
AlI	Ali	pos=n,comp=y
janaH	jana	pos=n,g=m,c=1,n=s

# id = AmrShtk.24
BrU	BrU	pos=n,comp=y
BaNge	BaNga	pos=n,g=m,c=7,n=s
racite	racay	pos=va,g=m,c=7,n=s,f=part
api	api	pos=i
dfzwiH	dfzwi	pos=n,g=f,c=1,n=s
aDikam	aDika	pos=a,g=n,c=2,n=s
sa	sa	pos=i
utkaRWam	utkaRWA	pos=n,g=n,c=2,n=s
udvIkzate	udvIkz	pos=v,p=3,n=s,l=lat
kArkaSyam	kArkaSya	pos=n,g=n,c=2,n=s
gamite	gamay	pos=va,g=n,c=7,n=s,f=part
api	api	pos=i
cetasi	cetas	pos=n,g=n,c=7,n=s
tanU	tanU	pos=n,comp=y
romAYcam	romAYca	pos=n,g=m,c=2,n=s
Alambate	Alamb	pos=v,p=3,n=s,l=lat
rudDAyAm	ruD	pos=va,g=f,c=7,n=s,f=part
api	api	pos=i
vAci	vAc	pos=n,g=f,c=7,n=s
sasmitam	sasmita	pos=a,g=n,c=1,n=s
idam	idam	pos=n,g=n,c=1,n=s
dagDa	dah	pos=va,comp=y,f=part
Ananam	Anana	pos=n,g=n,c=1,n=s
jAyate	jan	pos=v,p=3,n=s,l=lat
dfzwe	dfS	pos=va,g=m,c=7,n=s,f=part
nirvahaRam	nirvahaRa	pos=n,g=n,c=1,n=s
Bavizyati	BU	pos=v,p=3,n=s,l=lrt
kaTam	kaTam	pos=i
mAnasya	mAna	pos=n,g=m,c=6,n=s
tasmin	tad	pos=n,g=m,c=7,n=s
jane	jana	pos=n,g=m,c=7,n=s

# id = AmrShtk.25
kAnte	kAntA	pos=n,g=f,c=8,n=s
kati	kati	pos=i
api	api	pos=i
vAsarARi	vAsara	pos=n,g=n,c=2,n=p
gamaya	gamay	pos=v,p=2,n=s,l=lot
tvam	tvad	pos=n,g=,c=1,n=s
mIlayitvA	mIlay	pos=vi
dfSO	dfS	pos=n,g=f,c=2,n=d
svasti	svasti	pos=n,g=n,c=2,n=s
svasti	svasti	pos=n,g=n,c=2,n=s
nimIlayAmi	nimIlay	pos=v,p=1,n=s,l=lat
nayane	nayana	pos=n,g=n,c=2,n=d
yAvan	yAvat	pos=i
na	na	pos=i
SUnyA	SUnya	pos=a,g=f,c=1,n=p
diSaH	diS	pos=n,g=f,c=1,n=p
AyAtA	AyA	pos=va,g=m,c=1,n=p,f=part
vayam	mad	pos=n,g=,c=1,n=p
Agamizyati	Agam	pos=v,p=3,n=s,l=lrt
suhfd	suhfd	pos=n,comp=y
vargasya	varga	pos=n,g=m,c=6,n=s
BAgya	BAgya	pos=n,comp=y
udayEH	udaya	pos=n,g=m,c=3,n=p
saMdeSo	saMdeSa	pos=n,g=m,c=1,n=s
vada	vad	pos=v,p=2,n=s,l=lot
kaH	ka	pos=n,g=m,c=1,n=s
te	tvad	pos=n,g=,c=6,n=s
aBilazitaH	aBilaz	pos=va,g=m,c=1,n=s,f=part
tIrTezu	tIrTa	pos=n,g=n,c=7,n=p
toya	toya	pos=n,comp=y
aYjaliH	aYjali	pos=n,g=m,c=1,n=s

# id = AmrShtk.26
sA	tad	pos=n,g=f,c=1,n=s
patyuH	pati	pos=n,g=,c=6,n=s
praTama	praTama	pos=a,comp=y
aparADa	aparADa	pos=n,comp=y
samaye	samaya	pos=n,g=m,c=7,n=s
saKyA	saKI	pos=n,g=f,c=3,n=s
upadeSam	upadeSa	pos=n,g=m,c=2,n=s
vinA	vinA	pos=i
no	no	pos=i
jAnAti	jYA	pos=v,p=3,n=s,l=lat
svacCEH	svacCa	pos=a,g=n,c=3,n=p
acCa	acCa	pos=a,comp=y
kapola	kapola	pos=n,comp=y
mUla	mUla	pos=n,comp=y
galitEH	gal	pos=va,g=n,c=3,n=p,f=part
paryasta	paryas	pos=va,comp=y,f=part
netra	netra	pos=n,comp=y
utpalA	utpala	pos=n,g=f,c=1,n=s
bAlA	bAlA	pos=n,g=f,c=1,n=s
kevalam	kevala	pos=a,g=n,c=2,n=s
eva	eva	pos=i
roditi	rud	pos=v,p=3,n=s,l=lat
luW	luW	pos=va,comp=y,f=part
lola	lola	pos=a,comp=y
alakEH	alaka	pos=n,g=n,c=3,n=p
aSruBiH	aSru	pos=n,g=n,c=3,n=p

# id = AmrShtk.27
Bavatu	BU	pos=v,p=3,n=s,l=lot
viditam	vid	pos=va,g=n,c=1,n=s,f=part
Cadma	Cadman	pos=n,comp=y
AlApEH	AlApa	pos=n,g=m,c=3,n=p
alam	alam	pos=i
priya	priya	pos=a,g=m,c=8,n=s
gamyatAm	gam	pos=v,p=3,n=s,l=lot
tanuH	tanu	pos=n,g=f,c=1,n=s
api	api	pos=i
na	na	pos=i
te	tvad	pos=n,g=,c=6,n=s
dozaH	doza	pos=n,g=m,c=1,n=s
naH	mad	pos=n,g=,c=6,n=p
viDiH	viDi	pos=n,g=m,c=1,n=s
tu	tu	pos=i
parANmuKaH	parANmuKa	pos=a,g=m,c=1,n=s
tava	tvad	pos=n,g=,c=6,n=s
yaTA	yaTA	pos=i
taTABUtam	taTABUta	pos=a,g=n,c=1,n=s
prema	preman	pos=n,g=n,c=2,n=s
prapannam	prapad	pos=va,g=n,c=1,n=s,f=part
imAm	idam	pos=n,g=f,c=2,n=s
daSAm	daSA	pos=n,g=f,c=2,n=s
prakfti	prakfti	pos=n,comp=y
capale	capala	pos=n,g=m,c=7,n=s
kA	ka	pos=n,g=f,c=1,n=s
naH	mad	pos=n,g=,c=6,n=p
pIqA	pIqA	pos=n,g=f,c=1,n=s
gate	gam	pos=va,g=m,c=7,n=s,f=part
hata	han	pos=va,comp=y,f=part
jIvite	jIvita	pos=n,g=m,c=7,n=s

# id = AmrShtk.28
urasi	uras	pos=n,g=n,c=7,n=s
nihitaH	niDA	pos=va,g=m,c=1,n=s,f=part
tAraH	tAra	pos=n,g=m,c=1,n=s
hAraH	hAra	pos=n,g=m,c=1,n=s
kftA	kf	pos=va,g=f,c=1,n=s,f=part
jaGane	jaGana	pos=n,g=m,c=7,n=s
Gane	Gana	pos=a,g=m,c=7,n=s
kalakalavatI	kalakalavat	pos=a,g=f,c=1,n=s
kAYcI	kAYcI	pos=n,g=f,c=1,n=s
pAdO	pAda	pos=n,g=m,c=1,n=d
kvaR	kvaR	pos=va,comp=y,f=part
maRi	maRi	pos=n,comp=y
nUpurO	nUpura	pos=n,g=m,c=1,n=d
priyam	priya	pos=a,g=m,c=2,n=s
aBisarasi	aBisf	pos=v,p=2,n=s,l=lat
evam	evam	pos=i
mugDe	muh	pos=va,g=f,c=8,n=s,f=part
samAhan	samAhan	pos=va,comp=y,f=part
qiRqimA	qiRqima	pos=n,g=f,c=1,n=s
yadi	yadi	pos=i
kim	ka	pos=n,g=n,c=2,n=s
aDika	aDika	pos=a,comp=y
trAsa	trAsa	pos=n,comp=y
utkampam	utkampa	pos=n,g=n,c=2,n=s
diSaH	diS	pos=n,g=f,c=2,n=p
samudIkzase	samudIkz	pos=v,p=2,n=s,l=lat

# id = AmrShtk.29
prAtaH	prAtar	pos=i
prAtaH	prAtar	pos=i
upAgatena	upAgam	pos=va,g=m,c=3,n=s,f=part
janitA	janay	pos=va,g=f,c=1,n=s,f=part
nirnidratA	nirnidratA	pos=n,g=f,c=1,n=s
cakzuzoH	cakzus	pos=n,g=n,c=6,n=d
mandAyAm	manda	pos=a,g=f,c=7,n=s
mayi	mad	pos=n,g=,c=7,n=s
gOrava	gOrava	pos=n,comp=y
vyapagamAt	vyapagama	pos=n,g=m,c=5,n=s
utpAditam	utpAday	pos=va,g=n,c=1,n=s,f=part
lAGavam	lAGava	pos=n,g=n,c=1,n=s
kim	ka	pos=n,g=n,c=1,n=s
mugDe	muh	pos=va,g=f,c=8,n=s,f=part
na	na	pos=i
mayA	mad	pos=n,g=,c=3,n=s
kftam	kf	pos=va,g=n,c=1,n=s,f=part
ramaRa	ramaRa	pos=n,comp=y
DIH	DI	pos=n,g=f,c=1,n=s
muktA	muc	pos=va,g=f,c=1,n=s,f=part
tvayA	tvad	pos=n,g=,c=3,n=s
gamyatAm	gam	pos=v,p=3,n=s,l=lot
dusTam	dusTa	pos=a,g=n,c=2,n=s
tizWasi	sTA	pos=v,p=2,n=s,l=lat
yat	yat	pos=i
ca	ca	pos=i
paTya	paTya	pos=a,comp=y
maDunA	maDu	pos=n,g=n,c=3,n=s
kartA	kartf	pos=n,g=m,c=1,n=s
asmi	as	pos=v,p=1,n=s,l=lat
tat	tad	pos=n,g=n,c=2,n=s
Srozyasi	Sru	pos=v,p=2,n=s,l=lrt

# id = AmrShtk.30
sA	tad	pos=n,g=f,c=1,n=s
bAlA	bAlA	pos=n,g=f,c=1,n=s
vayam	mad	pos=n,g=,c=1,n=p
a	a	pos=i
pragalBa	pragalBa	pos=a,comp=y
manasaH	manas	pos=n,g=m,c=1,n=p
sA	tad	pos=n,g=f,c=1,n=s
strI	strI	pos=n,g=f,c=1,n=s
vayam	mad	pos=n,g=,c=1,n=p
kAtarAH	kAtara	pos=a,g=m,c=1,n=p
sA	tad	pos=n,g=f,c=1,n=s
pIna	pIna	pos=a,comp=y
unnatimat	unnatimat	pos=a,comp=y
payoDara	payoDara	pos=n,comp=y
yugam	yuga	pos=n,g=n,c=2,n=s
Datte	DA	pos=v,p=3,n=s,l=lat
saKedA	saKeda	pos=a,g=m,c=1,n=p
vayam	mad	pos=n,g=,c=1,n=p
sA	tad	pos=n,g=f,c=1,n=s
AkrAntA	Akram	pos=va,g=f,c=1,n=s,f=part
jaGana	jaGana	pos=n,comp=y
sTalena	sTala	pos=n,g=n,c=3,n=s
guruRA	guru	pos=a,g=n,c=3,n=s
gantum	gam	pos=vi
na	na	pos=i
SaktA	Sak	pos=va,g=f,c=1,n=s,f=part
vayam	mad	pos=n,g=,c=1,n=p
dozEH	doza	pos=n,g=m,c=3,n=p
anya	anya	pos=n,comp=y
jana	jana	pos=n,comp=y
ASritEH	ASri	pos=va,g=m,c=3,n=p,f=part
apawavaH	apawu	pos=a,g=m,c=1,n=p
jAtAH	jan	pos=va,g=m,c=1,n=p,f=part
sma	as	pos=v,p=1,n=p,l=lat
iti	iti	pos=i
adButam	adButa	pos=n,g=n,c=1,n=s

# id = AmrShtk.31
prasTAnam	prasTAna	pos=n,g=n,c=1,n=s
valayEH	valaya	pos=n,g=m,c=3,n=p
kftam	kf	pos=va,g=n,c=1,n=s,f=part
priya	priya	pos=a,comp=y
saKEH	saKa	pos=n,g=m,c=3,n=p
ajasram	ajasram	pos=i
gatam	gam	pos=va,g=n,c=1,n=s,f=part
DftyA	Dfti	pos=n,g=f,c=3,n=s
na	na	pos=i
kzaRam	kzaRa	pos=n,g=m,c=2,n=s
Asitam	As	pos=va,g=n,c=1,n=s,f=part
vyavasitam	vyavasA	pos=va,g=n,c=1,n=s,f=part
cittena	citta	pos=n,g=n,c=3,n=s
gantum	gam	pos=vi
puraH	puras	pos=i
gantum	gam	pos=vi
niScita	niSci	pos=va,comp=y,f=part
cetasi	cetas	pos=n,g=m,c=7,n=s
priyatame	priyatama	pos=a,g=m,c=7,n=s
sarve	sarva	pos=n,g=m,c=1,n=p
samam	sama	pos=n,g=n,c=2,n=s
prasTitA	prasTA	pos=va,g=m,c=1,n=p,f=part
gantavye	gam	pos=va,g=n,c=7,n=s,f=krtya
sati	as	pos=va,g=n,c=7,n=s,f=part
jIvita	jIvita	pos=n,comp=y
priya	priya	pos=a,comp=y
suhfd	suhfd	pos=n,comp=y
sArTaH	sArTa	pos=n,g=m,c=1,n=s
kimu	kimu	pos=i
tyajyate	tyaj	pos=v,p=3,n=s,l=lat

# id = AmrShtk.32
saMdazwa	saMdaMS	pos=va,comp=y,f=part
aDara	aDara	pos=n,comp=y
pallavA	pallava	pos=n,g=f,c=1,n=s
sacakitam	sacakita	pos=a,g=n,c=2,n=s
hasta	hasta	pos=n,comp=y
agram	agra	pos=n,g=n,c=2,n=s
ADunvatI	ADU	pos=va,g=f,c=1,n=s,f=part
mAm	mad	pos=n,g=,c=2,n=s
AmuYca	Amuc	pos=v,p=2,n=s,l=lot
SaWEH	SaWa	pos=a,g=m,c=8,n=s
iti	iti	pos=i
kopa	kopa	pos=n,comp=y
vacanEH	vacana	pos=n,g=n,c=3,n=p
Anartay	Anartay	pos=va,comp=y,f=part
BrU	BrU	pos=n,comp=y
latA	latA	pos=n,g=f,c=1,n=s
SItkAra	SItkAra	pos=n,comp=y
aYcita	aYcita	pos=a,comp=y
locanA	locana	pos=n,g=f,c=1,n=s
saraBasam	saraBasa	pos=a,g=n,c=2,n=s
yEH	yad	pos=n,g=m,c=3,n=p
cumbitA	cumb	pos=va,g=f,c=1,n=s,f=part
mAninI	mAninI	pos=n,g=f,c=1,n=s
prAptam	prAp	pos=va,g=n,c=1,n=s,f=part
tEH	tad	pos=n,g=m,c=3,n=p
amftam	amfta	pos=n,g=n,c=1,n=s
muDA	muDA	pos=i
eva	eva	pos=i
maTito	maT	pos=va,g=m,c=1,n=s,f=part
mUQEH	muh	pos=va,g=m,c=3,n=p,f=part
surEH	sura	pos=n,g=m,c=3,n=p
sAgaraH	sAgara	pos=n,g=m,c=1,n=s

# id = AmrShtk.33
suptaH	svap	pos=va,g=m,c=1,n=s,f=part
ayam	idam	pos=n,g=m,c=1,n=s
saKi	saKI	pos=n,g=f,c=8,n=s
supyatAm	svap	pos=v,p=3,n=s,l=lot
iti	iti	pos=i
gatAH	gam	pos=va,g=f,c=1,n=p,f=part
saKyaH	saKI	pos=n,g=f,c=1,n=p
tatas	tatas	pos=i
anantaram	anantara	pos=a,g=n,c=2,n=s
prema	preman	pos=n,comp=y
AvAsitayA	AvAsay	pos=va,g=f,c=3,n=s,f=part
mayA	mad	pos=n,g=,c=3,n=s
saralayA	sarala	pos=a,g=f,c=3,n=s
nyastam	nyas	pos=va,g=n,c=1,n=s,f=part
muKam	muKa	pos=n,g=n,c=1,n=s
tad	tad	pos=n,comp=y
muKe	muKa	pos=n,g=n,c=7,n=s
jYAte	jYA	pos=va,g=n,c=7,n=s,f=part
alIka	alIka	pos=a,comp=y
nimIlane	nimIlana	pos=n,g=n,c=7,n=s
nayanayoH	nayana	pos=n,g=n,c=6,n=d
DUrtasya	DUrta	pos=n,g=m,c=6,n=s
romAYcato	romAYca	pos=n,g=m,c=5,n=s
lajjA	lajjA	pos=n,g=f,c=1,n=s
AsIt	as	pos=v,p=3,n=s,l=lan
mama	mad	pos=n,g=,c=6,n=s
tena	tad	pos=n,g=n,c=3,n=s
sA	tad	pos=n,g=f,c=1,n=s
api	api	pos=i
apahftA	apahf	pos=va,g=f,c=1,n=s,f=part
tad	tad	pos=n,comp=y
kAla	kAla	pos=n,comp=y
yogyEH	yogya	pos=a,g=m,c=3,n=p
kramEH	krama	pos=n,g=m,c=3,n=p

# id = AmrShtk.34
kopo	kopa	pos=n,g=m,c=1,n=s
yatra	yatra	pos=i
BrUkuwi	BrUkuwi	pos=n,comp=y
racanA	racanA	pos=n,g=f,c=1,n=s
nigraho	nigraha	pos=n,g=m,c=1,n=s
yatra	yatra	pos=i
mOnam	mOna	pos=n,g=n,c=1,n=s
yatra	yatra	pos=i
anyonya	anyonya	pos=n,comp=y
smitam	smita	pos=n,g=n,c=1,n=s
anunayaH	anunaya	pos=n,g=m,c=1,n=s
yatra	yatra	pos=i
dfzwiH	dfzwi	pos=n,g=f,c=1,n=s
prasAdaH	prasAda	pos=n,g=m,c=1,n=s
tasya	tad	pos=n,g=m,c=6,n=s
preman	preman	pos=n,g=,c=6,n=s
tat	tad	pos=n,g=n,c=2,n=s
idam	idam	pos=n,g=n,c=2,n=s
aDunA	aDunA	pos=i
vEzamam	vEzama	pos=n,g=n,c=2,n=s
paSya	paS	pos=v,p=2,n=s,l=lot
jAtam	jan	pos=va,g=n,c=2,n=s,f=part
tvam	tvad	pos=n,g=,c=1,n=s
pAda	pAda	pos=n,comp=y
ante	anta	pos=n,g=m,c=7,n=s
luWasi	luW	pos=v,p=2,n=s,l=lat
nahi	nahi	pos=i
me	mad	pos=n,g=,c=6,n=s
manyu	manyu	pos=n,comp=y
mokzaH	mokza	pos=n,g=m,c=1,n=s
KalAyAH	KalA	pos=n,g=f,c=6,n=s

# id = AmrShtk.35
su	su	pos=i
tanu	tanu	pos=a,g=f,c=8,n=s
jahihi	hA	pos=v,p=2,n=s,l=lot
kopam	kopa	pos=n,g=m,c=2,n=s
paSya	paS	pos=v,p=2,n=s,l=lot
pAda	pAda	pos=n,comp=y
Anatam	Anam	pos=va,g=m,c=2,n=s,f=part
mAm	mad	pos=n,g=,c=2,n=s
na	na	pos=i
Kalu	Kalu	pos=i
tava	tvad	pos=n,g=,c=6,n=s
kadAcid	kadAcid	pos=i
kopaH	kopa	pos=n,g=m,c=1,n=s
evaMviDaH	evaMviDa	pos=a,g=m,c=1,n=s
aBUt	BU	pos=v,p=3,n=s,l=lun
iti	iti	pos=i
nigadati	nigad	pos=va,g=m,c=7,n=s,f=part
nATe	nATa	pos=n,g=m,c=7,n=s
tiryak	tiryaYc	pos=a,comp=y
AmIlay	AmIlay	pos=va,comp=y,f=part
akzyA	akzi	pos=n,g=f,c=3,n=s
nayanajalam	nayanajala	pos=n,g=n,c=1,n=s
analpam	analpa	pos=a,g=n,c=1,n=s
muktam	muc	pos=va,g=n,c=1,n=s,f=part
uktam	vac	pos=va,g=n,c=1,n=s,f=part
na	na	pos=i
kiMcit	kaScit	pos=n,g=n,c=1,n=s

# id = AmrShtk.36
gAQa	gAQa	pos=a,comp=y
AliNgana	AliNgana	pos=n,comp=y
vAmanIkfta	vAmanIkfta	pos=a,comp=y
kuca	kuca	pos=n,comp=y
prodBid	prodBid	pos=va,comp=y,f=part
roma	roman	pos=n,comp=y
udgamA	udgama	pos=n,g=f,c=1,n=s
sAndra	sAndra	pos=a,comp=y
sneha	sneha	pos=n,comp=y
rasa	rasa	pos=n,comp=y
atireka	atireka	pos=n,comp=y
vigalat	vigal	pos=va,comp=y,f=part
SrImat	SrImat	pos=a,comp=y
nitamba	nitamba	pos=n,comp=y
ambarA	ambara	pos=n,g=f,c=1,n=s
mA	mA	pos=i
mA	mA	pos=i
mAnada	mAnada	pos=a,g=m,c=8,n=s
mA	mA	pos=i
ati	ati	pos=i
mAm	mad	pos=n,g=,c=2,n=s
alam	alam	pos=i
iti	iti	pos=i
kzAma	kzAma	pos=a,comp=y
akzara	akzara	pos=n,comp=y
ullApin	ullApin	pos=a,g=f,c=1,n=s
suptA	svap	pos=va,g=f,c=1,n=s,f=part
kim	ka	pos=n,g=n,c=2,n=s
nu	nu	pos=i
mftA	mf	pos=va,g=f,c=1,n=s,f=part
nu	nu	pos=i
kim	ka	pos=n,g=n,c=2,n=s
manasi	manas	pos=n,g=n,c=7,n=s
me	mad	pos=n,g=,c=6,n=s
lInA	lI	pos=va,g=f,c=1,n=s,f=part
vilInA	vilI	pos=va,g=f,c=1,n=s,f=part
nu	nu	pos=i
kim	ka	pos=n,g=n,c=1,n=s

# id = AmrShtk.37
pawa	pawa	pos=n,comp=y
Alagne	Alag	pos=va,g=m,c=7,n=s,f=part
patyO	pati	pos=n,g=,c=7,n=s
namayati	namay	pos=v,p=3,n=s,l=lat
muKam	muKa	pos=n,g=n,c=2,n=s
jAta	jan	pos=va,comp=y,f=part
vinayA	vinaya	pos=n,g=f,c=1,n=s
haWa	haWa	pos=n,comp=y
ASlezam	ASleza	pos=n,g=m,c=2,n=s
vAYCati	vAYC	pos=v,p=3,n=s,l=lat
apaharati	apahf	pos=v,p=3,n=s,l=lat
gAtrARi	gAtra	pos=n,g=n,c=2,n=p
niBftam	niBfta	pos=a,g=n,c=2,n=s
na	na	pos=i
Saknoti	Sak	pos=v,p=3,n=s,l=lat
AKyAtum	AKyA	pos=vi
smita	smita	pos=n,comp=y
muKa	muKa	pos=n,comp=y
saKi	saKI	pos=n,comp=y
datta	dA	pos=va,comp=y,f=part
nayanA	nayana	pos=n,g=f,c=1,n=s
hriyA	hrI	pos=n,g=f,c=3,n=s
tAmyati	tam	pos=v,p=3,n=s,l=lat
antaH	antar	pos=i
praTama	praTama	pos=a,comp=y
parihAse	parihAsa	pos=n,g=m,c=7,n=s
nava	nava	pos=a,comp=y
vaDUH	vaDU	pos=n,g=f,c=1,n=s

# id = AmrShtk.38
gate	gam	pos=va,g=m,c=7,n=s,f=part
premAbanDe	premAbanDa	pos=n,g=m,c=7,n=s
praRaya	praRaya	pos=n,comp=y
bahu	bahu	pos=a,comp=y
mAne	mAna	pos=n,g=m,c=7,n=s
vigalite	vigal	pos=va,g=m,c=7,n=s,f=part
nivftte	nivft	pos=va,g=m,c=7,n=s,f=part
sadBAve	sadBAva	pos=n,g=m,c=7,n=s
jana	jana	pos=n,g=m,c=1,n=s
iva	iva	pos=i
jane	jana	pos=n,g=m,c=7,n=s
gacCati	gam	pos=v,p=3,n=s,l=lat
puraH	puras	pos=i
tad	tad	pos=n,g=n,c=2,n=s
utprekzya	utprekz	pos=vi
utprekzya	utprekz	pos=vi
priya	priya	pos=a,comp=y
saKi	saKI	pos=n,g=f,c=8,n=s
gatAn	gam	pos=va,g=m,c=2,n=p,f=part
tAn	tad	pos=n,g=m,c=2,n=p
ca	ca	pos=i
divasAn	divasa	pos=n,g=m,c=2,n=p
na	na	pos=i
jAne	jYA	pos=v,p=1,n=s,l=lat
ko	ka	pos=n,g=m,c=1,n=s
hetuH	hetu	pos=n,g=m,c=1,n=s
dalati	dal	pos=v,p=3,n=s,l=lat
SataDA	SataDA	pos=i
yan	yat	pos=i
na	na	pos=i
hfdayam	hfdaya	pos=n,g=n,c=1,n=s

# id = AmrShtk.39
cira	cira	pos=a,comp=y
virahin	virahin	pos=a,g=m,c=6,n=d
utkaRWA	utkaRWA	pos=n,comp=y
Arti	Arti	pos=n,comp=y
SlaTIkfta	SlaTIkf	pos=va,comp=y,f=part
gAtrayoH	gAtra	pos=n,g=m,c=6,n=d
navam	nava	pos=a,g=n,c=1,n=s
iva	iva	pos=i
jagaj	jagant	pos=n,g=n,c=1,n=s
jAtam	jan	pos=va,g=n,c=1,n=s,f=part
BUyas	BUyas	pos=i
cirAt	cirAt	pos=i
aBinandatoH	aBinand	pos=va,g=m,c=6,n=d,f=part
kaTam	kaTam	pos=i
api	api	pos=i
dine	dina	pos=n,g=n,c=7,n=s
dIrGe	dIrGa	pos=a,g=n,c=7,n=s
yAte	yA	pos=va,g=n,c=7,n=s,f=part
niSAm	niSA	pos=n,g=f,c=2,n=s
aDirUQayoH	aDiruh	pos=va,g=m,c=6,n=d,f=part
prasarati	prasf	pos=v,p=3,n=s,l=lat
kaTA	kaTA	pos=n,g=f,c=1,n=s
bahvI	bahu	pos=a,g=f,c=1,n=s
yUnoH	yuvan	pos=n,g=,c=6,n=d
yaTA	yaTA	pos=i
na	na	pos=i
taTA	taTA	pos=i
ratiH	rati	pos=n,g=f,c=1,n=s

# id = AmrShtk.40
dIrGA	dIrGa	pos=a,g=f,c=1,n=s
vandanamAlikA	vandanamAlikA	pos=n,g=f,c=1,n=s
viracitA	viracay	pos=va,g=f,c=1,n=s,f=part
hfzwyA	hfzwi	pos=n,g=f,c=3,n=s
eva	eva	pos=i
na	na	pos=i
indIvarEH	indIvara	pos=n,g=m,c=3,n=p
puzpARAm	puzpa	pos=n,g=n,c=6,n=p
prakaraH	prakara	pos=n,g=m,c=1,n=s
smitena	smita	pos=n,g=n,c=3,n=s
racito	racay	pos=va,g=m,c=1,n=s,f=part
no	no	pos=i
kunda	kunda	pos=n,comp=y
jAti	jAti	pos=n,comp=y
AdiBiH	Adi	pos=n,g=m,c=3,n=p
dattaH	dA	pos=va,g=m,c=1,n=s,f=part
sveda	sveda	pos=n,comp=y
mucA	muc	pos=a,g=n,c=3,n=s
payoDara	payoDara	pos=n,comp=y
yuge	yuga	pos=n,g=n,c=7,n=s
na	na	pos=i
arGyaH	arGya	pos=a,g=m,c=1,n=s
na	na	pos=i
kumBa	kumBa	pos=n,comp=y
amBasA	amBas	pos=n,g=n,c=3,n=s
svEH	sva	pos=a,g=m,c=3,n=p
eva	eva	pos=i
avayavEH	avayava	pos=n,g=m,c=3,n=p
priyasya	priya	pos=a,g=m,c=6,n=s
viSataH	viS	pos=va,g=m,c=6,n=s,f=part
tanvyA	tanvI	pos=n,g=f,c=3,n=s
kftam	kf	pos=va,g=n,c=1,n=s,f=part
maNgalam	maNgala	pos=n,g=n,c=1,n=s

# id = AmrShtk.41
kAnte	kAnta	pos=n,g=m,c=7,n=s
sAgasi	sAgas	pos=a,g=m,c=7,n=s
SAyite	SAyay	pos=va,g=m,c=7,n=s,f=part
priya	priya	pos=a,comp=y
saKi	saKI	pos=n,comp=y
veSam	veSa	pos=n,g=m,c=2,n=s
viDAya	viDA	pos=vi
Agate	Agam	pos=va,g=m,c=7,n=s,f=part
BrAntyA	BrAnti	pos=n,g=f,c=3,n=s
AliNgya	AliNgay	pos=vi
mayA	mad	pos=n,g=,c=3,n=s
rahasyam	rahasya	pos=n,g=n,c=1,n=s
uditam	vad	pos=va,g=n,c=1,n=s,f=part
tad	tad	pos=n,comp=y
saNgam	saNga	pos=n,g=m,c=2,n=s
AkANkzayA	AkANkzA	pos=n,g=f,c=3,n=s
mugDe	muh	pos=va,g=f,c=8,n=s,f=part
duzkaram	duzkara	pos=a,g=n,c=1,n=s
etat	etad	pos=n,g=n,c=1,n=s
iti	iti	pos=i
atitarAm	atitarAm	pos=i
uktvA	vac	pos=vi
sa	sa	pos=i
hAsam	hAsa	pos=n,g=n,c=2,n=s
balAd	bala	pos=n,g=n,c=5,n=s
AliNgya	AliNgay	pos=vi
CalitA	Calay	pos=va,g=f,c=1,n=s,f=part
asmi	as	pos=v,p=1,n=s,l=lat
tena	tad	pos=n,g=m,c=3,n=s
kitavena	kitava	pos=n,g=m,c=3,n=s
adya	adya	pos=i
pradoza	pradoza	pos=n,comp=y
Agame	Agama	pos=n,g=m,c=7,n=s

# id = AmrShtk.42
ASaNkya	ASaNk	pos=vi
praRatim	praRati	pos=n,g=f,c=2,n=s
pawa	pawa	pos=n,comp=y
anta	anta	pos=n,comp=y
pihitO	piDA	pos=va,g=m,c=2,n=d,f=part
pAdO	pAda	pos=n,g=m,c=2,n=d
karoti	kf	pos=v,p=3,n=s,l=lat
AdarataH	Adara	pos=n,g=m,c=5,n=s
vyAjena	vyAja	pos=n,g=m,c=3,n=s
Agatam	Agam	pos=va,g=n,c=2,n=s,f=part
AvfRoti	Avf	pos=v,p=3,n=s,l=lat
hasitam	hasita	pos=n,g=n,c=2,n=s
na	na	pos=i
spazwam	paS	pos=va,g=n,c=2,n=s,f=part
udvIkzate	udvIkz	pos=v,p=3,n=s,l=lat
mayi	mad	pos=n,g=,c=7,n=s
AlApavat	AlApavat	pos=a,g=m,c=7,n=s
pratIpavacanam	pratIpavacana	pos=n,g=n,c=2,n=s
saKyA	saKI	pos=n,g=f,c=3,n=s
saha	saha	pos=i
ABAzate	ABAz	pos=v,p=3,n=s,l=lat
tasyAH	tad	pos=n,g=f,c=6,n=s
tizWatu	sTA	pos=v,p=3,n=s,l=lot
nirBara	nirBara	pos=a,comp=y
praRayitA	praRayitf	pos=a,g=m,c=1,n=s
mAnaH	mAna	pos=n,g=m,c=1,n=s
api	api	pos=i
ramya	ramya	pos=a,comp=y
udayaH	udaya	pos=n,g=m,c=1,n=s

# id = AmrShtk.43
sA	tad	pos=n,g=f,c=1,n=s
yAvanti	yAvat	pos=a,g=n,c=2,n=p
padAni	pada	pos=n,g=n,c=2,n=p
alIka	alIka	pos=a,comp=y
vacanEH	vacana	pos=n,g=n,c=3,n=p
AlI	Ali	pos=n,comp=y
janEH	jana	pos=n,g=m,c=3,n=p
SikzitA	Sikzay	pos=va,g=f,c=1,n=s,f=part
tAvanti	tAvat	pos=a,g=n,c=2,n=p
eva	eva	pos=i
kfta	kf	pos=va,comp=y,f=part
AgasaH	Agas	pos=n,g=m,c=6,n=s
drutataram	drutatara	pos=a,g=n,c=2,n=s
vyAhftya	vyAhf	pos=vi
patyuH	pati	pos=n,g=,c=6,n=s
puraH	puras	pos=i
prArabDA	prAraB	pos=va,g=f,c=1,n=s,f=part
purato	puratas	pos=i
yaTA	yaTA	pos=i
manasijasya	manasija	pos=n,g=m,c=6,n=s
AjYA	AjYA	pos=n,g=f,c=1,n=s
taTA	taTA	pos=i
vartitum	vft	pos=vi
premRo	preman	pos=n,g=,c=6,n=s
mOgDya	mOgDya	pos=n,comp=y
viBUzaRasya	viBUzaRa	pos=n,g=m,c=6,n=s
sahajaH	sahaja	pos=a,g=m,c=1,n=s
kaH	ka	pos=n,g=m,c=1,n=s
api	api	pos=i
eza	etad	pos=n,g=m,c=1,n=s
kAntaH	kAnta	pos=a,g=m,c=1,n=s
kramaH	krama	pos=n,g=m,c=1,n=s

# id = AmrShtk.44
dUrAt	dUra	pos=a,g=n,c=5,n=s
utsukam	utsuka	pos=n,g=n,c=2,n=s
Agate	Agam	pos=va,g=m,c=7,n=s,f=part
vivalitam	vivalita	pos=a,g=n,c=2,n=s
samBAziRi	samBAzin	pos=a,g=m,c=7,n=s
sPAritam	sPAray	pos=va,g=m,c=2,n=s,f=part
saMSlizyati	saMSliz	pos=v,p=3,n=s,l=lat
aruRam	aruRa	pos=a,g=m,c=2,n=s
gfhIta	grah	pos=va,comp=y,f=part
vasane	vasana	pos=n,g=m,c=7,n=s
kiMcin	kaScit	pos=n,g=n,c=2,n=s
nata	nam	pos=va,comp=y,f=part
BrU	BrU	pos=n,comp=y
latam	latA	pos=n,g=m,c=2,n=s
mAninyAH	mAninI	pos=n,g=f,c=6,n=s
caraRAnati	caraRAnati	pos=n,comp=y
vyatikare	vyatikara	pos=n,g=m,c=7,n=s
bAzpa	bAzpa	pos=n,comp=y
ambu	ambu	pos=n,comp=y
pUrRa	pUrRa	pos=a,comp=y
IkzaRam	IkzaRa	pos=n,g=n,c=1,n=s
cakzuH	cakzus	pos=n,g=n,c=1,n=s
jAtam	jan	pos=va,g=n,c=1,n=s,f=part
aho	aho	pos=i
prapaYca	prapaYca	pos=n,comp=y
caturam	catura	pos=a,g=n,c=1,n=s
jAta	jan	pos=va,comp=y,f=part
Agasi	Agas	pos=n,g=m,c=7,n=s
preyasi	preyas	pos=n,g=m,c=7,n=s

# id = AmrShtk.45
aNgAnAm	aNga	pos=n,g=n,c=6,n=p
atitAnavam	atitAnava	pos=n,g=n,c=1,n=s
kaTam	kaTam	pos=i
idam	idam	pos=n,g=n,c=1,n=s
kampaH	kampa	pos=n,g=m,c=1,n=s
ca	ca	pos=i
kasmAt	ka	pos=n,g=n,c=5,n=s
kutas	kutas	pos=i
mugDe	muh	pos=va,g=f,c=8,n=s,f=part
pARqu	pARqu	pos=a,comp=y
kapolam	kapola	pos=n,g=n,c=1,n=s
Ananam	Anana	pos=n,g=n,c=1,n=s
iti	iti	pos=i
prAReSvare	prAReSvara	pos=n,g=m,c=7,n=s
pfcCati	pracC	pos=va,g=m,c=7,n=s,f=part
tanvyA	tanu	pos=n,g=f,c=3,n=s
sarvam	sarva	pos=n,g=n,c=1,n=s
idam	idam	pos=n,g=n,c=1,n=s
svaBAva	svaBAva	pos=n,comp=y
jam	ja	pos=a,g=n,c=1,n=s
iti	iti	pos=i
vyAhftya	vyAhf	pos=vi
pakzma	pakzman	pos=n,comp=y
antara	antara	pos=n,comp=y
vyApI	vyApin	pos=a,g=m,c=1,n=s
bAzpa	bAzpa	pos=n,comp=y
BaraH	Bara	pos=n,g=m,c=1,n=s
tayA	tad	pos=n,g=f,c=3,n=s
calitayA	cal	pos=va,g=f,c=3,n=s,f=part
niHSvasya	niHSvas	pos=vi
muktaH	muc	pos=va,g=m,c=1,n=s,f=part
anyatas	anyatas	pos=i

# id = AmrShtk.46
puras	puras	pos=i
tanvAH	tanu	pos=n,g=f,c=6,n=s
gotra	gotra	pos=n,comp=y
sKalana	sKalana	pos=n,comp=y
cakitaH	cak	pos=va,g=m,c=1,n=s,f=part
aham	mad	pos=n,g=,c=1,n=s
nata	nam	pos=va,comp=y,f=part
muKaH	muKa	pos=n,g=m,c=1,n=s
pravftto	pravft	pos=va,g=m,c=1,n=s,f=part
vElakzyAt	vElakzya	pos=n,g=n,c=5,n=s
kim	ka	pos=n,g=n,c=2,n=s
api	api	pos=i
liKitum	liK	pos=vi
dEva	dEva	pos=n,comp=y
hatakaH	hataka	pos=a,g=m,c=1,n=s
sPuwo	sPuwa	pos=a,g=m,c=1,n=s
reKA	reKA	pos=n,comp=y
nyAsaH	nyAsa	pos=n,g=m,c=1,n=s
kaTam	kaTam	pos=i
api	api	pos=i
sa	tad	pos=n,g=m,c=1,n=s
tAdfk	tAdfS	pos=a,g=m,c=1,n=s
pariRato	pariRam	pos=va,g=m,c=1,n=s,f=part
gatA	gam	pos=va,g=f,c=1,n=s,f=part
yena	yena	pos=i
vyaktam	vyakta	pos=a,g=n,c=2,n=s
punaH	punar	pos=i
avayavEH	avayava	pos=n,g=m,c=3,n=p
sA	tad	pos=n,g=f,c=1,n=s
eva	eva	pos=i
taruRI	taruRa	pos=a,g=f,c=1,n=s

# id = AmrShtk.47
kaWina	kaWina	pos=a,comp=y
hfdaye	hfdaya	pos=n,g=n,c=7,n=s
muYca	muc	pos=v,p=2,n=s,l=lot
BrAntim	BrAnti	pos=n,g=f,c=2,n=s
vyalIka	vyalIka	pos=a,comp=y
kaTA	kaTA	pos=n,comp=y
ASritAm	ASri	pos=va,g=f,c=2,n=s,f=part
piSuna	piSuna	pos=a,comp=y
vacanEH	vacana	pos=n,g=n,c=3,n=p
duHKam	duHKa	pos=n,g=n,c=2,n=s
netum	nI	pos=vi
na	na	pos=i
yuktam	yukta	pos=a,g=n,c=1,n=s
imam	idam	pos=n,g=m,c=2,n=s
janam	jana	pos=n,g=m,c=2,n=s
kim	ka	pos=n,g=n,c=1,n=s
idam	idam	pos=n,g=n,c=1,n=s
aTavA	aTavA	pos=i
satyam	satya	pos=n,g=n,c=1,n=s
mugDe	muh	pos=va,g=f,c=8,n=s,f=part
tvayA	tvad	pos=n,g=,c=3,n=s
hi	hi	pos=i
viniScitam	viniSci	pos=va,g=n,c=1,n=s,f=part
yad	yad	pos=n,g=n,c=1,n=s
aBirucitam	aBirucita	pos=a,g=n,c=1,n=s
tan	tad	pos=n,g=n,c=2,n=s
me	mad	pos=n,g=,c=6,n=s
kftvA	kf	pos=vi
priye	priya	pos=a,g=f,c=8,n=s
suKam	suKam	pos=i
AsyatAm	As	pos=v,p=3,n=s,l=lot

# id = AmrShtk.48
mandam	manda	pos=a,g=n,c=2,n=s
mudray	mudray	pos=va,comp=y,f=part
pAMSavaH	pAMSu	pos=n,g=m,c=1,n=p
paripat	paripat	pos=va,comp=y,f=part
JaNkAra	JaNkAra	pos=n,comp=y
JaYJA	JaYJA	pos=n,comp=y
marut	marut	pos=n,comp=y
vega	vega	pos=n,comp=y
Dvasta	DvaMs	pos=va,comp=y,f=part
kuwIraka	kuwIraka	pos=n,comp=y
antara	antara	pos=a,comp=y
gata	gam	pos=va,comp=y,f=part
Cidrezu	Cidra	pos=n,g=n,c=7,n=p
labDa	laB	pos=va,comp=y,f=part
antarAH	antara	pos=n,g=m,c=1,n=p
karma	karman	pos=n,comp=y
vyagra	vyagra	pos=a,comp=y
kuwumbinI	kuwumbinI	pos=n,comp=y
kucatawa	kucatawa	pos=n,comp=y
svedacCid	svedacCid	pos=a,g=f,c=1,n=p
prAvfzaH	prAvfz	pos=n,g=f,c=1,n=p
prAramBe	prAramBa	pos=n,g=m,c=7,n=s
nipatanti	nipat	pos=v,p=3,n=p,l=lat
kandala	kandala	pos=n,comp=y
dala	dala	pos=n,comp=y
ullAsAH	ullAsa	pos=n,g=m,c=1,n=p
payaH	payas	pos=n,comp=y
bindavaH	bindu	pos=n,g=m,c=1,n=p

# id = AmrShtk.49
pItaH	pA	pos=va,g=m,c=1,n=s,f=part
tuzArakiraRaH	tuzArakiraRa	pos=n,g=m,c=1,n=s
maDunA	maDu	pos=n,g=n,c=3,n=s
eva	eva	pos=i
sArDam	sArDam	pos=i
antaH	antar	pos=i
praviSya	praviS	pos=vi
cazake	cazaka	pos=n,g=m,c=7,n=s
pratibimba	pratibimba	pos=n,comp=y
vartI	vartin	pos=a,g=m,c=1,n=s
mAna	mAna	pos=n,comp=y
anDakAram	anDakAra	pos=n,g=m,c=2,n=s
api	api	pos=i
mAnavatI	mAnavatI	pos=n,comp=y
janasya	jana	pos=n,g=m,c=6,n=s
nUnam	nUnam	pos=i
biBeda	Bid	pos=v,p=3,n=s,l=lit
yad	yat	pos=i
asO	adas	pos=n,g=m,c=1,n=s
prasasAda	prasad	pos=v,p=3,n=s,l=lit
sadyaH	sadyas	pos=i

# id = AmrShtk.50
naBasi	naBas	pos=n,g=n,c=7,n=s
jalada	jalada	pos=n,comp=y
lakzmyam	lakzmI	pos=n,g=f,c=2,n=s
samBftAm	samBfta	pos=a,g=f,c=2,n=s
vIkzya	vIkz	pos=vi
dizwyA	dizwi	pos=n,g=f,c=3,n=s
prasarasi	prasf	pos=v,p=2,n=s,l=lat
yadi	yadi	pos=i
kAntEH	kAnta	pos=n,g=m,c=8,n=s
iti	iti	pos=i
arDam	arDa	pos=n,g=n,c=2,n=s
uktvA	vac	pos=vi
kaTaMcit	kaTaMcid	pos=i
mama	mad	pos=n,g=,c=6,n=s
pawam	pawa	pos=n,g=m,c=2,n=s
avalambya	avalamb	pos=vi
prolliKantI	prolliK	pos=va,g=f,c=1,n=s,f=part
DaritrIm	DaritrI	pos=n,g=f,c=2,n=s
tad	tad	pos=n,comp=y
anukftavatI	anukf	pos=va,g=f,c=1,n=s,f=part
sA	tad	pos=n,g=f,c=1,n=s
yatra	yatra	pos=i
vAco	vAc	pos=n,g=f,c=1,n=p
nivfttAH	nivft	pos=va,g=f,c=1,n=p,f=part

# id = AmrShtk.51
iyam	idam	pos=n,g=f,c=1,n=s
asO	adas	pos=n,g=f,c=1,n=s
tarala	tarala	pos=a,comp=y
Ayata	Ayam	pos=va,comp=y,f=part
locanA	locana	pos=n,g=f,c=1,n=s
guru	guru	pos=n,comp=y
samunnata	samunnam	pos=va,comp=y,f=part
pIna	pIna	pos=a,comp=y
payoDarA	payoDara	pos=n,g=f,c=1,n=s
pfTu	pfTu	pos=a,comp=y
nitamba	nitamba	pos=n,comp=y
Bara	Bara	pos=n,comp=y
alasa	alasa	pos=a,comp=y
gAminI	gAmin	pos=a,g=f,c=1,n=s
priyatamA	priyatama	pos=a,g=f,c=1,n=s
mama	mad	pos=n,g=,c=6,n=s
jIvita	jIvita	pos=n,comp=y
hAriRI	hArin	pos=a,g=f,c=1,n=s

# id = AmrShtk.52
sa	sa	pos=i
alaktakena	alaktaka	pos=n,g=m,c=3,n=s
nava	nava	pos=a,comp=y
pallava	pallava	pos=n,comp=y
komalena	komala	pos=a,g=m,c=3,n=s
pAdena	pAda	pos=n,g=m,c=3,n=s
nUpuravatA	nUpuravat	pos=a,g=m,c=3,n=s
madana	madana	pos=n,comp=y
alasena	alasa	pos=a,g=m,c=3,n=s
yaH	yad	pos=n,g=m,c=1,n=s
tAqyate	tAqay	pos=v,p=3,n=s,l=lat
dayitayA	dayitA	pos=n,g=f,c=3,n=s
praRaya	praRaya	pos=n,comp=y
ArADAt	ArADa	pos=n,g=m,c=5,n=s
saH	tad	pos=n,g=m,c=1,n=s
aNgIkftaH	aNgIkf	pos=va,g=m,c=1,n=s,f=part
BagavatA	Bagavat	pos=a,g=m,c=3,n=s
makaraDvajena	makaraDvaja	pos=n,g=m,c=3,n=s

# id = AmrShtk.53
bAle	bAlA	pos=n,g=f,c=8,n=s
nATa	nATa	pos=n,g=m,c=8,n=s
vimuYca	vimuc	pos=v,p=2,n=s,l=lot
mAnini	mAnin	pos=a,g=f,c=8,n=s
ruzam	ruz	pos=n,g=f,c=2,n=s
rozAn	roza	pos=n,g=m,c=5,n=s
mayA	mad	pos=n,g=,c=3,n=s
kim	ka	pos=n,g=n,c=1,n=s
kftam	kf	pos=va,g=n,c=1,n=s,f=part
KedaH	Keda	pos=n,g=m,c=1,n=s
asmAsu	mad	pos=n,g=,c=7,n=p
na	na	pos=i
me	mad	pos=n,g=,c=6,n=s
aparADyati	aparAD	pos=v,p=3,n=s,l=lat
BavAn	Bavat	pos=a,g=m,c=1,n=s
sarve	sarva	pos=n,g=m,c=1,n=p
aparADAH	aparADa	pos=n,g=m,c=1,n=p
mayi	mad	pos=n,g=,c=7,n=s
tat	tad	pos=n,g=n,c=2,n=s
kim	ka	pos=n,g=n,c=2,n=s
rodizi	rud	pos=v,p=2,n=s,l=lat
gadgadena	gadgada	pos=a,g=n,c=3,n=s
vacasA	vacas	pos=n,g=n,c=3,n=s
kasya	ka	pos=n,g=m,c=6,n=s
agratas	agratas	pos=i
rudyate	rud	pos=v,p=3,n=s,l=lat
nanu	nanu	pos=i
etat	etad	pos=n,g=n,c=1,n=s
mama	mad	pos=n,g=,c=6,n=s
kA	ka	pos=n,g=f,c=1,n=s
te	tvad	pos=n,g=,c=6,n=s
asmi	as	pos=v,p=1,n=s,l=lat
dayitA	dayitA	pos=n,g=f,c=1,n=s
na	na	pos=i
asmi	as	pos=v,p=1,n=s,l=lat
iti	iti	pos=i
atas	atas	pos=i
rudyate	rud	pos=v,p=3,n=s,l=lat

# id = AmrShtk.54
nItvA	nI	pos=vi
uccEs	uccEs	pos=i
vikzip	vikzip	pos=va,g=m,c=1,n=p,f=part
kfta	kf	pos=va,comp=y,f=part
tuhina	tuhina	pos=n,comp=y
kaRa	kaRa	pos=n,comp=y
AsAra	AsAra	pos=n,comp=y
saNgAn	saNga	pos=n,g=m,c=2,n=p
parAgAn	parAga	pos=n,g=m,c=2,n=p
kOndAn	kOnda	pos=a,g=m,c=2,n=p
Anandita	Anand	pos=va,comp=y,f=part
ali	ali	pos=n,g=m,c=2,n=p
atitara	atitara	pos=a,comp=y
suraBIn	suraBi	pos=a,g=m,c=2,n=p
BUriSo	BUriSas	pos=i
diNmuKezu	diNmuKa	pos=n,g=n,c=7,n=p
ete	etad	pos=n,g=m,c=1,n=p
te	tad	pos=n,g=m,c=1,n=p
kuNkuma	kuNkuma	pos=n,comp=y
aYj	aYj	pos=va,comp=y,f=part
stana	stana	pos=n,comp=y
kalaSa	kalaSa	pos=n,comp=y
Bara	Bara	pos=n,comp=y
AsPAlanAt	AsPAlana	pos=n,g=n,c=5,n=s
ucCalantaH	ucCal	pos=va,g=m,c=1,n=p,f=part
pItvA	pA	pos=vi
SItkArin	SItkArin	pos=a,comp=y
vaktram	vaktra	pos=n,g=n,c=2,n=s
SiSu	SiSu	pos=a,comp=y
hari	hari	pos=n,comp=y
dfSAm	dfS	pos=n,g=f,c=6,n=p
hEmanA	hEmana	pos=a,g=m,c=1,n=p
vAnti	vA	pos=v,p=3,n=p,l=lat
vAtAH	vAta	pos=n,g=m,c=1,n=p

# id = AmrShtk.55
SrutvA	Sru	pos=vi
tanvyA	tanu	pos=n,g=f,c=6,n=s
niSITe	niSITa	pos=n,g=m,c=7,n=s
nava	nava	pos=a,comp=y
Gana	Gana	pos=n,comp=y
rasitam	rasita	pos=n,g=n,c=2,n=s
viSlaTa	viSlaTa	pos=a,comp=y
aNkam	aNka	pos=n,g=m,c=2,n=s
patitvA	pat	pos=vi
SayyAyAm	SayyA	pos=n,g=f,c=7,n=s
BUmi	BUmi	pos=n,comp=y
pfzWe	pfzWa	pos=n,g=n,c=7,n=s
kara	kara	pos=n,comp=y
tala	tala	pos=n,comp=y
DftayA	Df	pos=va,g=f,c=3,n=s,f=part
duHKita	duHKita	pos=a,comp=y
AlI	Ali	pos=n,comp=y
janena	jana	pos=n,g=m,c=3,n=s
sa	sa	pos=i
utkaRWam	utkaRWA	pos=n,g=n,c=2,n=s
mukta	muc	pos=va,comp=y,f=part
kaRWam	kaRWa	pos=n,g=n,c=2,n=s
kaWina	kaWina	pos=a,comp=y
kuca	kuca	pos=n,comp=y
tawAGAta	tawAGAta	pos=n,comp=y
SIrRa	Sf	pos=va,comp=y,f=part
aSru	aSru	pos=n,comp=y
bindu	bindu	pos=n,g=n,c=2,n=s
smftvA	smf	pos=vi
smftvA	smf	pos=vi
priyasya	priya	pos=a,g=m,c=6,n=s
sKalita	sKal	pos=va,comp=y,f=part
mfdu	mfdu	pos=a,comp=y
vacaH	vacas	pos=n,g=n,c=2,n=s
rudyate	rud	pos=v,p=3,n=s,l=lat
pAnTa	pAnTa	pos=n,comp=y
vaDvA	vaDU	pos=n,g=f,c=3,n=s

# id = AmrShtk.56
SlizwaH	Sliz	pos=va,g=m,c=1,n=s,f=part
kaRWe	kaRWa	pos=n,g=m,c=7,n=s
kim	ka	pos=n,g=n,c=1,n=s
iti	iti	pos=i
na	na	pos=i
mayA	mad	pos=n,g=,c=3,n=s
mUQayA	muh	pos=va,g=f,c=3,n=s,f=part
prARanATaH	prARanATa	pos=n,g=m,c=1,n=s
cumb	cumb	pos=va,g=m,c=7,n=s,f=part
asmin	idam	pos=n,g=m,c=7,n=s
vadana	vadana	pos=n,comp=y
viDutiH	viDuti	pos=n,g=f,c=1,n=s
kim	ka	pos=n,g=n,c=2,n=s
kftA	kf	pos=va,g=f,c=1,n=s,f=part
kim	ka	pos=n,g=n,c=2,n=s
na	na	pos=i
dfzwaH	dfS	pos=va,g=m,c=1,n=s,f=part
na	na	pos=i
uktavAn	vac	pos=va,g=m,c=1,n=s,f=part
kasmAd	ka	pos=n,g=n,c=5,n=s
iti	iti	pos=i
nava	nava	pos=a,comp=y
vaDU	vaDU	pos=n,comp=y
cezwitam	cezw	pos=va,g=n,c=2,n=s,f=part
cintayantI	cintay	pos=va,g=f,c=1,n=s,f=part
paScAttApam	paScAttApa	pos=n,g=m,c=2,n=s
vahati	vah	pos=v,p=3,n=s,l=lat
taruRI	taruRI	pos=n,g=f,c=1,n=s
premRi	preman	pos=n,g=,c=7,n=s
jAte	jan	pos=va,g=m,c=7,n=s,f=part
rasajYA	rasajYa	pos=a,g=f,c=1,n=s

# id = AmrShtk.57
SrutvA	Sru	pos=vi
nAma	nAman	pos=n,g=n,c=2,n=s
api	api	pos=i
yasya	yad	pos=n,g=m,c=6,n=s
sPuwa	sPuwa	pos=a,comp=y
Gana	Gana	pos=a,comp=y
pulakam	pulaka	pos=n,g=n,c=1,n=s
jAyate	jan	pos=v,p=3,n=s,l=lat
aNgam	aNga	pos=n,g=n,c=1,n=s
samantAt	samantAt	pos=i
dfzwvA	dfS	pos=vi
yasya	yad	pos=n,g=m,c=6,n=s
Anana	Anana	pos=n,comp=y
indum	indu	pos=n,g=m,c=2,n=s
Bavati	BU	pos=v,p=3,n=s,l=lat
vapuH	vapus	pos=n,g=n,c=1,n=s
idam	idam	pos=n,g=n,c=1,n=s
candrakAnta	candrakAnta	pos=n,comp=y
anukArin	anukArin	pos=a,g=n,c=1,n=s
tasmin	tad	pos=n,g=m,c=7,n=s
Agatya	Agam	pos=vi
kaRWagrahaRa	kaRWagrahaRa	pos=n,comp=y
saraBasa	saraBasa	pos=a,comp=y
sTAyini	sTAyin	pos=a,g=m,c=7,n=s
prARanATe	prARanATa	pos=n,g=m,c=7,n=s
BagnA	BaYj	pos=va,g=f,c=1,n=s,f=part
mAnasya	mAna	pos=n,g=m,c=6,n=s
cintA	cintA	pos=n,g=f,c=1,n=s
Bavati	BU	pos=v,p=3,n=s,l=lat
mama	mad	pos=n,g=,c=6,n=s
punaH	punar	pos=i
vajra	vajra	pos=n,comp=y
mayyAH	maya	pos=a,g=f,c=6,n=s
kadA	kadA	pos=i
nu	nu	pos=i

# id = AmrShtk.58
rAmARAm	rAmA	pos=n,g=f,c=6,n=p
ramaRIya	ramaRIya	pos=a,comp=y
vaktra	vaktra	pos=n,comp=y
SaSinaH	SaSin	pos=n,g=m,c=6,n=s
sveda	sveda	pos=n,comp=y
uda	uda	pos=n,comp=y
bindu	bindu	pos=n,comp=y
plutaH	plu	pos=va,g=m,c=1,n=s,f=part
vyAlola	vyAlola	pos=a,comp=y
alaka	alaka	pos=n,comp=y
vallarIm	vallarI	pos=n,g=f,c=2,n=s
pracalayan	pracalay	pos=va,g=m,c=1,n=s,f=part
Dunvan	DU	pos=va,g=m,c=1,n=s,f=part
nitamba	nitamba	pos=n,comp=y
ambaram	ambara	pos=n,g=n,c=2,n=s
prAtaH	prAtar	pos=i
vAti	vA	pos=v,p=3,n=s,l=lat
maDO	maDu	pos=n,g=m,c=7,n=s
prakAma	prakAma	pos=n,comp=y
vikas	vikas	pos=va,comp=y,f=part
rAjIva	rAjIva	pos=n,comp=y
rAjI	rAjI	pos=n,comp=y
rajaH	rajas	pos=n,g=n,c=2,n=s
jAla	jAla	pos=n,comp=y
Amoda	Amoda	pos=n,comp=y
manoharaH	manohara	pos=a,g=m,c=1,n=s
rati	rati	pos=n,comp=y
rasa	rasa	pos=n,comp=y
glAnim	glAni	pos=n,g=f,c=2,n=s
haran	hf	pos=va,g=m,c=1,n=s,f=part
mArutaH	mAruta	pos=n,g=m,c=1,n=s

# id = AmrShtk.59
aNgam	aNga	pos=n,g=n,c=1,n=s
candana	candana	pos=n,comp=y
pARqu	pARqu	pos=a,comp=y
pallava	pallava	pos=n,comp=y
mfduH	mfdu	pos=a,g=m,c=1,n=s
tAmbUla	tAmbUla	pos=n,comp=y
tAmra	tAmra	pos=a,comp=y
aDaraH	aDara	pos=n,g=m,c=1,n=s
DArAyantra	DArAyantra	pos=n,comp=y
jala	jala	pos=n,comp=y
aBizeka	aBizeka	pos=n,comp=y
kaluze	kaluza	pos=n,g=n,c=1,n=d
DOta	DAv	pos=va,comp=y,f=part
aYjane	aYjana	pos=n,g=n,c=1,n=d
locane	locana	pos=n,g=n,c=1,n=d
antaH	antar	pos=i
puzpa	puzpa	pos=n,comp=y
suganDiH	suganDi	pos=a,g=f,c=1,n=s
Ardra	Ardra	pos=a,comp=y
kavarI	kavarI	pos=n,g=f,c=1,n=s
sarva	sarva	pos=n,comp=y
aNga	aNga	pos=n,comp=y
lagna	lag	pos=va,comp=y,f=part
ambaram	ambara	pos=n,g=n,c=1,n=s
romARAm	roma	pos=n,g=n,c=6,n=p
ramaRIya	ramaRIya	pos=a,comp=y
tAm	tA	pos=n,g=f,c=2,n=s
vidaDati	viDA	pos=v,p=3,n=p,l=lat
grIzma	grIzma	pos=n,comp=y
apara	apara	pos=n,comp=y
AhvA	AhvA	pos=n,comp=y
Agame	Agama	pos=n,g=m,c=7,n=s

# id = AmrShtk.60
varam	vara	pos=a,g=n,c=2,n=s
asO	adas	pos=n,g=m,c=1,n=s
divaso	divasa	pos=n,g=m,c=1,n=s
na	na	pos=i
punaH	punar	pos=i
niSA	niSA	pos=n,g=f,c=1,n=s
nanu	nanu	pos=i
niSA	niSA	pos=n,g=f,c=1,n=s
eva	eva	pos=i
varam	vara	pos=a,g=n,c=2,n=s
na	na	pos=i
punaH	punar	pos=i
divA	divA	pos=i
uBayam	uBaya	pos=a,g=n,c=1,n=s
etat	etad	pos=n,g=n,c=1,n=s
upEtu	upe	pos=v,p=3,n=s,l=lot
aTavA	aTavA	pos=i
kzayam	kzaya	pos=n,g=m,c=2,n=s
priya	priya	pos=a,comp=y
janena	jana	pos=n,g=m,c=3,n=s
na	na	pos=i
yatra	yatra	pos=i
samAgamaH	samAgama	pos=n,g=m,c=1,n=s

# id = AmrShtk.61
lolEH	lola	pos=a,g=n,c=3,n=p
locana	locana	pos=n,comp=y
vAriBiH	vAri	pos=n,g=n,c=3,n=p
sa	sa	pos=i
SapaTeBiH	SapaTa	pos=n,g=m,c=3,n=p
pAda	pAda	pos=n,comp=y
praRAmEH	praRAma	pos=n,g=m,c=3,n=p
priyEH	priya	pos=a,g=m,c=3,n=p
anyAH	anya	pos=n,g=f,c=1,n=p
tAH	tad	pos=n,g=f,c=1,n=p
vinivArayanti	vinivAray	pos=v,p=3,n=p,l=lat
kfpaRAH	kfpaRa	pos=a,g=f,c=1,n=p
prAReSvaram	prAReSvara	pos=n,g=m,c=2,n=s
prasTitam	prasTA	pos=va,g=m,c=2,n=s,f=part
puRya	puRya	pos=a,comp=y
aham	aha	pos=n,g=m,c=2,n=s
vraja	vraj	pos=v,p=2,n=s,l=lot
maNgalam	maNgala	pos=a,g=m,c=2,n=s
su	su	pos=i
divasam	divasa	pos=n,g=m,c=2,n=s
prAtaH	prAtar	pos=i
prayAtasya	prayA	pos=va,g=m,c=6,n=s,f=part
te	tvad	pos=n,g=,c=6,n=s
yat	yad	pos=n,g=n,c=1,n=s
sneha	sneha	pos=n,comp=y
ucitam	ucita	pos=a,g=n,c=1,n=s
Ihitam	Ih	pos=va,g=n,c=1,n=s,f=part
priyatama	priyatama	pos=a,g=m,c=8,n=s
tvam	tva	pos=n,g=n,c=1,n=s
nirgataH	nirgam	pos=va,g=m,c=1,n=s,f=part
Srozyasi	Sru	pos=v,p=2,n=s,l=lrt

# id = AmrShtk.62
lagnA	lag	pos=va,g=f,c=1,n=s,f=part
na	na	pos=i
aMSuka	aMSuka	pos=n,comp=y
pallave	pallava	pos=n,g=n,c=7,n=s
Buja	Buja	pos=n,comp=y
latA	latA	pos=n,g=f,c=1,n=s
na	na	pos=i
dvAra	dvAra	pos=n,comp=y
deSe	deSa	pos=n,g=m,c=7,n=s
'rpitA	arpay	pos=va,g=f,c=1,n=s,f=part
no	no	pos=i
vA	vA	pos=i
pAda	pAda	pos=n,comp=y
tale	tala	pos=n,g=m,c=7,n=s
tayA	tad	pos=n,g=f,c=3,n=s
nipatitam	nipat	pos=va,g=n,c=1,n=s,f=part
tizWa	sTA	pos=v,p=2,n=s,l=lot
iti	iti	pos=i
na	na	pos=i
uktam	vac	pos=va,g=n,c=1,n=s,f=part
vacaH	vacas	pos=n,g=n,c=1,n=s
kAle	kAla	pos=n,g=m,c=7,n=s
kevalam	kevalam	pos=i
ambuda	ambuda	pos=n,comp=y
ati	ati	pos=i
maline	malina	pos=a,g=m,c=7,n=s
gantum	gam	pos=vi
pravfttaH	pravft	pos=va,g=m,c=1,n=s,f=part
SaWaH	SaWa	pos=a,g=m,c=1,n=s
tanvyA	tanu	pos=n,g=f,c=6,n=s
bAzpa	bAzpa	pos=n,comp=y
jala	jala	pos=n,comp=y
oGa	oGa	pos=n,comp=y
kalpita	kalpay	pos=va,comp=y,f=part
nadIpUrena	nadIpUra	pos=n,g=m,c=3,n=s
badDaH	banD	pos=va,g=m,c=1,n=s,f=part
priyaH	priya	pos=a,g=m,c=1,n=s

# id = AmrShtk.63
na	na	pos=i
jAne	jYA	pos=v,p=1,n=s,l=lat
saMmuKa	sammuKa	pos=a,comp=y
AyAte	AyA	pos=va,g=m,c=7,n=s,f=part
priyARi	priya	pos=a,g=n,c=2,n=p
vadati	vad	pos=va,g=m,c=7,n=s,f=part
priye	priya	pos=a,g=m,c=7,n=s
sarvARi	sarva	pos=n,g=n,c=1,n=p
aNgAni	aNga	pos=n,g=n,c=1,n=p
me	mad	pos=n,g=,c=6,n=s
yAnti	yA	pos=v,p=3,n=p,l=lat
Srotra	Srotra	pos=n,comp=y
tAm	tA	pos=n,g=f,c=2,n=s
kimu	kimu	pos=i
netra	netra	pos=n,comp=y
tAm	tA	pos=n,g=f,c=2,n=s

# id = AmrShtk.64
viraha	viraha	pos=n,comp=y
vizamaH	vizama	pos=a,g=m,c=1,n=s
kAmo	kAma	pos=n,g=m,c=1,n=s
vAmaH	vAma	pos=a,g=m,c=1,n=s
tanum	tanu	pos=n,g=f,c=2,n=s
kurute	kf	pos=v,p=3,n=s,l=lat
tanum	tanu	pos=a,g=f,c=2,n=s
divasa	divasa	pos=n,comp=y
gaRanA	gaRanA	pos=n,comp=y
dakzaH	dakza	pos=a,g=m,c=1,n=s
ca	ca	pos=i
asO	adas	pos=n,g=m,c=1,n=s
vyapeta	vyape	pos=va,comp=y,f=part
GfRaH	GfRA	pos=n,g=m,c=1,n=s
yamaH	yama	pos=n,g=m,c=1,n=s
tvam	tvad	pos=n,g=,c=1,n=s
api	api	pos=i
vaSago	vaSaga	pos=a,g=m,c=1,n=s
mAna	mAna	pos=n,comp=y
vyADeH	vyADi	pos=n,g=m,c=6,n=s
vicintaya	vicintay	pos=v,p=2,n=s,l=lot
nATa	nATa	pos=n,g=m,c=8,n=s
he	he	pos=i
kisalaya	kisalaya	pos=n,comp=y
mfduH	mfdu	pos=a,g=m,c=1,n=s
jIved	jIv	pos=v,p=3,n=s,l=vidhilin
evam	evam	pos=i
kaTam	kaTam	pos=i
pramadA	pramadA	pos=n,comp=y
janaH	jana	pos=n,g=m,c=1,n=s

# id = AmrShtk.65
pAda	pAda	pos=n,comp=y
Asakte	AsaYj	pos=va,g=m,c=7,n=s,f=part
su	su	pos=i
ciram	ciram	pos=i
iha	iha	pos=i
te	tvad	pos=n,g=,c=6,n=s
vAmatA	vAmatA	pos=n,g=f,c=1,n=s
kA	ka	pos=n,g=f,c=1,n=s
eva	eva	pos=i
kAnte	kAnta	pos=a,g=f,c=8,n=s
sat	sat	pos=a,comp=y
mArga	mArga	pos=n,comp=y
sTe	sTa	pos=a,g=m,c=7,n=s
praRayini	praRayin	pos=a,g=m,c=7,n=s
jane	jana	pos=n,g=m,c=7,n=s
kopane	kopana	pos=a,g=m,c=7,n=s
kaH	ka	pos=n,g=m,c=1,n=s
aparADaH	aparADa	pos=n,g=m,c=1,n=s
itTam	itTam	pos=i
tasyAH	tad	pos=n,g=f,c=6,n=s
parijana	parijana	pos=n,comp=y
kaTA	kaTA	pos=n,g=f,c=1,n=s
kopa	kopa	pos=n,comp=y
vega	vega	pos=n,comp=y
upaSAntO	upaSAnti	pos=n,g=f,c=7,n=s
bAzpa	bAzpa	pos=n,comp=y
udBedEH	udBeda	pos=n,g=m,c=3,n=p
tadanu	tadanu	pos=i
sahasA	sahasA	pos=i
na	na	pos=i
sTitam	sTA	pos=va,g=n,c=1,n=s,f=part
na	na	pos=i
prayAtam	prayA	pos=va,g=n,c=1,n=s,f=part

# id = AmrShtk.66
purA	purA	pos=i
aBUt	BU	pos=v,p=3,n=s,l=lun
naH	mad	pos=n,g=,c=6,n=p
niyatam	niyatam	pos=i
aviBinnA	aviBinna	pos=a,g=f,c=1,n=s
tanuH	tanu	pos=n,g=f,c=1,n=s
iyam	idam	pos=n,g=f,c=1,n=s
tato	tatas	pos=i
nu	nu	pos=i
tvam	tvad	pos=n,g=,c=1,n=s
preyAn	preyas	pos=a,g=m,c=1,n=s
vayam	mad	pos=n,g=,c=1,n=p
api	api	pos=i
hatASAH	hatASa	pos=a,g=f,c=1,n=p
priyatamAH	priyatama	pos=a,g=f,c=1,n=p
idAnIm	idAnIm	pos=i
nATaH	nATa	pos=n,g=m,c=1,n=s
tvam	tvad	pos=n,g=,c=1,n=s
vayam	mad	pos=n,g=,c=1,n=p
api	api	pos=i
kalatram	kalatra	pos=n,g=n,c=1,n=s
kim	ka	pos=n,g=n,c=1,n=s
aparam	apara	pos=n,g=n,c=1,n=s
mayA	mad	pos=n,g=,c=3,n=s
Aptam	Ap	pos=va,g=n,c=1,n=s,f=part
prARAnAm	prARa	pos=n,g=m,c=6,n=p
kuliSa	kuliSa	pos=n,comp=y
kaWinAnAm	kaWina	pos=a,g=m,c=6,n=p
Palam	Pala	pos=n,g=n,c=1,n=s
idam	idam	pos=n,g=n,c=1,n=s

# id = AmrShtk.67
mugDe	muh	pos=va,g=f,c=8,n=s,f=part
mUQa	muh	pos=va,comp=y,f=part
tayA	tA	pos=n,g=f,c=3,n=s
eva	eva	pos=i
netoH	nI	pos=vi
aKilaH	aKila	pos=a,g=m,c=1,n=s
kAlaH	kAla	pos=n,g=m,c=1,n=s
kim	ka	pos=n,g=n,c=2,n=s
AraByate	AraB	pos=v,p=3,n=s,l=lat
mAnam	mAna	pos=n,g=m,c=2,n=s
Datsva	DA	pos=v,p=2,n=s,l=lot
Dftim	Dfti	pos=n,g=f,c=2,n=s
fju	fju	pos=a,comp=y
tAm	tA	pos=n,g=f,c=2,n=s
fjutAm	dUra	pos=a,g=n,c=7,n=s
dUre	kf	pos=v,p=2,n=s,l=lot
kuru	preyas	pos=a,g=m,c=7,n=s
saKyA	saKi	pos=n,g=,c=3,n=s
evam	evam	pos=i
pratiboDitA	pratiboDay	pos=va,g=f,c=1,n=s,f=part
prativacaH	prativacas	pos=n,g=n,c=2,n=s
tAm	tad	pos=n,g=f,c=2,n=s
Aha	ah	pos=v,p=3,n=s,l=lit
BIta	BI	pos=va,comp=y,f=part
AnanA	Anana	pos=n,g=f,c=1,n=s
nIcEH	nIcEs	pos=i
SaMsa	SaMs	pos=v,p=2,n=s,l=lot
hfdi	hfd	pos=n,g=n,c=7,n=s
sTito	sTA	pos=va,g=m,c=1,n=s,f=part
nanu	nanu	pos=i
sa	tad	pos=n,g=m,c=1,n=s
me	mad	pos=n,g=,c=6,n=s
prAReSvaraH	prAReSvara	pos=n,g=m,c=1,n=s
Srozyati	Sru	pos=v,p=3,n=s,l=lrt

# id = AmrShtk.68
pIto	pA	pos=va,g=m,c=1,n=s,f=part
yataH	yatas	pos=i
praBfti	praBfti	pos=i
kAma	kAma	pos=n,comp=y
pipAsitena	pipAsita	pos=a,g=m,c=3,n=s
tasyA	tad	pos=n,g=f,c=6,n=s
mayA	mad	pos=n,g=,c=3,n=s
aDara	aDara	pos=n,comp=y
rasaH	rasa	pos=n,g=m,c=1,n=s
pracuraH	pracura	pos=a,g=m,c=1,n=s
priyAyAH	priya	pos=a,g=f,c=6,n=s
tfzRA	tfzRA	pos=n,g=f,c=1,n=s
tataH	tatas	pos=i
praBfti	praBfti	pos=i
me	mad	pos=n,g=,c=6,n=s
dviguRa	dviguRa	pos=a,comp=y
tvam	tva	pos=n,g=n,c=2,n=s
eti	i	pos=v,p=3,n=s,l=lat
lAvaRyam	lAvaRya	pos=n,g=n,c=1,n=s
asti	as	pos=v,p=3,n=s,l=lat
bahu	bahu	pos=a,g=n,c=1,n=s
tatra	tatra	pos=i
kim	ka	pos=n,g=n,c=1,n=s
api	api	pos=i
citram	citra	pos=n,g=n,c=1,n=s

# id = AmrShtk.69
kva	kva	pos=i
prasTitA	prasTA	pos=va,g=f,c=1,n=s,f=part
asi	as	pos=v,p=2,n=s,l=lat
karaBa	karaBa	pos=n,comp=y
Uru	Uru	pos=n,g=f,c=8,n=s
Gane	Gana	pos=a,g=m,c=7,n=s
niSITe	niSITa	pos=n,g=m,c=7,n=s
prARa	prARa	pos=n,comp=y
aDikaH	aDika	pos=a,g=m,c=1,n=s
vasati	vas	pos=v,p=3,n=s,l=lat
yatra	yatra	pos=i
janaH	jana	pos=n,g=m,c=1,n=s
priyo	priya	pos=a,g=m,c=1,n=s
me	mad	pos=n,g=,c=6,n=s
ekAkinI	ekAkin	pos=a,g=f,c=1,n=s
vada	vad	pos=v,p=2,n=s,l=lot
kaTam	kaTam	pos=i
na	na	pos=i
biBezi	BI	pos=v,p=2,n=s,l=lat
bAle	bAlA	pos=n,g=f,c=8,n=s
nanu	nanu	pos=i
asti	as	pos=v,p=3,n=s,l=lat
puNKita	puNKita	pos=a,comp=y
SaraH	Sara	pos=n,g=m,c=1,n=s
madanaH	madana	pos=n,g=m,c=1,n=s
sahAyaH	sahAya	pos=n,g=m,c=1,n=s

# id = AmrShtk.70
lIlA	lIlA	pos=n,comp=y
tAmarasa	tAmarasa	pos=n,comp=y
AhataH	Ahan	pos=va,g=m,c=1,n=s,f=part
anya	anya	pos=n,comp=y
vanitA	vanitA	pos=n,comp=y
niHSaNka	niHSaNka	pos=a,comp=y
dazwa	daMS	pos=va,comp=y,f=part
aDaraH	aDara	pos=n,g=m,c=1,n=s
kaScid	kaScit	pos=n,g=m,c=1,n=s
kesara	kesara	pos=n,comp=y
dUzita	dUzay	pos=va,comp=y,f=part
IkzaRaH	IkzaRa	pos=n,g=m,c=1,n=s
iva	iva	pos=i
vyAmIlya	vyAmIlay	pos=vi
netre	netra	pos=n,g=n,c=2,n=d
sTitaH	sTA	pos=va,g=m,c=1,n=s,f=part
mugDA	muh	pos=va,g=f,c=1,n=s,f=part
kuqmalita	kuqmalita	pos=a,comp=y
Ananena	Anana	pos=n,g=n,c=3,n=s
daDato	DA	pos=va,g=m,c=6,n=s,f=part
vAyum	vAyu	pos=n,g=m,c=2,n=s
sTitA	sTA	pos=va,g=f,c=1,n=s,f=part
tasya	tad	pos=n,g=m,c=6,n=s
sA	tad	pos=n,g=f,c=1,n=s
BrAntyA	BrAnti	pos=n,g=f,c=3,n=s
DUrta	DUrta	pos=a,comp=y
tayA	tA	pos=n,g=f,c=3,n=s
ca	ca	pos=i
vepaTumatI	vepaTumat	pos=a,g=f,c=1,n=s
tena	tad	pos=n,g=m,c=3,n=s
aniSam	aniSam	pos=i
cumbitA	cumb	pos=va,g=f,c=1,n=s,f=part

# id = AmrShtk.71
sPuwatu	sPuw	pos=v,p=3,n=s,l=lot
hfdayam	hfdaya	pos=n,g=n,c=1,n=s
kAmam	kAmam	pos=i
kAmam	kAma	pos=n,g=m,c=2,n=s
karotu	kf	pos=v,p=3,n=s,l=lot
tanum	tanu	pos=n,g=f,c=2,n=s
tanum	tanu	pos=a,g=f,c=2,n=s
na	na	pos=i
saKi	saKI	pos=n,g=f,c=8,n=s
cawula	cawula	pos=a,comp=y
premRA	preman	pos=n,g=m,c=3,n=s
kAryam	kf	pos=va,g=n,c=1,n=s,f=krtya
punaH	punar	pos=i
dayitena	dayita	pos=a,g=m,c=3,n=s
me	mad	pos=n,g=,c=6,n=s
iti	iti	pos=i
sa	sa	pos=i
raBasam	raBasa	pos=n,g=n,c=2,n=s
mAna	mAna	pos=n,comp=y
AwopAt	Awopa	pos=n,g=m,c=5,n=s
udIrya	udIray	pos=vi
vacaH	vacas	pos=n,g=n,c=2,n=s
tayA	tad	pos=n,g=f,c=3,n=s
ramaRa	ramaRa	pos=n,comp=y
padavIH	padavI	pos=n,g=f,c=1,n=s
sAraNga	sAraNga	pos=n,comp=y
akzayA	akza	pos=a,g=f,c=3,n=s
sa	sa	pos=i
SaNkitam	SaNk	pos=va,g=n,c=2,n=s,f=part
IkzitA	Ikz	pos=va,g=f,c=1,n=s,f=part

# id = AmrShtk.72
gAQa	gAQa	pos=a,comp=y
ASleza	ASleza	pos=n,comp=y
viSIrRa	viSf	pos=va,comp=y,f=part
candana	candana	pos=n,comp=y
rajaH	rajas	pos=n,comp=y
puYja	puYja	pos=n,comp=y
prakarzAt	prakarza	pos=n,g=m,c=5,n=s
iyam	idam	pos=n,g=f,c=1,n=s
SayyA	SayyA	pos=n,g=f,c=1,n=s
samprati	samprati	pos=i
komala	komala	pos=a,comp=y
aNge	aNga	pos=a,g=f,c=8,n=s
paruzA	paruza	pos=a,g=f,c=1,n=s
iti	iti	pos=i
Aropya	Aropay	pos=vi
mAm	mad	pos=n,g=,c=2,n=s
vakzasi	vakzas	pos=n,g=n,c=7,n=s
gAQa	gAQa	pos=a,comp=y
ozWa	ozWa	pos=n,comp=y
graha	graha	pos=n,comp=y
pUrvam	pUrvam	pos=i
Akula	Akula	pos=a,comp=y
tayA	tA	pos=n,g=f,c=3,n=s
pAda	pAda	pos=n,comp=y
agra	agra	pos=n,comp=y
saMdaMSakena	saMdaMSaka	pos=n,g=m,c=3,n=s
Akfzya	Akfz	pos=vi
ambaram	ambara	pos=n,g=n,c=2,n=s
AtmanaH	Atman	pos=n,g=m,c=6,n=s
yat	yad	pos=n,g=n,c=1,n=s
ucitam	ucita	pos=a,g=n,c=1,n=s
DUrtena	DUrta	pos=n,g=m,c=3,n=s
tat	tad	pos=n,g=n,c=1,n=s
prastutam	prastu	pos=va,g=n,c=1,n=s,f=part

# id = AmrShtk.73
kaTam	kaTam	pos=i
api	api	pos=i
kfta	kf	pos=va,comp=y,f=part
pratyAKyAne	pratyAKyAna	pos=n,g=m,c=7,n=s
priye	priya	pos=a,g=m,c=7,n=s
sKalita	sKal	pos=va,comp=y,f=part
uttare	uttara	pos=n,g=m,c=7,n=s
viraha	viraha	pos=n,comp=y
kfSayA	kfSa	pos=a,g=f,c=3,n=s
kftvA	kf	pos=vi
vyAjam	vyAja	pos=n,g=m,c=2,n=s
prakalpitam	prakalpay	pos=va,g=m,c=2,n=s,f=part
aSrutam	aSruta	pos=a,g=m,c=2,n=s
asahana	asahana	pos=a,comp=y
saKi	saKI	pos=n,comp=y
Srotra	Srotra	pos=n,comp=y
prApti	prApti	pos=n,comp=y
pramAda	pramAda	pos=n,comp=y
sa	sa	pos=i
saMBramam	samBrama	pos=n,g=m,c=2,n=s
vigalita	vigal	pos=va,comp=y,f=part
dfSA	dfS	pos=n,g=f,c=3,n=s
SUnye	SUnya	pos=a,g=n,c=7,n=s
gehe	geha	pos=n,g=n,c=7,n=s
samucCvasitam	samucCvas	pos=va,g=n,c=1,n=s,f=part
punaH	punar	pos=i

# id = AmrShtk.74
dfzwi	dfzwi	pos=n,comp=y
prasarAt	prasara	pos=n,g=m,c=5,n=s
priyasya	priya	pos=a,g=m,c=6,n=s
padavIm	padavI	pos=n,g=f,c=2,n=s
udvIkzya	udvIkz	pos=vi
nirviRRayA	nirviRRa	pos=a,g=f,c=3,n=s
vicCinnezu	vicCid	pos=va,g=n,c=7,n=p,f=part
paTin	paTin	pos=n,g=,c=7,n=p
ahaH	ahar	pos=n,comp=y
pariRatO	pariRati	pos=n,g=f,c=7,n=s
DvAnte	DvAnta	pos=n,g=n,c=7,n=s
samutsarpati	samutsfp	pos=va,g=n,c=7,n=s,f=part
datta	dA	pos=va,comp=y,f=part
ekam	eka	pos=n,g=n,c=1,n=s
sa	sa	pos=i
SucA	Suc	pos=n,g=f,c=3,n=s
gfham	gfha	pos=n,g=n,c=2,n=s
prati	prati	pos=i
padam	pada	pos=n,g=n,c=1,n=s
pAnTa	pAnTa	pos=n,comp=y
striyA	strI	pos=n,g=f,c=3,n=s
asmin	idam	pos=n,g=m,c=7,n=s
kzaRe	kzaRa	pos=n,g=m,c=7,n=s
mA	mA	pos=i
BUt	BU	pos=v,p=3,n=s,l=lun_unaug
AgataH	Agam	pos=va,g=m,c=1,n=s,f=part
iti	iti	pos=i
amanda	amanda	pos=a,comp=y
valita	valita	pos=n,comp=y
grIvam	grIvA	pos=n,g=n,c=2,n=s
punaH	punar	pos=i
vIkzitam	vIkz	pos=va,g=n,c=1,n=s,f=part

# id = AmrShtk.75
AyAte	AyA	pos=va,g=m,c=7,n=s,f=part
dayite	dayita	pos=a,g=f,c=8,n=s
manoraTa	manoraTa	pos=n,comp=y
SatEH	Sata	pos=n,g=n,c=3,n=p
nItvA	nI	pos=vi
kaTaMcid	kaTaMcid	pos=i
dinam	dina	pos=n,g=n,c=2,n=s
vEdagDya	vEdagDya	pos=n,comp=y
apagamAt	apagama	pos=n,g=m,c=5,n=s
jaqe	jaqa	pos=a,g=m,c=7,n=s
parijane	parijana	pos=n,g=m,c=7,n=s
dIrGAm	dIrGa	pos=a,g=f,c=2,n=s
kaTAm	kaTA	pos=n,g=f,c=2,n=s
kurvati	kf	pos=va,g=m,c=7,n=s,f=part
dazwA	daMS	pos=va,g=f,c=1,n=s,f=part
asmi	as	pos=v,p=1,n=s,l=lat
iti	iti	pos=i
aBiDAya	aBiDA	pos=vi
satvara	satvara	pos=a,comp=y
padam	pada	pos=n,g=n,c=2,n=s
vyADUya	vyADU	pos=vi
cIna	cIna	pos=n,comp=y
aMSukam	aMSuka	pos=n,g=m,c=2,n=s
tanu	tanu	pos=a,comp=y
aNgayA	aNga	pos=a,g=f,c=3,n=s
rati	rati	pos=n,comp=y
kAtarena	kAtara	pos=a,g=n,c=3,n=s
manasA	manas	pos=n,g=n,c=3,n=s
nItaH	nI	pos=va,g=m,c=1,n=s,f=part
pradIpaH	pradIpa	pos=n,g=m,c=1,n=s
Samam	Sama	pos=n,g=m,c=2,n=s

# id = AmrShtk.76
Alambya	Alamb	pos=vi
aNgaRa	aNgaRa	pos=n,comp=y
vAwikA	vAwikA	pos=n,comp=y
parisare	parisara	pos=n,g=m,c=7,n=s
cUta	cUta	pos=n,comp=y
drume	druma	pos=n,g=m,c=7,n=s
maYjarIm	maYjarI	pos=n,g=f,c=2,n=s
sfp	sfp	pos=va,comp=y,f=part
sAndra	sAndra	pos=a,comp=y
parAga	parAga	pos=n,comp=y
lampawa	lampawa	pos=a,comp=y
raR	raR	pos=va,comp=y,f=part
BfNga	BfNga	pos=n,comp=y
aNganA	aNganA	pos=n,comp=y
SoBin	SoBin	pos=a,g=f,c=2,n=s
manye	man	pos=v,p=1,n=s,l=lat
svAm	sva	pos=a,g=f,c=2,n=s
tanum	tanu	pos=n,g=f,c=2,n=s
uttarIya	uttarIya	pos=n,comp=y
Sakalena	Sakala	pos=n,g=m,c=3,n=s
AcCAdya	AcCAday	pos=vi
bAlA	bAlA	pos=n,g=f,c=1,n=s
sPurat	sPur	pos=va,comp=y,f=part
kaRWa	kaRWa	pos=n,comp=y
DvAna	DvAna	pos=n,comp=y
niroDa	niroDa	pos=n,comp=y
kamp	kamp	pos=va,comp=y,f=part
kuca	kuca	pos=n,comp=y
SvAsa	SvAsa	pos=n,comp=y
udgamA	udgama	pos=n,g=f,c=1,n=s
roditi	rud	pos=v,p=3,n=s,l=lat

# id = AmrShtk.77
yA	yad	pos=n,g=f,c=1,n=s
asyAm	idam	pos=n,g=f,c=7,n=s
iti	iti	pos=i
samudyatasya	samudyam	pos=va,g=m,c=6,n=s,f=part
gaditam	gad	pos=va,g=n,c=1,n=s,f=part
viSrabDam	viSramB	pos=va,g=n,c=1,n=s,f=part
AkarRitam	AkarRay	pos=va,g=n,c=1,n=s,f=part
gacCan	gam	pos=v,p=3,n=p,l=lan
dUram	dUra	pos=a,g=n,c=2,n=s
upekzitaH	upekz	pos=va,g=m,c=1,n=s,f=part
muhuH	muhur	pos=i
asO	adas	pos=n,g=m,c=1,n=s
vyAvftya	vyAvft	pos=vi
tizWan	sTA	pos=va,g=m,c=1,n=s,f=part
api	api	pos=i
tad	tad	pos=n,comp=y
SUnye	SUnya	pos=a,g=n,c=7,n=s
punaH	punar	pos=i
AsTitA	AsTA	pos=va,g=f,c=1,n=s,f=part
asmi	as	pos=v,p=1,n=s,l=lat
Bavane	Bavana	pos=n,g=n,c=7,n=s
prARAH	prARa	pos=n,g=m,c=1,n=p
te	tad	pos=n,g=m,c=1,n=p
ete	etad	pos=n,g=m,c=1,n=p
dfQAH	dfQa	pos=a,g=m,c=1,n=p
saKI	saKI	pos=n,g=f,c=8,n=p
tizWata	sTA	pos=v,p=2,n=p,l=lot
jIvita	jIvita	pos=n,comp=y
vyasanin	vyasanin	pos=a,g=f,c=1,n=s
damBAt	damBa	pos=n,g=m,c=5,n=s
aham	mad	pos=n,g=,c=1,n=s
rodimi	rud	pos=v,p=1,n=s,l=lat

# id = AmrShtk.78
SUnyam	SUnya	pos=a,g=n,c=2,n=s
vAsagfham	vAsagfha	pos=n,g=n,c=2,n=s
vilokya	vilokay	pos=vi
SayanAt	Sayana	pos=n,g=n,c=5,n=s
utTAya	utTA	pos=vi
kiMcid	kaScit	pos=n,g=n,c=2,n=s
SanEs	SanEs	pos=i
nidrA	nidrA	pos=n,comp=y
vyAjam	vyAja	pos=n,g=m,c=2,n=s
upAgatasya	upAgam	pos=va,g=m,c=6,n=s,f=part
su	su	pos=i
ciram	ciram	pos=i
nirvarRya	nirvarRay	pos=vi
patyuH	pati	pos=n,g=,c=6,n=s
muKam	muKa	pos=n,g=n,c=2,n=s
viSrabDam	viSramB	pos=va,g=n,c=2,n=s,f=part
paricumbya	paricumb	pos=vi
jAta	jan	pos=va,comp=y,f=part
pulakAm	pulaka	pos=n,g=f,c=2,n=s
Alokya	Alokay	pos=vi
gaRqa	gaRqa	pos=n,comp=y
sTalIm	sTalI	pos=n,g=f,c=2,n=s
lajjA	lajjA	pos=n,comp=y
namra	namra	pos=a,comp=y
muKI	muKa	pos=a,g=f,c=1,n=s
priyeRa	priya	pos=a,g=m,c=3,n=s
hasatA	has	pos=va,g=m,c=3,n=s,f=part
bAlA	bAlA	pos=n,g=f,c=1,n=s
ciram	ciram	pos=i
cumbitA	cumb	pos=va,g=f,c=1,n=s,f=part

# id = AmrShtk.79
lul	lul	pos=va,comp=y,f=part
BrU	BrU	pos=n,comp=y
latayA	latA	pos=n,g=f,c=3,n=s
vipakza	vipakza	pos=n,comp=y
diH	diS	pos=n,comp=y
upanyAse	upanyAsa	pos=n,g=m,c=7,n=s
avaDUtam	avaDU	pos=va,g=n,c=1,n=s,f=part
Siras	Siras	pos=n,g=n,c=1,n=s
tad	tad	pos=n,comp=y
vfttAnta	vfttAnta	pos=n,comp=y
nirIkzaRe	nirIkzaRa	pos=n,g=n,c=7,n=s
kfta	kf	pos=va,comp=y,f=part
namaskAraH	namaskAra	pos=n,g=m,c=1,n=s
vilakzaH	vilakza	pos=a,g=m,c=1,n=s
sTitaH	sTA	pos=va,g=m,c=1,n=s,f=part
kopAt	kopa	pos=n,g=m,c=5,n=s
tAmra	tAmra	pos=a,comp=y
kapolaBitti	kapolaBitti	pos=n,g=n,c=7,n=s
muKe	muKa	pos=n,g=n,c=7,n=s
dfzwyA	dfzwi	pos=n,g=f,c=6,n=s
gataH	gam	pos=va,g=m,c=1,n=s,f=part
pAdayoH	pAda	pos=n,g=m,c=7,n=d
utsfzwo	utsfj	pos=va,g=m,c=1,n=s,f=part
guru	guru	pos=n,comp=y
saMniDO	saMniDi	pos=n,g=m,c=7,n=s
api	api	pos=i
viDiH	viDi	pos=n,g=m,c=1,n=s
dvAByAm	dvi	pos=n,g=m,c=3,n=d
na	na	pos=i
kAla	kAla	pos=n,comp=y
ucitaH	ucita	pos=a,g=m,c=1,n=s

# id = AmrShtk.80
jAtA	jan	pos=va,g=f,c=1,n=s,f=part
na	na	pos=i
utkalikA	utkalikA	pos=n,g=f,c=1,n=s
stanO	stana	pos=n,g=m,c=1,n=d
na	na	pos=i
lulitO	lul	pos=va,g=m,c=1,n=d,f=part
gAtram	gAtra	pos=n,g=n,c=1,n=s
na	na	pos=i
romAYcitam	romAYcita	pos=a,g=n,c=1,n=s
vaktram	vaktra	pos=n,g=n,c=1,n=s
sveda	sveda	pos=n,comp=y
kaRA	kaRA	pos=n,comp=y
anvitam	anvita	pos=a,g=n,c=1,n=s
na	na	pos=i
sahasA	sahasA	pos=i
yAvat	yAvat	pos=i
SaWena	SaWa	pos=a,g=m,c=3,n=s
amunA	adas	pos=n,g=m,c=3,n=s
dfzwena	dfS	pos=va,g=m,c=3,n=s,f=part
eva	eva	pos=i
mano	manas	pos=n,g=n,c=1,n=s
hftam	hf	pos=va,g=n,c=1,n=s,f=part
Dfti	Dfti	pos=n,comp=y
muH	muz	pos=n,g=m,c=3,n=s
prAReSvarena	prAReSvara	pos=n,g=m,c=3,n=s
adya	adya	pos=i
me	mad	pos=n,g=,c=6,n=s
tat	tad	pos=n,g=n,c=1,n=s
kena	ka	pos=n,g=m,c=3,n=s
atra	atra	pos=i
nirUpay	nirUpay	pos=va,comp=y,f=part
nipuRaH	nipuRa	pos=a,g=m,c=1,n=s
mAnaH	mAna	pos=n,g=m,c=1,n=s
samADIyatAm	samADA	pos=v,p=3,n=s,l=lot

# id = AmrShtk.81
dfzwaH	dfS	pos=va,g=m,c=1,n=s,f=part
kAtara	kAtara	pos=a,comp=y
netrayA	netra	pos=n,g=f,c=3,n=s
cirataram	ciratara	pos=a,g=n,c=2,n=s
badDAYjalim	badDAYjali	pos=a,g=f,c=2,n=s
yAcitaH	yAc	pos=va,g=m,c=1,n=s,f=part
paScAt	paScAt	pos=i
aMSuka	aMSuka	pos=n,comp=y
pallavena	pallava	pos=n,g=m,c=3,n=s
viDfto	viDf	pos=va,g=m,c=1,n=s,f=part
nirvyAjam	nirvyAja	pos=a,g=n,c=2,n=s
AliNgitaH	AliNgay	pos=va,g=m,c=1,n=s,f=part
iti	iti	pos=i
Akzipya	Akzip	pos=vi
yadA	yadA	pos=i
samastam	samasta	pos=a,g=n,c=2,n=s
aGfRaH	aGfRa	pos=a,g=m,c=1,n=s
gantum	gam	pos=vi
pravfttaH	pravft	pos=va,g=m,c=1,n=s,f=part
SaWaH	SaWa	pos=a,g=m,c=1,n=s
pUrvam	pUrvam	pos=i
prARa	prARa	pos=n,comp=y
parigrahaH	parigraha	pos=n,g=m,c=1,n=s
dayitayA	dayitA	pos=n,g=f,c=3,n=s
muktaH	muc	pos=va,g=m,c=1,n=s,f=part
tatas	tatas	pos=i
vallaBaH	vallaBa	pos=a,g=m,c=1,n=s

# id = AmrShtk.82
kfto	kf	pos=va,g=m,c=1,n=s,f=part
dUrAt	dUra	pos=a,g=n,c=5,n=s
eva	eva	pos=i
smita	smi	pos=va,comp=y,f=part
maDuram	maDura	pos=n,g=n,c=1,n=s
aByudgama	aByudgama	pos=n,comp=y
viDiH	viDi	pos=n,g=m,c=1,n=s
Sirasi	Siras	pos=n,g=n,c=7,n=s
AjYA	AjYA	pos=n,g=f,c=1,n=s
nyastA	nyas	pos=va,g=f,c=1,n=s,f=part
prativacanavat	prativacanavat	pos=a,g=f,c=8,n=s
Anatimat	Anatimat	pos=a,g=f,c=8,n=s
na	na	pos=i
dfzweH	dfzwi	pos=n,g=f,c=6,n=s
SETilyam	SETilya	pos=n,g=n,c=1,n=s
milana	milana	pos=n,g=n,c=7,n=s
iti	iti	pos=i
ceto	cetas	pos=n,g=n,c=1,n=s
dahati	dah	pos=v,p=3,n=s,l=lat
me	mad	pos=n,g=,c=6,n=s
nigUQa	niguh	pos=va,comp=y,f=part
antaH	antar	pos=i
kopAt	kopa	pos=n,g=m,c=5,n=s
kaWina	kaWina	pos=a,comp=y
hfdaye	hfdaya	pos=n,g=f,c=8,n=s
saMvftiH	saMvfti	pos=n,g=f,c=1,n=s
iyam	idam	pos=n,g=f,c=1,n=s

# id = AmrShtk.83
ekasmin	eka	pos=n,g=n,c=7,n=s
Sayane	Sayana	pos=n,g=n,c=7,n=s
vipakza	vipakza	pos=n,comp=y
ramaRI	ramaRI	pos=n,g=f,c=6,n=p
agrahe	agraha	pos=n,g=m,c=7,n=s
mugDayA	muh	pos=va,g=f,c=3,n=s,f=part
sadyaH	sadyas	pos=i
kopa	kopa	pos=n,comp=y
parANmuKam	parANmuKa	pos=a,g=n,c=2,n=s
SayitayA	SI	pos=va,g=f,c=3,n=s,f=part
cAwUni	cAwu	pos=n,g=n,c=2,n=p
kurvan	kf	pos=va,g=m,c=1,n=s,f=part
api	api	pos=i
AvegAt	Avega	pos=n,g=m,c=5,n=s
avaDIritaH	avaDIrita	pos=a,g=m,c=1,n=s
priyatamaH	priyatama	pos=a,g=m,c=1,n=s
tUzRIm	tUzRIm	pos=i
sTitaH	sTA	pos=va,g=m,c=1,n=s,f=part
tad	tad	pos=n,comp=y
kzaRAt	kzaRa	pos=n,g=m,c=5,n=s
mA	mad	pos=n,g=,c=2,n=s
BUH	BU	pos=v,p=2,n=s,l=lun_unaug
supta	svap	pos=va,g=m,c=1,n=s,f=part
iva	iva	pos=i
eza	etad	pos=n,g=m,c=1,n=s
manda	manda	pos=a,comp=y
valita	val	pos=va,comp=y,f=part
grIvam	grIvA	pos=n,g=n,c=2,n=s
punaH	punar	pos=i
vIkzitaH	vIkz	pos=va,g=m,c=1,n=s,f=part

# id = AmrShtk.84
malaya	malaya	pos=n,comp=y
marutAm	marut	pos=n,g=m,c=6,n=p
vAtA	vAta	pos=n,g=m,c=1,n=p
yAtA	yA	pos=va,g=m,c=1,n=p,f=part
vikAsay	vikAsay	pos=va,comp=y,f=part
mallikA	mallikA	pos=n,comp=y
parimala	parimala	pos=n,comp=y
BaraH	Bara	pos=n,g=m,c=1,n=s
Bagno	BaYj	pos=va,g=m,c=1,n=s,f=part
grIzmaH	grIzma	pos=n,g=m,c=1,n=s
tvam	tva	pos=n,g=n,c=2,n=s
utsahase	utsah	pos=v,p=2,n=s,l=lat
yadi	yadi	pos=i
Gana	Gana	pos=n,g=m,c=8,n=s
Gawayitum	Gaway	pos=vi
niHsneham	niHsneha	pos=a,g=m,c=2,n=s
tvAm	tvad	pos=n,g=,c=2,n=s
ya	yad	pos=n,g=m,c=1,n=s
eva	eva	pos=i
nivartane	nivartana	pos=n,g=n,c=7,n=s
praBavati	praBU	pos=v,p=3,n=s,l=lat
gavAm	go	pos=n,g=,c=6,n=p
kim	ka	pos=n,g=n,c=1,n=s
naH	mad	pos=n,g=,c=4,n=p
Cinnam	Cid	pos=va,g=n,c=1,n=s,f=part
sa	tad	pos=n,g=m,c=1,n=s
eva	eva	pos=i
DanaYjayaH	DanaMjaya	pos=n,g=m,c=1,n=s

# id = AmrShtk.85
svam	sva	pos=a,g=n,c=2,n=s
dfzwvA	dfS	pos=vi
karaja	karaja	pos=n,comp=y
kzatam	kzata	pos=n,g=n,c=2,n=s
maDumat	maDumat	pos=a,comp=y
akzIbA	akzIba	pos=a,g=f,c=1,n=s
vicArya	vicAray	pos=vi
IrzyayA	IrzyA	pos=n,g=f,c=3,n=s
gacCantI	gam	pos=va,g=f,c=1,n=s,f=part
kva	kva	pos=i
nu	nu	pos=i
gacCasi	gam	pos=v,p=2,n=s,l=lat
iti	iti	pos=i
viDftA	viDf	pos=va,g=f,c=1,n=s,f=part
bAlA	bAla	pos=a,g=f,c=1,n=s
pawa	pawa	pos=n,comp=y
ante	anta	pos=n,g=m,c=7,n=s
mayA	mad	pos=n,g=,c=3,n=s
pratyAvft	pratyAvft	pos=va,comp=y,f=part
muKI	muKa	pos=a,g=f,c=1,n=s
sa	sa	pos=i
bAzpa	bAzpa	pos=n,comp=y
nayanA	nayana	pos=n,g=f,c=1,n=s
mAm	mad	pos=n,g=,c=2,n=s
muYca	muc	pos=v,p=2,n=s,l=lot
muYca	muc	pos=v,p=2,n=s,l=lot
iti	iti	pos=i
sA	tad	pos=n,g=f,c=1,n=s
kopAt	kopa	pos=n,g=m,c=5,n=s
prasPurita	prasPur	pos=va,comp=y,f=part
aDara	aDara	pos=n,g=f,c=1,n=p
yat	yad	pos=n,g=n,c=2,n=s
avadat	vad	pos=v,p=3,n=s,l=lan
tat	tad	pos=n,g=n,c=1,n=s
kena	ka	pos=n,g=m,c=3,n=s
vismaryate	vismf	pos=v,p=3,n=s,l=lat

# id = AmrShtk.86
sa	sa	pos=i
alaktakam	alaktaka	pos=n,g=n,c=1,n=s
SatadalA	SatadalA	pos=n,comp=y
aDika	aDika	pos=a,comp=y
kAnti	kAnti	pos=n,comp=y
ramyam	ramya	pos=a,g=n,c=1,n=s
ratna	ratna	pos=n,comp=y
oGa	oGa	pos=n,comp=y
DAma	DAman	pos=n,comp=y
nikara	nikara	pos=n,comp=y
aruRa	aruRa	pos=a,comp=y
nUpuram	nUpura	pos=n,g=n,c=1,n=s
ca	ca	pos=i
kziptam	kzip	pos=va,g=n,c=1,n=s,f=part
BfSam	BfSam	pos=i
kupitayA	kup	pos=va,g=f,c=3,n=s,f=part
tarala	tarala	pos=a,comp=y
utpala	utpala	pos=n,comp=y
akzayA	akza	pos=a,g=f,c=3,n=s
sOBAgya	sOBAgya	pos=n,comp=y
cihnam	cihna	pos=n,g=n,c=1,n=s
iva	iva	pos=i
mUrDni	mUrDan	pos=n,g=m,c=7,n=s
padam	pada	pos=n,g=n,c=1,n=s
vireje	virAj	pos=v,p=3,n=s,l=lit

# id = AmrShtk.87
kapole	kapola	pos=n,g=m,c=7,n=s
pattra	pattra	pos=n,comp=y
AliH	Ali	pos=n,g=f,c=1,n=s
kara	kara	pos=n,comp=y
tala	tala	pos=n,comp=y
niroDena	niroDa	pos=n,g=m,c=3,n=s
mfditA	mfd	pos=va,g=f,c=1,n=s,f=part
nipIto	nipA	pos=va,g=m,c=1,n=s,f=part
niHSvAsEH	niHSvAsa	pos=n,g=m,c=3,n=p
ayam	idam	pos=n,g=m,c=1,n=s
amfta	amfta	pos=n,comp=y
hfdyaH	hfdya	pos=a,g=m,c=1,n=s
aDara	aDara	pos=n,comp=y
rasaH	rasa	pos=n,g=m,c=1,n=s
muhuH	muhur	pos=i
kaRWe	kaRWa	pos=n,g=m,c=7,n=s
lagnas	lag	pos=va,g=m,c=1,n=s,f=part
taralayati	taralay	pos=v,p=3,n=s,l=lat
bAzpaH	bAzpa	pos=n,g=m,c=1,n=s
stana	stana	pos=n,comp=y
tawam	tawa	pos=n,g=n,c=2,n=s
priyo	priya	pos=a,g=m,c=1,n=s
manyuH	manyu	pos=n,g=m,c=1,n=s
jAtaH	jan	pos=va,g=m,c=1,n=s,f=part
te	tvad	pos=n,g=,c=6,n=s
niranuroDe	niranuroDa	pos=a,g=m,c=7,n=s
na	na	pos=i
tu	tu	pos=i
vayam	mad	pos=n,g=,c=1,n=p

# id = AmrShtk.88
lAkzA	lAkzA	pos=n,comp=y
lakzman	lakzman	pos=n,comp=y
lalAwa	lalAwa	pos=n,comp=y
pawwam	pawwa	pos=n,g=m,c=2,n=s
aBitas	aBitas	pos=i
keyUra	keyUra	pos=n,comp=y
mudrA	mudrA	pos=n,g=f,c=1,n=s
gale	gala	pos=n,g=m,c=7,n=s
vaktre	vaktra	pos=n,g=n,c=7,n=s
kajjala	kajjala	pos=n,comp=y
kAlimA	kAliman	pos=n,g=m,c=1,n=s
nayanayos	nayana	pos=n,g=n,c=6,n=d
tAmbUla	tAmbUla	pos=n,comp=y
rAgaH	rAga	pos=n,g=m,c=1,n=s
GanaH	Gana	pos=a,g=m,c=1,n=s
dfzwA	dfS	pos=va,g=f,c=1,n=s,f=part
kopa	kopa	pos=n,comp=y
viDAyin	viDAyin	pos=a,g=n,c=1,n=s
maRqanam	maRqana	pos=n,g=n,c=1,n=s
idam	idam	pos=n,g=n,c=1,n=s
prAtaH	prAtar	pos=i
ciram	ciram	pos=i
preyaso	preyas	pos=a,g=m,c=6,n=s
lIlA	lIlA	pos=n,comp=y
tAmarasa	tAmarasa	pos=n,comp=y
udare	udara	pos=n,g=n,c=7,n=s
mfga	mfga	pos=n,comp=y
dfSaH	dfS	pos=n,g=f,c=6,n=s
SvAsAH	SvAsa	pos=n,g=m,c=1,n=p
samAptim	samApti	pos=n,g=f,c=2,n=s
gatAH	gam	pos=va,g=m,c=1,n=p,f=part

# id = AmrShtk.89
tapte	tap	pos=va,g=n,c=7,n=s,f=part
mahA	mahat	pos=a,comp=y
viraha	viraha	pos=n,comp=y
vahni	vahni	pos=n,comp=y
SiKA	SiKA	pos=n,comp=y
AvaliBiH	Avali	pos=n,g=f,c=3,n=p
ApARqura	ApARqura	pos=a,comp=y
stana	stana	pos=n,comp=y
tawe	tawa	pos=n,g=n,c=7,n=s
hfdaye	hfdaya	pos=n,g=n,c=7,n=s
priyAyAH	priya	pos=a,g=f,c=6,n=s
raTyA	raTyA	pos=n,comp=y
AlI	Ali	pos=n,comp=y
vIkzaRa	vIkzaRa	pos=n,comp=y
niveSita	niveSay	pos=va,comp=y,f=part
lola	lola	pos=a,comp=y
dfzwyAH	dfzwi	pos=n,g=f,c=6,n=s
nUnam	nUnam	pos=i
CanacCaniti	CanacCaniti	pos=i
bAzpa	bAzpa	pos=n,comp=y
kaRAH	kaRA	pos=n,g=f,c=1,n=p
patanti	pat	pos=v,p=3,n=p,l=lat

# id = AmrShtk.90
cintA	cintA	pos=n,comp=y
moha	moha	pos=n,comp=y
viniScalena	viniScala	pos=a,g=n,c=3,n=s
manasA	manas	pos=n,g=n,c=3,n=s
mOnena	mOna	pos=n,g=n,c=3,n=s
pAda	pAda	pos=n,comp=y
AnataH	Anam	pos=va,g=m,c=1,n=s,f=part
pratyAKyAna	pratyAKyAna	pos=n,comp=y
parANmuKaH	parANmuKa	pos=a,g=m,c=1,n=s
priyatamo	priyatama	pos=a,g=m,c=1,n=s
gantum	gam	pos=vi
pravfttaH	pravft	pos=va,g=m,c=1,n=s,f=part
aDunA	aDunA	pos=i
sa	sa	pos=i
vrIqA	vrIqA	pos=n,g=n,c=3,n=p
alasEH	alasa	pos=a,g=n,c=3,n=p
nirantara	nirantara	pos=a,comp=y
luW	luW	pos=va,comp=y,f=part
bAzpa	bAzpa	pos=n,comp=y
AkulEH	Akula	pos=a,g=n,c=3,n=p
locanEH	locana	pos=n,g=n,c=3,n=p
SvAsa	SvAsa	pos=n,comp=y
utkampa	utkampa	pos=n,comp=y
kucam	kuca	pos=n,g=m,c=2,n=s
nirIkzya	nirIkz	pos=vi
su	su	pos=i
ciram	ciram	pos=i
jIva	jIva	pos=n,comp=y
ASayA	ASA	pos=n,g=f,c=3,n=s
vAritaH	vAray	pos=va,g=m,c=1,n=s,f=part

# id = AmrShtk.91
tanu	tanu	pos=a,comp=y
aNgAyAH	aNga	pos=a,g=f,c=6,n=s
guru	guru	pos=n,comp=y
saMniDO	saMniDi	pos=n,g=m,c=7,n=s
nayana	nayana	pos=n,comp=y
jam	ja	pos=a,g=n,c=1,n=s
yad	yad	pos=n,g=n,c=1,n=s
vAri	vAri	pos=n,g=n,c=1,n=s
saMstamBitam	saMstamBay	pos=va,g=n,c=1,n=s,f=part
tena	tad	pos=n,g=n,c=3,n=s
antaH	antar	pos=i
galitena	gal	pos=va,g=n,c=3,n=s,f=part
manmaTa	manmaTa	pos=n,comp=y
SiKI	SiKin	pos=n,g=m,c=1,n=s
siktaH	sic	pos=va,g=m,c=1,n=s,f=part
anuzaNga	anuzaNga	pos=n,comp=y
udBavaH	udBava	pos=a,g=m,c=1,n=s
manye	man	pos=v,p=1,n=s,l=lat
tasya	tad	pos=n,g=m,c=6,n=s
niras	niras	pos=va,comp=y,f=part
kiraRasya	kiraRa	pos=n,g=m,c=6,n=s
ezA	etad	pos=n,g=f,c=1,n=s
muKena	muKa	pos=n,g=n,c=3,n=s
udgatA	udgam	pos=va,g=f,c=1,n=s,f=part
SvAsa	SvAsa	pos=n,comp=y
Amoda	Amoda	pos=n,comp=y
samAkula	samAkula	pos=a,comp=y
Ali	Ali	pos=n,comp=y
nikara	nikara	pos=n,comp=y
vyAjena	vyAja	pos=n,g=m,c=3,n=s
DUma	DUma	pos=n,comp=y
AvalI	Avali	pos=n,g=f,c=1,n=s

# id = AmrShtk.92
BrU	BrU	pos=n,comp=y
BedaH	Beda	pos=n,g=m,c=1,n=s
racitaH	racay	pos=va,g=m,c=1,n=s,f=part
ciram	ciram	pos=i
nayanayoH	nayana	pos=n,g=n,c=6,n=d
aByastam	aByas	pos=va,g=n,c=1,n=s,f=part
AmIlanam	AmIlana	pos=n,g=n,c=1,n=s
rodDum	ruD	pos=vi
Sikzitam	Sikzay	pos=va,g=n,c=2,n=s,f=part
AdareRa	Adara	pos=n,g=m,c=3,n=s
hasitam	hasita	pos=n,g=n,c=2,n=s
mOne	mOna	pos=n,g=n,c=7,n=s
aBiyogaH	aBiyoga	pos=n,g=m,c=1,n=s
kftaH	kf	pos=va,g=m,c=1,n=s,f=part
DEryam	DErya	pos=n,g=n,c=2,n=s
kartum	kf	pos=vi
api	api	pos=i
sTirIkftam	sTirIkf	pos=va,g=n,c=1,n=s,f=part
idam	idam	pos=n,g=n,c=1,n=s
cetaH	cetas	pos=n,g=n,c=1,n=s
kaTaMcin	kaTaMcid	pos=i
mayA	mad	pos=n,g=,c=3,n=s
badDo	banD	pos=va,g=m,c=1,n=s,f=part
mAna	mAna	pos=n,comp=y
parigrahe	parigraha	pos=n,g=m,c=7,n=s
parikaraH	parikara	pos=n,g=m,c=1,n=s
sidDiH	sidDi	pos=n,g=f,c=1,n=s
tu	tu	pos=i
dEva	dEva	pos=n,comp=y
sTitA	sTA	pos=va,g=f,c=1,n=s,f=part

# id = AmrShtk.93
deSEH	deSa	pos=n,g=m,c=3,n=p
antaritA	antari	pos=va,g=f,c=1,n=s,f=part
SatEH	Sata	pos=n,g=n,c=3,n=p
ca	ca	pos=i
saritAm	sarit	pos=n,g=f,c=6,n=p
urvIBft	urvIBft	pos=n,g=m,c=6,n=p
kAnanEH	kAnana	pos=n,g=n,c=3,n=p
yatnena	yatna	pos=n,g=m,c=3,n=s
api	api	pos=i
na	na	pos=i
yAti	yA	pos=v,p=3,n=s,l=lat
locana	locana	pos=n,comp=y
paTam	paTa	pos=n,g=m,c=2,n=s
kAntA	kAntA	pos=n,g=f,c=1,n=s
iti	iti	pos=i
jAnan	jYA	pos=va,g=m,c=1,n=s,f=part
api	api	pos=i
udgrIvaH	udgrIva	pos=a,g=m,c=1,n=s
caraRa	caraRa	pos=n,comp=y
arDa	arDa	pos=n,comp=y
rudDa	ruD	pos=va,comp=y,f=part
vasuDaH	vasuDA	pos=n,g=m,c=1,n=s
kftvA	kf	pos=vi
aSru	aSru	pos=n,comp=y
pUrRAm	pf	pos=va,g=f,c=2,n=s,f=part
dfSam	dfS	pos=n,g=f,c=2,n=s
tAm	tad	pos=n,g=f,c=2,n=s
ASAm	ASA	pos=n,g=f,c=2,n=s
paTikaH	paTika	pos=n,g=m,c=1,n=s
taTA	taTA	pos=i
api	api	pos=i
kim	ka	pos=n,g=n,c=2,n=s
api	api	pos=i
DyAyan	DyA	pos=va,g=m,c=1,n=s,f=part
ciram	ciram	pos=i
vIkzate	vIkz	pos=v,p=3,n=s,l=lat

# id = AmrShtk.94
mlAnam	mlA	pos=va,g=n,c=1,n=s,f=part
pARqu	pARqu	pos=a,g=n,c=1,n=s
kfSam	kfSa	pos=a,g=n,c=1,n=s
viyoga	viyoga	pos=n,comp=y
viDuram	viDura	pos=a,g=n,c=1,n=s
lamba	lamba	pos=a,comp=y
alakam	alaka	pos=n,g=n,c=1,n=s
sa	sa	pos=i
alasam	alasa	pos=a,g=n,c=1,n=s
BUyas	BUyas	pos=i
tad	tad	pos=n,comp=y
kzaRa	kzaRa	pos=n,comp=y
jAta	jan	pos=va,comp=y,f=part
kAnti	kAnti	pos=n,g=n,c=1,n=s
raBasa	raBasa	pos=n,comp=y
prApte	prAp	pos=va,g=m,c=7,n=s,f=part
mayi	mad	pos=n,g=,c=7,n=s
prozite	pravas	pos=va,g=m,c=7,n=s,f=part
sa	sa	pos=i
Awopam	Awopa	pos=n,g=n,c=1,n=s
rati	rati	pos=n,comp=y
keli	keli	pos=n,comp=y
kAla	kAla	pos=n,comp=y
sarasam	sarasa	pos=a,g=n,c=1,n=s
ramyam	ramya	pos=a,g=n,c=1,n=s
kim	ka	pos=n,g=n,c=2,n=s
api	api	pos=i
AdarataH	Adara	pos=n,g=m,c=5,n=s
yat	yad	pos=n,g=n,c=1,n=s
pItam	pA	pos=va,g=n,c=1,n=s,f=part
su	su	pos=i
tanvAH	tanu	pos=n,g=f,c=6,n=s
mayA	mad	pos=n,g=,c=3,n=s
vadanakam	vadanaka	pos=n,g=n,c=1,n=s
vaktum	vac	pos=vi
na	na	pos=i
tat	tad	pos=n,g=n,c=1,n=s
pAryate	pAray	pos=v,p=3,n=s,l=lat

# id = AmrShtk.95
sA	tad	pos=n,g=f,c=1,n=s
eva	eva	pos=i
aham	mad	pos=n,g=,c=1,n=s
pramadA	pramadA	pos=n,g=f,c=1,n=s
nfRAm	nf	pos=n,g=,c=6,n=p
aDigatO	aDigam	pos=va,g=m,c=1,n=d,f=part
etO	etad	pos=n,g=m,c=1,n=d
ca	ca	pos=i
tO	tad	pos=n,g=m,c=1,n=d
nUpurAv	nUpura	pos=n,g=m,c=1,n=d
ezA	etad	pos=n,g=f,c=1,n=s
naH	mad	pos=n,g=,c=6,n=p
avfttiH	avftti	pos=n,g=f,c=1,n=s
eva	eva	pos=i
sahaja	sahaja	pos=a,comp=y
vrIqA	vrIqA	pos=n,comp=y
DanaH	Dana	pos=n,g=m,c=1,n=s
strI	strI	pos=n,comp=y
janaH	jana	pos=n,g=m,c=1,n=s
itTam	itTam	pos=i
lajjitayA	lajj	pos=va,g=f,c=3,n=s,f=part
smfteH	smfti	pos=n,g=f,c=6,n=s
upagame	upagama	pos=n,g=m,c=7,n=s
matvA	man	pos=vi
tanum	tanu	pos=a,g=f,c=2,n=s
samBramAt	samBrama	pos=n,g=m,c=5,n=s
pumBAvaH	pumBAva	pos=n,g=m,c=1,n=s
praTamam	praTamam	pos=i
rati	rati	pos=n,comp=y
vyatikare	vyatikara	pos=n,g=m,c=7,n=s
muktaH	muc	pos=va,g=m,c=1,n=s,f=part
tatas	tatas	pos=i
vallaBaH	vallaBa	pos=a,g=m,c=1,n=s

# id = AmrShtk.96
kara	kara	pos=n,comp=y
kisalayam	kisalaya	pos=n,g=m,c=2,n=s
DUtvA	DU	pos=vi
DUtvA	DU	pos=vi
vimArgati	vimArg	pos=v,p=3,n=s,l=lat
vAsasI	vAsas	pos=n,g=n,c=2,n=d
kzipati	kzip	pos=v,p=3,n=s,l=lat
sumanaH	sumanas	pos=n,comp=y
mAlA	mAlA	pos=n,comp=y
Sezam	Seza	pos=n,g=m,c=2,n=s
pradIpa	pradIpa	pos=n,comp=y
SiKAm	SiKA	pos=n,g=f,c=2,n=s
prati	prati	pos=i
sTagayati	sTagay	pos=v,p=3,n=s,l=lat
muhuH	muhur	pos=i
patyuH	pati	pos=n,g=,c=6,n=s
netre	netra	pos=n,g=n,c=2,n=d
vihasya	vihas	pos=vi
samAkulA	samAkula	pos=a,g=f,c=1,n=s
surata	surata	pos=n,comp=y
viratA	viram	pos=va,g=f,c=1,n=s,f=part
ramyA	ramya	pos=a,g=f,c=1,n=s
tanvI	tanvI	pos=n,g=f,c=1,n=s
muhuH	muhur	pos=i
muhuH	muhur	pos=i
Ikzate	Ikz	pos=v,p=3,n=s,l=lat

# id = AmrShtk.97
santi	as	pos=v,p=3,n=p,l=lat
eva	eva	pos=i
atra	atra	pos=i
gfhe	gfha	pos=n,g=n,c=7,n=s
gfhe	gfha	pos=n,g=n,c=7,n=s
yuvatayaH	yuvati	pos=n,g=f,c=1,n=p
tAH	tad	pos=n,g=f,c=2,n=p
pfcCa	pracC	pos=v,p=2,n=s,l=lot
gatvA	gam	pos=vi
aDunA	aDunA	pos=i
preyAMsaH	preyas	pos=a,g=m,c=1,n=p
praRamanti	praRam	pos=v,p=3,n=p,l=lat
kim	kim	pos=i
tava	tvad	pos=n,g=,c=6,n=s
punaH	punar	pos=i
dAsaH	dAsa	pos=n,g=m,c=1,n=s
yaTA	yaTA	pos=i
vartate	vft	pos=v,p=3,n=s,l=lat
Atma	Atman	pos=n,comp=y
drohin	drohin	pos=a,g=f,c=8,n=s
durjanEH	durjana	pos=n,g=m,c=3,n=p
pralapitam	pralap	pos=va,g=n,c=2,n=s,f=part
karRe	karRa	pos=n,g=m,c=7,n=s
aniSam	aniSam	pos=i
mA	mA	pos=i
kfTAH	kf	pos=v,p=2,n=s,l=lun_unaug
Cinna	Cid	pos=va,comp=y,f=part
sneha	sneha	pos=n,comp=y
rasAH	rasa	pos=n,g=m,c=1,n=p
Bavanti	BU	pos=v,p=3,n=p,l=lat
puruzA	puruza	pos=n,g=m,c=1,n=p
duHKa	duHKa	pos=n,comp=y
anuvft	anuvft	pos=va,g=m,c=1,n=p,f=krtya
punaH	punar	pos=i

# id = AmrShtk.98
niHSvAsA	niHSvAsa	pos=n,g=m,c=1,n=p
vadanam	vadana	pos=n,g=n,c=2,n=s
dahanti	dah	pos=v,p=3,n=p,l=lat
hfdayam	hfdaya	pos=n,g=n,c=1,n=s
nirmUlam	nirmUla	pos=a,g=n,c=1,n=s
unmaTyate	unmaT	pos=v,p=3,n=s,l=lat
nidrA	nidrA	pos=n,g=f,c=1,n=s
na	na	pos=i
iti	iti	pos=i
na	na	pos=i
dfSyate	dfS	pos=v,p=3,n=s,l=lat
priya	priya	pos=a,comp=y
muKam	muKa	pos=n,g=n,c=1,n=s
rAtriMdivam	rAtriMdiva	pos=n,g=n,c=2,n=s
rudyate	rud	pos=v,p=3,n=s,l=lat
aNgam	aNga	pos=n,g=n,c=1,n=s
Sozam	Soza	pos=n,g=m,c=2,n=s
upEti	upe	pos=v,p=3,n=s,l=lat
pAda	pAda	pos=n,comp=y
patitaH	pat	pos=va,g=m,c=1,n=s,f=part
preyAn	preyas	pos=a,g=m,c=1,n=s
taTA	taTA	pos=i
upekzitaH	upekz	pos=va,g=m,c=1,n=s,f=part
saKyaH	saKI	pos=n,g=f,c=1,n=p
kam	ka	pos=n,g=m,c=2,n=s
guRam	guRa	pos=n,g=m,c=2,n=s
Akalayya	Akalay	pos=vi
dayite	dayita	pos=a,g=f,c=8,n=s
mAnam	mAna	pos=n,g=m,c=2,n=s
vayam	mad	pos=n,g=,c=1,n=p
kAritAH	kAray	pos=va,g=f,c=1,n=p,f=part

# id = AmrShtk.99
adya	adya	pos=i
AraBya	AraB	pos=vi
yadi	yadi	pos=i
priye	priya	pos=a,g=f,c=8,n=s
punaH	punar	pos=i
aham	mad	pos=n,g=,c=1,n=s
mAnasya	mAna	pos=n,g=m,c=6,n=s
vA	vA	pos=i
anyasya	anya	pos=n,g=m,c=6,n=s
vA	vA	pos=i
gfhRIyAm	grah	pos=v,p=1,n=s,l=vidhilin
SaWa	SaWa	pos=a,comp=y
durnayena	durnaya	pos=a,g=n,c=3,n=s
manasA	manas	pos=n,g=n,c=3,n=s
nAma	nAman	pos=n,g=n,c=2,n=s
api	api	pos=i
saMkzepataH	saMkzepa	pos=n,g=m,c=5,n=s
tat	tad	pos=n,g=n,c=2,n=s
tena	tad	pos=n,g=n,c=3,n=s
eva	eva	pos=i
vinA	vinA	pos=i
SaSANka	SaSANka	pos=n,comp=y
DavalAH	Davala	pos=a,g=f,c=2,n=p
spazwa	paS	pos=va,comp=y,f=part
awwahAsA	awwahAsa	pos=n,g=f,c=1,n=s
niSA	niSA	pos=n,g=f,c=1,n=s
eko	eka	pos=n,g=m,c=1,n=s
vA	vA	pos=i
divasaH	divasa	pos=n,g=m,c=1,n=s
payoda	payoda	pos=n,comp=y
malinaH	malina	pos=a,g=m,c=1,n=s
yAyAt	yA	pos=v,p=3,n=s,l=vidhilin
me	mad	pos=n,g=,c=6,n=s
prAvfzi	prAvfz	pos=n,g=f,c=7,n=s

# id = AmrShtk.100
idam	idam	pos=n,g=n,c=1,n=s
kfzRam	kfzRa	pos=a,g=n,c=1,n=s
kfzRam	kfzRa	pos=a,g=n,c=1,n=s
priyatama	priyatama	pos=a,g=m,c=8,n=s
tanu	tanu	pos=a,g=n,c=1,n=s
Svetam	Sveta	pos=a,g=n,c=1,n=s
aTa	aTa	pos=i
kim	kim	pos=i
gamizyAmo	gam	pos=v,p=1,n=p,l=lrt
yAmo	yA	pos=v,p=1,n=p,l=lat
Bavatu	BU	pos=v,p=3,n=s,l=lot
gamanena	gamana	pos=n,g=n,c=3,n=s
aTa	aTa	pos=i
Bavatu	BU	pos=v,p=3,n=s,l=lot
purA	purA	pos=i
yenAvam	mad	pos=n,g=,c=6,n=s
ciram	ciram	pos=i
anusftA	anusf	pos=va,g=f,c=1,n=s,f=part
citta	citta	pos=n,comp=y
padavIH	padavI	pos=n,g=f,c=1,n=s
cittapadavI	tad	pos=n,g=m,c=1,n=s
eva	eva	pos=i
anyaH	anya	pos=n,g=m,c=1,n=s
evAnyo	jan	pos=va,g=m,c=1,n=s,f=part
jAtaH	saKI	pos=n,g=f,c=8,n=s
saKi	parici	pos=va,g=m,c=1,n=p,f=part
paricitAH	ka	pos=n,g=m,c=6,n=s
kasya	puruza	pos=n,g=m,c=1,n=p

# id = AmrShtk.101
caraRa	caraRa	pos=n,comp=y
patanam	patana	pos=n,g=n,c=1,n=s
saKi	saKI	pos=n,comp=y
AlApAH	AlApa	pos=n,g=m,c=1,n=p
manohara	manohara	pos=a,comp=y
cAwavaH	cAwu	pos=n,g=m,c=1,n=p
kfSatara	kfSatara	pos=a,comp=y
tanoH	tanu	pos=n,g=m,c=6,n=s
gAQa	gAQa	pos=a,comp=y
ASlezaH	ASleza	pos=n,g=m,c=1,n=s
haWAt	haWa	pos=n,g=m,c=5,n=s
paricumbanam	paricumbana	pos=n,g=n,c=1,n=s
iti	iti	pos=i
hi	hi	pos=i
capalo	capala	pos=n,g=m,c=1,n=s
mAna	mAna	pos=n,comp=y
AramBaH	AramBa	pos=n,g=m,c=1,n=s
taTA	taTA	pos=i
api	api	pos=i
hi	hi	pos=i
na	na	pos=i
utsahe	utsah	pos=v,p=1,n=s,l=lat
hfdaya	hfdaya	pos=n,comp=y
dayitaH	dayita	pos=a,g=m,c=1,n=s
kAntaH	kAnta	pos=a,g=m,c=1,n=s
kAmam	kAma	pos=n,g=m,c=2,n=s
kim	kim	pos=i
atra	atra	pos=i
karomi	kf	pos=v,p=1,n=s,l=lat
aham	mad	pos=n,g=,c=1,n=s

# id = AmrShtk.102
aham	mad	pos=n,g=,c=1,n=s
tena	tad	pos=n,g=m,c=3,n=s
AhUtA	AhvA	pos=va,g=f,c=1,n=s,f=part
kim	ka	pos=n,g=n,c=2,n=s
api	api	pos=i
kaTayAmi	kaTay	pos=v,p=1,n=s,l=lat
iti	iti	pos=i
vijane	vijana	pos=a,g=n,c=7,n=s
samIpe	samIpa	pos=n,g=n,c=7,n=s
ca	ca	pos=i
AsInA	As	pos=va,g=f,c=1,n=s,f=part
sarasa	sarasa	pos=a,comp=y
hfdaya	hfdaya	pos=n,comp=y
tvAt	tva	pos=n,g=n,c=5,n=s
avahitA	avahita	pos=a,g=f,c=1,n=s
tataH	tatas	pos=i
karRa	karRa	pos=n,comp=y
upAnte	upAnta	pos=n,g=n,c=7,n=s
kim	ka	pos=n,g=n,c=2,n=s
api	api	pos=i
vad	vad	pos=va,g=m,c=3,n=s,f=part
AGrAya	AGrA	pos=vi
vadanam	vadana	pos=n,g=n,c=2,n=s
gfhItA	grah	pos=va,g=f,c=1,n=s,f=part
Darmille	saKI	pos=n,g=f,c=8,n=s
saKi	tad	pos=n,g=m,c=1,n=s
sa	ca	pos=i
ca	mad	pos=n,g=,c=3,n=s
gAQam	gAQam	pos=i
aDare	aDara	pos=n,g=m,c=7,n=s

# id = AmrShtk.103
cakzuH	cakzus	pos=n,comp=y
prIti	prIti	pos=n,comp=y
prasakte	prasaYj	pos=va,g=n,c=7,n=s,f=part
manasi	manas	pos=n,g=n,c=7,n=s
paricaye	paricaya	pos=n,g=m,c=7,n=s
cintay	cintay	pos=va,comp=y,f=part
aByupAye	aByupAya	pos=n,g=m,c=7,n=s
rAge	rAga	pos=n,g=m,c=7,n=s
yAte	yA	pos=va,g=m,c=7,n=s,f=part
atiBUmim	atiBUmi	pos=n,g=f,c=2,n=s
vikasati	vikas	pos=va,g=m,c=7,n=s,f=part
sutarAm	sutarAm	pos=i
gocare	gocara	pos=n,g=m,c=7,n=s
dUtikAyAH	dUtikA	pos=n,g=f,c=6,n=s
AstAm	As	pos=v,p=3,n=s,l=lot
dUreRa	dUra	pos=a,g=n,c=3,n=s
tAvat	tAvat	pos=i
sa	sa	pos=i
raBasa	raBasa	pos=n,comp=y
dayita	dayita	pos=a,comp=y
AliNgana	AliNgana	pos=n,comp=y
Ananda	Ananda	pos=n,comp=y
lABaH	lABa	pos=n,g=m,c=1,n=s
tad	tad	pos=n,comp=y
geha	geha	pos=n,comp=y
upAnta	upAnta	pos=n,comp=y
raTyA	raTyA	pos=n,comp=y
BramaRam	BramaRa	pos=n,g=n,c=1,n=s
api	api	pos=i
parAm	para	pos=n,g=f,c=2,n=s
nirvftim	nirvfti	pos=n,g=f,c=2,n=s
saMtanoti	saMtan	pos=v,p=3,n=s,l=lat

# id = AmrShtk.104
kAnte	kAnta	pos=a,g=m,c=7,n=s
talpam	talpa	pos=n,g=m,c=2,n=s
upAgate	upAgam	pos=va,g=m,c=7,n=s,f=part
vigalitA	vigal	pos=va,g=f,c=1,n=s,f=part
nIvI	nIvi	pos=n,g=f,c=1,n=s
svayam	svayam	pos=i
banDanAd	banDana	pos=n,g=n,c=5,n=s
vAso	vAsas	pos=n,g=n,c=1,n=s
viSlaTa	viSlaTa	pos=a,comp=y
meKalA	meKalA	pos=n,comp=y
guRa	guRa	pos=n,comp=y
Dftam	Df	pos=va,g=n,c=1,n=s,f=part
kiMcid	kaScit	pos=n,g=n,c=2,n=s
nitambe	nitamba	pos=n,g=m,c=7,n=s
sTitam	sTA	pos=va,g=n,c=1,n=s,f=part
etAvat	etAvat	pos=a,g=n,c=2,n=s
saKi	saKI	pos=n,g=f,c=8,n=s
vedmi	vid	pos=v,p=1,n=s,l=lat
sAMpratam	sAMpratam	pos=i
aham	mad	pos=n,g=,c=1,n=s
tasya	tad	pos=n,g=m,c=6,n=s
aNgasaNge	aNgasaNga	pos=n,g=m,c=7,n=s
punaH	punar	pos=i
kaH	ka	pos=n,g=m,c=1,n=s
ayam	idam	pos=n,g=m,c=1,n=s
kA	ka	pos=n,g=f,c=1,n=s
asmi	as	pos=v,p=1,n=s,l=lat
ratam	rata	pos=n,g=n,c=1,n=s
nu	nu	pos=i
vA	vA	pos=i
kaTam	kaTam	pos=i
iti	iti	pos=i
su	su	pos=i
alpA	alpa	pos=a,g=f,c=1,n=s
api	api	pos=i
me	mad	pos=n,g=,c=6,n=s
na	na	pos=i
smftiH	smfti	pos=n,g=f,c=1,n=s

# id = AmrShtk.105
prAsAde	prAsAda	pos=n,g=m,c=7,n=s
sA	tad	pos=n,g=f,c=1,n=s
diSi	diS	pos=n,g=f,c=7,n=s
diSi	diS	pos=n,g=f,c=7,n=s
ca	ca	pos=i
sA	tad	pos=n,g=f,c=1,n=s
pfzWataH	pfzWatas	pos=i
sA	tad	pos=n,g=f,c=1,n=s
puraH	puras	pos=i
sA	tad	pos=n,g=f,c=1,n=s
paryaNke	paryaNka	pos=n,g=m,c=7,n=s
sA	tad	pos=n,g=f,c=1,n=s
paTi	paTin	pos=n,g=,c=7,n=s
paTi	paTin	pos=n,g=,c=7,n=s
ca	ca	pos=i
sA	tad	pos=n,g=f,c=1,n=s
tad	tad	pos=n,comp=y
viyoga	viyoga	pos=n,comp=y
Aturasya	Atura	pos=a,g=m,c=6,n=s
haMho	haMho	pos=i
cetaH	cetas	pos=n,g=n,c=1,n=s
prakftiH	prakfti	pos=n,g=f,c=1,n=s
aparA	apara	pos=n,g=f,c=1,n=s
na	na	pos=i
asti	as	pos=v,p=3,n=s,l=lat
me	mad	pos=n,g=,c=6,n=s
kA	ka	pos=n,g=f,c=1,n=s
api	api	pos=i
sA	tad	pos=n,g=f,c=1,n=s
sA	tad	pos=n,g=f,c=1,n=s
sA	tad	pos=n,g=f,c=1,n=s
sA	tad	pos=n,g=f,c=1,n=s
sA	tad	pos=n,g=f,c=1,n=s
sA	tad	pos=n,g=f,c=1,n=s
jagati	jagant	pos=n,g=n,c=7,n=s
sakale	sakala	pos=a,g=n,c=7,n=s
kaH	ka	pos=n,g=m,c=1,n=s
ayam	idam	pos=n,g=m,c=1,n=s
advEta	advEta	pos=n,comp=y
vAdaH	vAda	pos=n,g=m,c=1,n=s

# id = AmrShtk.106
anAlocya	anAlocya	pos=i
premRaH	preman	pos=n,g=,c=6,n=s
pariRatim	pariRati	pos=n,g=f,c=2,n=s
anAdftya	anAdftya	pos=i
suhfdas	suhfd	pos=n,g=m,c=6,n=s
tvayA	tvad	pos=n,g=,c=3,n=s
akARqe	akARqa	pos=a,g=n,c=7,n=s
mAnaH	mAna	pos=n,g=m,c=1,n=s
kim	ka	pos=n,g=n,c=1,n=s
iti	iti	pos=i
sarale	sarala	pos=a,g=m,c=7,n=s
preyasi	preyas	pos=a,g=m,c=7,n=s
kftaH	kf	pos=va,g=m,c=1,n=s,f=part
samAkfzwA	samAkfz	pos=va,g=m,c=1,n=p,f=part
hi	hi	pos=i
ete	etad	pos=n,g=m,c=1,n=p
viraha	viraha	pos=n,comp=y
dahana	dahana	pos=n,comp=y
udBAsura	udBAsura	pos=a,comp=y
SiKAH	SiKA	pos=n,g=m,c=1,n=p
sva	sva	pos=a,comp=y
hastena	hasta	pos=n,g=m,c=3,n=s
aNgArAH	aNgAra	pos=n,g=m,c=1,n=p
tad	tad	pos=n,g=n,c=1,n=s
alam	alam	pos=i
aDunA	aDunA	pos=i
araRyaruditEH	araRyarudita	pos=n,g=n,c=3,n=p

