# id = HamDu.1
dukUlam	dukUla	pos=n,g=n,c=2,n=s
biBrARo	Bf	pos=va,g=m,c=1,n=s,f=part
dal	dal	pos=va,comp=y,f=part
haritAla	haritAla	pos=n,comp=y
dyuti	dyuti	pos=n,comp=y
haram	hara	pos=a,g=n,c=2,n=s
javApuzpa	javApuzpa	pos=n,comp=y
SreRI	SreRI	pos=n,comp=y
ruci	ruci	pos=n,comp=y
rucira	rucira	pos=a,comp=y
pAda	pAda	pos=n,comp=y
ambuja	ambuja	pos=n,comp=y
talaH	tala	pos=n,g=m,c=1,n=s
tamAla	tamAla	pos=n,comp=y
SyAma	SyAma	pos=a,comp=y
aNgaH	aNga	pos=n,g=m,c=1,n=s
dara	dara	pos=a,comp=y
hasita	hasita	pos=n,comp=y
lIlA	lIlA	pos=n,comp=y
AYC	AYC	pos=va,comp=y,f=part
muKaH	muKa	pos=n,g=m,c=1,n=s
parAnanda	parAnanda	pos=n,comp=y
ABogaH	ABoga	pos=n,g=m,c=1,n=s
sPuratu	sPur	pos=v,p=3,n=s,l=lot
hfdi	hfd	pos=n,g=n,c=7,n=s
me	mad	pos=n,g=,c=6,n=s
kopin	kopin	pos=a,comp=y
puruzaH	puruza	pos=n,g=m,c=1,n=s

# id = HamDu.2
yadA	yadA	pos=i
yAto	yA	pos=va,g=m,c=1,n=s,f=part
gopI	gopI	pos=n,comp=y
hfdaya	hfdaya	pos=n,comp=y
madanaH	madana	pos=n,g=m,c=1,n=s
nanda	nanda	pos=n,comp=y
sadanAt	sadana	pos=n,g=n,c=5,n=s
mukundo	mukunda	pos=n,g=m,c=1,n=s
gAnDinyAs	gAnDinI	pos=n,g=f,c=6,n=s
tanayam	tanaya	pos=n,g=m,c=2,n=s
anuvindan	anuvid	pos=va,g=m,c=1,n=s,f=part
maDupurIm	maDupurI	pos=n,g=f,c=2,n=s
tadA	tadA	pos=i
amANkzIt	majj	pos=v,p=3,n=s,l=lun
cintA	cintA	pos=n,comp=y
sariti	sarit	pos=n,g=f,c=7,n=s
Gana	Gana	pos=a,comp=y
GUrRa	GUrRa	pos=a,comp=y
paricayEH	paricaya	pos=n,g=m,c=3,n=p
agADAyAm	agADa	pos=a,g=f,c=7,n=s
bADA	bADA	pos=n,comp=y
maya	maya	pos=a,comp=y
payasi	payas	pos=n,g=n,c=7,n=s
rADA	rADa	pos=n,g=m,c=1,n=p
virahiRI	virahin	pos=a,g=f,c=1,n=s

# id = HamDu.3
kadAcit	kadAcid	pos=i
Keda	Keda	pos=n,comp=y
agnim	agni	pos=n,g=m,c=2,n=s
viGawayitum	viGaway	pos=vi
antargatam	antargam	pos=va,g=m,c=2,n=s,f=part
asO	adas	pos=n,g=f,c=1,n=s
saha	saha	pos=i
AliBiH	Ali	pos=n,g=f,c=3,n=p
leBe	laB	pos=v,p=3,n=s,l=lit
taralita	taralita	pos=a,comp=y
manAH	manas	pos=n,g=f,c=1,n=s
yAmuna	yAmuna	pos=a,comp=y
tawIm	tawI	pos=n,g=f,c=2,n=s
cirAt	cirAt	pos=i
asyAH	idam	pos=n,g=f,c=6,n=s
cittam	citta	pos=n,g=n,c=1,n=s
parici	parici	pos=va,comp=y,f=part
kuwI	kuwI	pos=n,comp=y
rAva	rAva	pos=n,comp=y
kalanAt	kalana	pos=n,g=n,c=5,n=s
avasTAm	avasTA	pos=n,g=f,c=2,n=s
tastAra	stf	pos=v,p=3,n=s,l=lit
sPUwamaTa	suzupti	pos=n,g=f,c=6,n=s
priya	priya	pos=a,comp=y
saKIm	saKI	pos=n,g=f,c=2,n=s

# id = HamDu.4
tadA	tadA	pos=i
nizpandA	nizpanda	pos=a,g=f,c=1,n=s
aNgI	aNga	pos=a,g=f,c=1,n=s
kalita	kalay	pos=va,comp=y,f=part
nalinI	nalinI	pos=n,comp=y
pallava	pallava	pos=n,comp=y
kulEH	kula	pos=n,g=n,c=3,n=p
parIRAhAt	parIRAha	pos=n,g=m,c=5,n=s
preman	preman	pos=n,g=m,c=6,n=p
akuSala	akuSala	pos=a,comp=y
Sata	Sata	pos=n,comp=y
ASaNkin	ASaNkin	pos=a,comp=y
hfdayEH	hfdaya	pos=n,g=n,c=3,n=p
dfH	dfS	pos=n,comp=y
amBaH	amBas	pos=n,comp=y
gamBIrIkf	gamBIrIkf	pos=va,comp=y,f=part
mihira	mihira	pos=n,comp=y
putrI	putrI	pos=n,comp=y
lahari	lahari	pos=n,g=f,c=3,n=p
vilInA	vilI	pos=va,g=f,c=1,n=s,f=part
DUlinAmupari	parivf	pos=v,p=3,n=s,l=lit
parivavre	parijana	pos=n,g=m,c=3,n=p

# id = HamDu.5
tatas	tatas	pos=i
tAm	tad	pos=n,g=f,c=2,n=s
nyasta	nyas	pos=va,comp=y,f=part
aNgIm	aNga	pos=a,g=f,c=2,n=s
urasi	uras	pos=n,g=n,c=7,n=s
lalitAyAH	lalitA	pos=n,g=f,c=6,n=s
kamalinI	kamalinI	pos=n,comp=y
palASEH	palASa	pos=n,g=n,c=3,n=p
kAlindI	kAlindI	pos=n,comp=y
salila	salila	pos=n,comp=y
SiSirEH	SiSira	pos=a,g=n,c=3,n=p
vIjita	vIjay	pos=va,comp=y,f=part
tanum	tanu	pos=n,g=f,c=2,n=s
parAvft	parAvft	pos=va,comp=y,f=part
SvAsa	SvAsa	pos=n,comp=y
aNkura	aNkura	pos=n,comp=y
calita	cal	pos=va,comp=y,f=part
kaRWIm	kaRWI	pos=n,g=f,c=2,n=s
kalayatAm	kalay	pos=va,g=m,c=6,n=p,f=part
saKi	saKI	pos=n,comp=y
saMdohAnAm	saMdoha	pos=n,g=m,c=6,n=p
pramada	pramada	pos=n,comp=y
Bara	Bara	pos=n,comp=y
SAlI	SAlin	pos=a,g=m,c=1,n=s
DvaniH	Dvani	pos=n,g=m,c=1,n=s
aBUt	BU	pos=v,p=3,n=s,l=lun

# id = HamDu.6
niDAya	niDA	pos=vi
aNke	aNka	pos=n,g=m,c=7,n=s
paNkeruha	paNkeruha	pos=n,comp=y
dala	dala	pos=n,comp=y
viwaNkasya	viwaNka	pos=n,g=m,c=6,n=s
lalitA	lalitA	pos=n,g=f,c=1,n=s
tato	tatas	pos=i
rADAm	rADA	pos=n,g=f,c=2,n=s
nIrAharaRa	nIrAharaRa	pos=n,comp=y
saraRi	saraRi	pos=n,comp=y
nyasta	nyas	pos=va,comp=y,f=part
caraRA	caraRa	pos=n,g=f,c=1,n=s
milantam	mil	pos=va,g=m,c=2,n=s,f=part
kAlindI	kAlindI	pos=n,comp=y
pulina	pulina	pos=n,comp=y
Buvi	BU	pos=n,g=f,c=7,n=s
KelA	KelA	pos=n,comp=y
AYc	AYc	pos=va,comp=y,f=part
gatim	gati	pos=n,g=m,c=2,n=s
dadarSa	dfS	pos=v,p=3,n=s,l=lit
agre	agra	pos=n,g=n,c=7,n=s
kaMcid	kaScit	pos=n,g=m,c=2,n=s
maDura	maDura	pos=a,comp=y
virutam	viruta	pos=n,g=m,c=2,n=s
Svetagarutam	Svetagaruta	pos=n,g=m,c=2,n=s

# id = HamDu.7
tad	tad	pos=n,comp=y
Aloka	Aloka	pos=n,comp=y
stoka	stoka	pos=a,comp=y
ucCvasita	ucCvas	pos=va,comp=y,f=part
hfdayA	hfdaya	pos=n,g=f,c=1,n=s
sAdaram	sAdara	pos=a,g=n,c=2,n=s
asO	adas	pos=n,g=f,c=1,n=s
praRAmam	praRAma	pos=n,g=m,c=2,n=s
saMSantI	laGu	pos=a,g=n,c=2,n=s
laGu	laGu	pos=a,g=n,c=2,n=s
laGu	samAsAday	pos=vi
samAsAdya	saviDa	pos=n,g=n,c=2,n=s
Dfta	Df	pos=va,comp=y,f=part
utkaRWA	utkaRWA	pos=n,g=f,c=1,n=s
sadyo	sadyas	pos=i
hari	hari	pos=n,comp=y
sadasi	sadas	pos=n,g=n,c=7,n=s
saMdeSa	saMdeSa	pos=n,comp=y
haraRe	haraRa	pos=n,g=n,c=7,n=s
varam	vara	pos=a,g=m,c=2,n=s
dUtam	dUta	pos=n,g=m,c=2,n=s
mene	man	pos=v,p=3,n=s,l=lit
tam	tad	pos=n,g=m,c=2,n=s
ati	ati	pos=i
lalitam	lal	pos=va,g=m,c=2,n=s,f=part
hanta	hanta	pos=i
lalitA	lalitA	pos=n,g=f,c=1,n=s

# id = HamDu.8
amarzAt	amarza	pos=n,g=m,c=5,n=s
prema	preman	pos=n,comp=y
IrzyAm	IrzyA	pos=n,g=f,c=2,n=s
sapadi	sapadi	pos=i
daDatI	DA	pos=va,g=f,c=1,n=s,f=part
kaMsa	kaMsa	pos=n,comp=y
maTane	maTana	pos=n,g=n,c=7,n=s
pravfttA	pravft	pos=va,g=f,c=1,n=s,f=part
haMsAya	haMsa	pos=n,g=m,c=4,n=s
Kam	Ka	pos=n,g=n,c=2,n=s
aBilazitam	aBilaz	pos=va,g=n,c=2,n=s,f=part
SaMsitum	SaMs	pos=vi
asO	adas	pos=n,g=f,c=1,n=s
na	na	pos=i
tasyA	tad	pos=n,g=f,c=6,n=s
dozaH	doza	pos=n,g=m,c=1,n=s
ayam	idam	pos=n,g=m,c=1,n=s
yat	yat	pos=i
iha	iha	pos=i
vihagam	vihaga	pos=n,g=m,c=2,n=s
prArTitavatI	prArTay	pos=va,g=f,c=1,n=s,f=part
na	na	pos=i
kasmin	ka	pos=n,g=m,c=7,n=s
visramBam	visramBa	pos=n,g=m,c=2,n=s
diSati	diS	pos=v,p=3,n=s,l=lat
hari	hari	pos=n,comp=y
Bakti	Bakti	pos=n,comp=y
praRayitA	praRayita	pos=a,g=f,c=1,n=s

# id = HamDu.9
pavitrezu	pavitra	pos=n,g=n,c=7,n=p
prAyo	prAyas	pos=i
viracayasi	viracay	pos=v,p=2,n=s,l=lat
toyezu	toya	pos=n,g=n,c=7,n=p
vasatim	vasati	pos=n,g=f,c=2,n=s
pramodam	pramoda	pos=n,g=m,c=2,n=s
na	na	pos=i
alIke	alIka	pos=n,g=n,c=7,n=s
vahasi	vah	pos=v,p=2,n=s,l=lat
viSada	viSada	pos=a,comp=y
AtmA	Atman	pos=n,g=m,c=1,n=s
svayam	svayam	pos=i
asi	as	pos=v,p=2,n=s,l=lat
atas	atas	pos=i
aham	mad	pos=n,g=,c=1,n=s
duHKa	duHKa	pos=n,comp=y
ArtA	Arta	pos=a,g=f,c=1,n=s
SaraRam	SaraRa	pos=n,g=n,c=2,n=s
avalA	tvad	pos=n,g=,c=2,n=s
tvAm	gam	pos=va,g=f,c=1,n=s,f=part
gatavatI	na	pos=i
na	BikzA	pos=n,g=f,c=1,n=s
sat	as	pos=va,comp=y,f=part
pakze	pakza	pos=n,g=m,c=7,n=s
satpakze	vraj	pos=v,p=3,n=s,l=lat
vrajati	hi	pos=i
hi	kadAcid	pos=i
viPala	viPala	pos=a,comp=y
tAm	tA	pos=n,g=f,c=2,n=s

# id = HamDu.10
ciram	ciram	pos=i
vismftya	vismf	pos=vi
asmAn	mad	pos=n,g=m,c=2,n=p
viraha	viraha	pos=n,comp=y
dahana	dahana	pos=n,comp=y
jvAla	jvAla	pos=n,comp=y
vikalAH	vikala	pos=a,g=m,c=1,n=p
kalAvAn	kalAvat	pos=a,g=m,c=1,n=s
sa	sa	pos=i
Anandam	Ananda	pos=n,g=n,c=2,n=s
vasati	vas	pos=v,p=3,n=s,l=lat
maTurAyAm	maTurA	pos=n,g=f,c=7,n=s
maDuripuH	maDuripu	pos=n,g=m,c=1,n=s
tat	tad	pos=n,g=n,c=2,n=s
etam	etad	pos=n,g=m,c=2,n=s
saMdeSam	saMdeSa	pos=n,g=m,c=2,n=s
sva	sva	pos=a,comp=y
manasi	manas	pos=n,g=n,c=7,n=s
samADAya	samADA	pos=vi
niKila	niKila	pos=a,g=m,c=8,n=s
BavAn	Bavat	pos=a,g=m,c=1,n=s
kzipram	kzipram	pos=i
tasya	tad	pos=n,g=m,c=6,n=s
SravaRa	SravaRa	pos=n,comp=y
padavIm	padavI	pos=n,g=f,c=2,n=s
saMgamayatu	saMgamay	pos=v,p=3,n=s,l=lot

# id = HamDu.11
nirasta	niras	pos=va,comp=y,f=part
pratyUham	pratyUha	pos=n,g=n,c=1,n=s
Bavatu	BU	pos=v,p=3,n=s,l=lot
Bavato	Bavat	pos=a,g=m,c=6,n=s
vartmani	vartman	pos=n,g=n,c=7,n=s
Sivam	Siva	pos=n,g=n,c=1,n=s
samuttizWa	samutTA	pos=v,p=2,n=s,l=lot
kzipram	kzipram	pos=i
manasi	manas	pos=n,g=n,c=7,n=s
mudam	mud	pos=n,g=f,c=2,n=s
ADAya	ADA	pos=vi
sadayam	sadaya	pos=a,g=m,c=2,n=s
aDastAt	aDastAt	pos=i
DAvantaH	DAv	pos=va,g=m,c=1,n=p,f=part
laGu	laGu	pos=a,g=n,c=2,n=s
laGu	laGu	pos=a,g=n,c=2,n=s
samuttAna	samuttAna	pos=a,comp=y
nayanEH	nayana	pos=n,g=n,c=3,n=p
Bavantam	Bavanta	pos=n,g=m,c=2,n=s
vIkzantAm	vIkz	pos=v,p=3,n=p,l=lot
kutuka	kutuka	pos=n,comp=y
taralAH	tarala	pos=a,g=m,c=1,n=p
gopa	gopa	pos=n,comp=y
SiSavaH	SiSu	pos=n,g=m,c=1,n=p

# id = HamDu.12
'sO	adas	pos=n,g=m,c=1,n=s
kaWina	kaWina	pos=a,comp=y
mati	mati	pos=n,g=m,c=3,n=s
dAnapatinA	dAnapati	pos=n,g=m,c=3,n=s
yayA	yad	pos=n,g=f,c=3,n=s
ninye	nI	pos=v,p=3,n=s,l=lit
tUrRam	tUrRa	pos=a,g=n,c=2,n=s
paSupa	paSupa	pos=n,comp=y
yuvatI	yuvatI	pos=n,comp=y
jIvita	jIvita	pos=n,comp=y
patiH	pati	pos=n,g=m,c=1,n=s
tayA	tad	pos=n,g=f,c=3,n=s
gantavyA	gam	pos=va,g=f,c=1,n=s,f=krtya
te	tvad	pos=n,g=,c=6,n=s
niKila	niKila	pos=a,comp=y
jagat	jagant	pos=n,comp=y
eka	eka	pos=n,comp=y
praTitayA	praT	pos=va,g=f,c=3,n=s,f=part
padavyA	padavI	pos=n,g=f,c=3,n=s
BavyAnAm	Bavya	pos=a,g=m,c=6,n=p
tilaka	tilaka	pos=n,g=m,c=8,n=s
kila	kila	pos=i
dASArha	dASArha	pos=n,comp=y
nagarI	nagarI	pos=n,g=f,c=1,n=s

# id = HamDu.13
gal	gal	pos=va,comp=y,f=part
bAzpa	bAzpa	pos=n,comp=y
asAra	asAra	pos=a,comp=y
pluta	plu	pos=va,comp=y,f=part
Davala	Davala	pos=a,comp=y
gaRqa	gaRqa	pos=n,g=f,c=1,n=p
mfga	mfga	pos=n,comp=y
dfSaH	dfS	pos=n,g=f,c=1,n=p
vidUyante	vidu	pos=v,p=3,n=p,l=lat
yatra	yatra	pos=i
prabala	prabala	pos=a,comp=y
madana	madana	pos=n,g=f,c=1,n=p
veSa	veSa	pos=n,comp=y
vivaSa	vivaSa	pos=a,g=f,c=1,n=p
tvayA	tvad	pos=n,g=,c=3,n=s
vijYAtavyA	vijYA	pos=va,g=f,c=1,n=s,f=krtya
hari	hari	pos=n,comp=y
caraRa	caraRa	pos=n,comp=y
saNga	saNga	pos=n,comp=y
praRayinaH	praRayin	pos=a,g=m,c=6,n=s
Druvam	Druvam	pos=i
sA	tad	pos=n,g=f,c=1,n=s
cakrANgI	cakrANgI	pos=n,g=f,c=1,n=s
rati	rati	pos=n,comp=y
saKa	saKa	pos=n,comp=y
SatANgasya	SatANga	pos=n,g=m,c=6,n=s
padavI	padavI	pos=n,g=f,c=1,n=s

# id = HamDu.14
piban	pA	pos=va,g=m,c=1,n=s,f=part
jambU	jambu	pos=n,comp=y
SyAmam	SyAma	pos=a,g=n,c=2,n=s
mihiraduhitaH	vAri	pos=n,g=n,c=2,n=s
vAri	maDura	pos=a,g=n,c=2,n=s
maDuram	Buj	pos=va,g=m,c=1,n=s,f=part
himakara	himakara	pos=n,comp=y
kalA	kalA	pos=n,comp=y
komala	komala	pos=a,comp=y
ruc	ruc	pos=n,g=f,c=6,n=s
kzaRam	kzaRa	pos=n,g=m,c=2,n=s
hfzwaH	hfz	pos=va,g=m,c=1,n=s,f=part
tizWan	sTA	pos=va,g=m,c=1,n=s,f=part
nibiqa	nibiqa	pos=a,comp=y
viwape	viwapa	pos=n,g=m,c=7,n=s
SAKini	SAKin	pos=n,g=m,c=7,n=s
saKe	saKi	pos=n,g=,c=8,n=s
suKena	suKa	pos=n,g=n,c=3,n=s
prasTAnam	prasTAna	pos=n,g=n,c=2,n=s
racayatu	racay	pos=v,p=3,n=s,l=lot
BavAn	Bavat	pos=a,g=m,c=1,n=s
vfzRi	vfzRi	pos=n,comp=y
nagare	nagara	pos=n,g=n,c=7,n=s

# id = HamDu.15
balAd	bala	pos=n,g=n,c=5,n=s
Akrandan	Akrand	pos=va,g=m,c=1,n=s,f=part
tIrTa	tIrTa	pos=n,comp=y
paTikam	paTika	pos=n,g=m,c=2,n=s
akrUra	akrUra	pos=n,comp=y
militam	mil	pos=va,g=m,c=2,n=s,f=part
vidUrataH	vidUra	pos=a,g=n,c=5,n=s
ABIrI	ABIrI	pos=n,comp=y
tatIH	tati	pos=n,g=f,c=2,n=p
anuyayO	anuyA	pos=v,p=3,n=s,l=lit
yena	yad	pos=n,g=m,c=3,n=s
ramaRam	ramaRa	pos=a,g=m,c=2,n=s
tam	tad	pos=n,g=m,c=2,n=s
AdO	Adi	pos=n,g=m,c=7,n=s
panTAnam	paTin	pos=n,g=,c=2,n=s
racaya	racay	pos=v,p=2,n=s,l=lot
caritArTA	caritArTa	pos=a,g=f,c=1,n=s
Bavatu	BU	pos=v,p=3,n=s,l=lot
te	tvad	pos=n,g=,c=4,n=s
virAjantI	virAj	pos=va,g=f,c=1,n=s,f=part
sarva	sarva	pos=n,comp=y
upari	upari	pos=i
paramahaMsa	paramahaMsa	pos=n,comp=y
sTitiH	sTiti	pos=n,g=f,c=1,n=s
iyam	idam	pos=n,g=f,c=1,n=s

# id = HamDu.16
akasmAt	akasmAt	pos=i
naH	mad	pos=n,g=,c=6,n=p
hariH	hari	pos=n,g=m,c=1,n=s
apahf	apahf	pos=va,g=m,c=1,n=s,f=part
aMSuka	aMSuka	pos=n,comp=y
cayam	caya	pos=n,g=m,c=2,n=s
yam	yad	pos=n,g=m,c=2,n=s
ArUQaH	Aruh	pos=va,g=m,c=1,n=s,f=part
gUQa	guh	pos=va,comp=y,f=part
praRaya	praRaya	pos=n,comp=y
laharim	lahari	pos=n,g=f,c=2,n=s
kandalayitum	kandalay	pos=vi
tava	tvad	pos=n,g=,c=6,n=s
SrAntasya	Sram	pos=va,g=m,c=6,n=s,f=part
antaH	antar	pos=i
sTagay	sTagay	pos=va,comp=y,f=part
ravi	ravi	pos=n,comp=y
bimbaH	bimba	pos=n,g=m,c=1,n=s
kisalayEH	kisalaya	pos=n,g=m,c=3,n=p
kadambaH	kadamba	pos=n,g=m,c=1,n=s
kAdamba	kAdamba	pos=n,g=m,c=8,n=s
tvaritam	tvarita	pos=a,g=n,c=2,n=s
avalambaH	avalamba	pos=n,g=m,c=1,n=s
sa	tad	pos=n,g=m,c=1,n=s
BavitA	Bavitf	pos=a,g=m,c=1,n=s

# id = HamDu.17
kirantI	kf	pos=va,g=f,c=1,n=s,f=part
lAvaRyam	lAvaRya	pos=n,g=n,c=2,n=s
diSi	diS	pos=n,g=f,c=7,n=s
diSi	diS	pos=n,g=f,c=7,n=s
SiKaRqa	SiKaRqa	pos=n,comp=y
stavakin	stavakin	pos=a,g=f,c=1,n=s
daDAnA	DA	pos=va,g=f,c=1,n=s,f=part
sADIyaH	sADIyas	pos=a,g=n,c=2,n=s
kanaka	kanaka	pos=n,comp=y
vimala	vimala	pos=a,comp=y
dyotin	dyotin	pos=a,comp=y
vasanam	vasana	pos=n,g=n,c=2,n=s
tamAla	tamAla	pos=n,comp=y
SyAma	SyAma	pos=a,comp=y
aNgI	aNga	pos=a,g=f,c=1,n=s
sarala	sarala	pos=n,comp=y
muralI	muralI	pos=n,comp=y
cumb	cumb	pos=va,comp=y,f=part
muKI	muKa	pos=a,g=f,c=1,n=s
jagO	gA	pos=v,p=3,n=s,l=lit
citram	citra	pos=n,g=n,c=2,n=s
yatra	yatra	pos=i
prakawa	prakawa	pos=a,comp=y
parama	parama	pos=a,comp=y
Ananda	Ananda	pos=n,comp=y
lahariH	lahari	pos=n,g=f,c=1,n=s

# id = HamDu.18
tayA	tad	pos=n,g=f,c=3,n=s
BUyaH	BUyas	pos=i
krIqA	krIqA	pos=n,comp=y
raBasa	raBasa	pos=a,comp=y
vikas	vikas	pos=va,comp=y,f=part
vallaBa	vallaBa	pos=a,comp=y
vaDu	vaDu	pos=n,g=m,c=1,n=d
vapuH	vapus	pos=n,comp=y
vallI	vallI	pos=n,comp=y
BraMS	BraMS	pos=va,comp=y,f=part
mfgamada	mfgamada	pos=n,comp=y
kaRa	kaRa	pos=n,comp=y
SyAmalikayA	SyAmalikA	pos=n,g=f,c=3,n=s
viDAtavyo	viDA	pos=va,g=m,c=1,n=s,f=krtya
hallIsaka	hallIsaka	pos=n,comp=y
dal	dal	pos=va,comp=y,f=part
malli	malli	pos=n,comp=y
latikayA	latikA	pos=n,g=f,c=3,n=s
samantAt	samantAt	pos=i
ullAsaH	ullAsa	pos=n,g=m,c=1,n=s
te	tvad	pos=n,g=,c=6,n=s
manasi	manas	pos=n,g=n,c=7,n=s
rAsasTalikayA	rAsasTalikA	pos=n,g=f,c=3,n=s

# id = HamDu.19
tad	tad	pos=n,comp=y
ante	anta	pos=n,g=m,c=7,n=s
vAsantI	vAsantI	pos=n,comp=y
viracitam	viracay	pos=va,g=n,c=1,n=s,f=part
anaNga	anaNga	pos=n,comp=y
utsava	utsava	pos=n,comp=y
kalA	kalA	pos=n,comp=y
catuHSAlam	catuHSAla	pos=n,g=n,c=1,n=s
SOreH	SOri	pos=n,g=m,c=6,n=s
sPurati	sPur	pos=v,p=3,n=s,l=lat
na	na	pos=i
dfSO	dfS	pos=n,g=f,c=2,n=d
tatra	tatra	pos=i
vikireH	vikf	pos=v,p=2,n=s,l=vidhilin
tad	tad	pos=n,comp=y
AlokA	Aloka	pos=n,g=f,c=1,n=s
udBeda	udBeda	pos=n,comp=y
pramada	pramada	pos=n,comp=y
Bara	Bara	pos=n,comp=y
vismAray	vismAray	pos=va,comp=y,f=part
gati	gati	pos=n,comp=y
kriye	kriyA	pos=n,g=m,c=7,n=s
jAne	jYA	pos=v,p=1,n=s,l=lat
tAvat	tAvat	pos=i
tve	tvad	pos=n,g=,c=7,n=s
bata	bata	pos=i
hatA	han	pos=va,g=f,c=1,n=s,f=part
gopa	gopa	pos=n,comp=y
vanitA	vanitA	pos=n,g=f,c=1,n=s

# id = HamDu.20
mama	mad	pos=n,g=,c=6,n=s
syAt	as	pos=v,p=3,n=s,l=vidhilin
arTAnAm	arTa	pos=n,g=m,c=6,n=p
kzatiH	kzati	pos=n,g=f,c=1,n=s
iha	iha	pos=i
vilambAt	vilamba	pos=n,g=m,c=5,n=s
yat	yat	pos=i
api	api	pos=i
te	tvad	pos=n,g=,c=6,n=s
vilokeTAH	sarva	pos=n,g=n,c=2,n=s
tat	tad	pos=n,g=n,c=2,n=s
api	api	pos=i
hari	hari	pos=n,comp=y
keli	keli	pos=n,comp=y
sTalam	sTala	pos=n,g=n,c=2,n=s
idam	idam	pos=n,g=n,c=2,n=s
te	tvad	pos=n,g=,c=6,n=s
iyam	idam	pos=n,g=f,c=1,n=s
na	na	pos=i
vyarTA	vyarTa	pos=a,g=f,c=1,n=s
Bavatu	BU	pos=v,p=3,n=s,l=lot
Suci	Suci	pos=a,comp=y
tA	tA	pos=n,g=f,c=1,n=s
kaH	ka	pos=n,g=m,c=1,n=s
sa	tad	pos=n,g=m,c=1,n=s
hi	hi	pos=i
saKe	saKi	pos=n,g=,c=8,n=s
guRo	guRa	pos=n,g=m,c=1,n=s
mati	mati	pos=n,comp=y
niveSAya	niveSa	pos=n,g=m,c=4,n=s
matiniveSAya	na	pos=i
na	BU	pos=v,p=3,n=s,l=vidhilin

# id = HamDu.21
sakft	sakft	pos=i
vaMSI	vaMSI	pos=n,comp=y
nAda	nAda	pos=n,comp=y
SravaRa	SravaRa	pos=n,comp=y
milita	mil	pos=va,comp=y,f=part
ABIra	ABIra	pos=n,comp=y
vanitA	vanitA	pos=n,g=f,c=1,n=s
rahaH	rahas	pos=n,comp=y
krIqA	krIqA	pos=n,comp=y
sAkzI	sAkzin	pos=a,g=m,c=1,n=s
pratipada	pratipada	pos=n,comp=y
latA	latA	pos=n,comp=y
sadma	sadman	pos=n,comp=y
suBagaH	suBaga	pos=a,g=m,c=1,n=s
sa	tad	pos=n,g=m,c=1,n=s
DenUnAm	Denu	pos=n,g=f,c=6,n=p
banDuH	banDu	pos=n,g=m,c=1,n=s
maDu	maDu	pos=n,comp=y
maTana	maTana	pos=a,comp=y
KawvA	KawvA	pos=n,comp=y
Ayay	Ayay	pos=va,comp=y,f=part
SilaH	SilA	pos=n,g=m,c=1,n=s
karizyati	kf	pos=v,p=3,n=s,l=lrt
Anandam	Ananda	pos=n,g=m,c=2,n=s
sapadi	sapadi	pos=i
tava	tvad	pos=n,g=,c=6,n=s
govarDana	govarDana	pos=n,comp=y
giriH	giri	pos=n,g=m,c=1,n=s

# id = HamDu.22
tam	tad	pos=n,g=m,c=2,n=s
eva	eva	pos=i
adrim	adri	pos=n,g=m,c=2,n=s
cakra	cakra	pos=n,comp=y
aNkita	aNkay	pos=va,comp=y,f=part
kara	kara	pos=n,comp=y
parizvaNga	parizvaNga	pos=n,comp=y
rasikam	rasika	pos=a,g=m,c=2,n=s
mahI	mahI	pos=n,comp=y
cakre	cakra	pos=n,g=n,c=7,n=s
SaNkemahi	SaNk	pos=v,p=1,n=p,l=vidhilin
SiKariRAm	SiKarin	pos=n,g=m,c=6,n=p
SeKaratayA	SeKaratA	pos=n,g=f,c=3,n=s
arAtim	arAti	pos=n,g=m,c=2,n=s
jYAtInAm	jYAti	pos=n,g=m,c=6,n=p
nanu	nanu	pos=i
harihayam	harihaya	pos=n,g=m,c=2,n=s
yaH	yad	pos=n,g=m,c=1,n=s
pariBavan	pariBU	pos=va,g=m,c=1,n=s,f=part
yaTArTam	yaTArTa	pos=a,g=n,c=1,n=s
svam	sva	pos=a,g=n,c=1,n=s
nAma	nAman	pos=n,g=n,c=1,n=s
vyaDita	viDA	pos=v,p=3,n=s,l=lun
Buvi	BU	pos=n,g=f,c=7,n=s
govarDana	govarDana	pos=n,g=m,c=1,n=s
iti	iti	pos=i

# id = HamDu.23
tamAlasya	tamAla	pos=n,g=m,c=6,n=s
AlokAt	Aloka	pos=n,g=m,c=5,n=s
giri	giri	pos=n,comp=y
parisare	parisara	pos=n,g=m,c=7,n=s
santi	as	pos=v,p=3,n=p,l=lat
capalAH	capala	pos=n,g=m,c=1,n=p
pulindo	pulinda	pos=n,g=m,c=1,n=s
govinda	govinda	pos=n,comp=y
smaraRa	smaraRa	pos=n,comp=y
raBasa	raBasa	pos=a,comp=y
uttapta	uttap	pos=va,comp=y,f=part
vapuzaH	vapus	pos=n,g=n,c=6,n=s
SanEs	SanEs	pos=i
tApam	tApa	pos=n,g=m,c=2,n=s
tAsAm	tad	pos=n,g=f,c=6,n=p
kzaRam	kzaRa	pos=n,g=m,c=2,n=s
apanI	apanI	pos=va,g=m,c=1,n=s,f=part
yAsyati	yA	pos=v,p=3,n=s,l=lrt
BavAn	Bavat	pos=a,g=m,c=1,n=s
avaSyam	avaSyam	pos=i
kAlindI	kAlindI	pos=n,comp=y
salila	salila	pos=n,comp=y
SiSirEH	SiSira	pos=a,g=m,c=3,n=p
pakza	pakza	pos=n,comp=y
pavanEH	pavana	pos=n,g=m,c=3,n=p

# id = HamDu.24
tad	tad	pos=n,comp=y
ante	anta	pos=n,g=m,c=7,n=s
SrIkAntasmarasamaraDAwIpuwakitA	kadamba	pos=n,g=m,c=6,n=p
kadambAnAm	vAwI	pos=n,g=f,c=1,n=s
rasika	rasika	pos=a,comp=y
paripAwim	paripAwi	pos=n,g=f,c=2,n=s
rasikaparipAwIm	sPuway	pos=v,p=3,n=s,l=lat
tvam	tvad	pos=n,g=,c=1,n=s
AsInaH	As	pos=va,g=m,c=1,n=s,f=part
tasyAm	tad	pos=n,g=f,c=7,n=s
na	na	pos=i
yadi	yadi	pos=i
parito	paritas	pos=i
nandasi	nand	pos=v,p=2,n=s,l=lat
tato	tatas	pos=i
baBUva	BU	pos=v,p=3,n=s,l=lit
vyarTA	vyarTa	pos=a,g=f,c=1,n=s
te	tvad	pos=n,g=,c=6,n=s
Gana	Gana	pos=n,comp=y
rasa	rasa	pos=n,comp=y
niveSa	niveSa	pos=n,comp=y
vyasani	vyasanin	pos=a,comp=y
tA	tA	pos=n,g=f,c=1,n=s

# id = HamDu.25
Sarad	Sarad	pos=n,comp=y
meGa	meGa	pos=n,comp=y
SreRI	SreRI	pos=n,comp=y
pratiBawam	pratiBawa	pos=a,g=n,c=2,n=s
arizwa	arizwa	pos=n,comp=y
asura	asura	pos=n,comp=y
SiraH	Siras	pos=n,g=n,c=2,n=s
ciram	ciram	pos=i
Suzkam	Suzka	pos=a,g=n,c=2,n=s
vfndAvana	vfndAvana	pos=n,comp=y
parisare	parisara	pos=n,g=m,c=7,n=s
drakzyati	dfS	pos=v,p=3,n=s,l=lrt
BavAn	Bavat	pos=a,g=m,c=1,n=s
yadA	yadA	pos=i
AroQum	Aruh	pos=vi
dUrAt	dUra	pos=a,g=n,c=5,n=s
milati	mil	pos=v,p=3,n=s,l=lat
kila	kila	pos=i
kElAsa	kElAsa	pos=n,comp=y
SiKari	SiKarin	pos=n,comp=y
Brama	Brama	pos=n,comp=y
AkrAnta	Akram	pos=va,comp=y,f=part
svAntaH	svAnta	pos=n,g=m,c=1,n=s
giriSa	giriSa	pos=n,comp=y
suhfdaH	suhfd	pos=n,g=m,c=6,n=s
kiMkara	kiMkara	pos=n,comp=y
gaRaH	gaRa	pos=n,g=m,c=1,n=s

# id = HamDu.26
ruvan	ru	pos=va,g=m,c=1,n=s,f=part
yAhi	yA	pos=v,p=2,n=s,l=lot
svEram	svEra	pos=a,g=m,c=2,n=s
carama	carama	pos=a,comp=y
daSayA	daSA	pos=n,g=f,c=3,n=s
cumb	cumb	pos=va,comp=y,f=part
rucaH	ruc	pos=n,g=f,c=1,n=p
nitambinyo	nitambinI	pos=n,g=f,c=1,n=p
vfndAvana	vfndAvana	pos=n,comp=y
Buvi	BU	pos=n,g=f,c=7,n=s
saKe	saKi	pos=n,g=,c=8,n=s
santi	as	pos=v,p=3,n=p,l=lat
bahavaH	bahu	pos=a,g=m,c=1,n=p
parAvartizyante	parAvft	pos=v,p=3,n=p,l=lrt
tulay	tulay	pos=va,comp=y,f=part
murajit	murajit	pos=n,comp=y
nUpura	nUpura	pos=n,comp=y
ravAt	rava	pos=n,g=m,c=5,n=s
tava	tvad	pos=n,g=,c=6,n=s
DvAnAt	DvAna	pos=n,g=m,c=5,n=s
tAsAm	tad	pos=n,g=f,c=6,n=p
bahis	bahis	pos=i
api	api	pos=i
gatAH	gam	pos=va,g=m,c=1,n=p,f=part
kzipram	kzipram	pos=i
asavaH	asu	pos=n,g=m,c=1,n=p

# id = HamDu.27
tvam	tvad	pos=n,g=,c=1,n=s
AsInaH	As	pos=va,g=m,c=1,n=s,f=part
SAKA	SAKA	pos=n,comp=y
antara	antara	pos=n,comp=y
milita	mil	pos=va,comp=y,f=part
caRqa	caRqa	pos=a,comp=y
tvizi	tviz	pos=n,g=m,c=7,n=s
suKam	suKa	pos=n,g=n,c=2,n=s
daDITA	DA	pos=v,p=2,n=s,l=vidhilin
BARqIre	BARqIra	pos=n,g=m,c=7,n=s
kzaRam	kzaRa	pos=n,g=m,c=2,n=s
api	api	pos=i
Gana	Gana	pos=n,comp=y
SyAmala	SyAmala	pos=n,comp=y
ruci	ruci	pos=n,g=m,c=7,n=s
tato	tatas	pos=i
haMsA	haMsa	pos=n,g=m,c=1,n=p
biBrat	Bf	pos=va,g=m,c=1,n=s,f=part
niKila	niKila	pos=a,comp=y
naBasaH	naBas	pos=n,g=n,c=6,n=s
cikramizayA	cikramizA	pos=n,g=f,c=3,n=s
sa	tad	pos=n,g=m,c=1,n=s
varDizRum	varDizRu	pos=a,g=m,c=2,n=s
vizRum	vizRu	pos=n,g=m,c=2,n=s
kalita	kalay	pos=va,comp=y,f=part
dara	dara	pos=n,comp=y
cakram	cakra	pos=n,g=m,c=2,n=s
tulayitA	tulayitf	pos=a,g=m,c=1,n=s

# id = HamDu.28
tvam	tvad	pos=n,g=,c=1,n=s
azwABiH	azwan	pos=n,g=m,c=3,n=p
netrEH	netra	pos=n,g=m,c=3,n=p
vigalat	vigal	pos=va,comp=y,f=part
amala	amala	pos=a,comp=y
prema	preman	pos=n,comp=y
salilEH	salila	pos=n,g=m,c=3,n=p
muhuH	muhur	pos=i
sic	sic	pos=va,comp=y,f=part
stamBAm	stamBa	pos=n,g=f,c=2,n=s
catura	catura	pos=a,g=m,c=8,n=s
catuH	catur	pos=n,comp=y
Asya	Asya	pos=n,comp=y
stuti	stuti	pos=n,comp=y
Buvam	BU	pos=n,g=f,c=2,n=s
jihITA	hA	pos=v,p=2,n=s,l=vidhilin
viKyAtAm	viKyA	pos=va,g=f,c=2,n=s,f=part
sPuwam	sPuwa	pos=a,g=m,c=2,n=s
iha	iha	pos=i
Bavat	Bavat	pos=a,comp=y
bAnDava	bAnDava	pos=n,comp=y
raTam	raTa	pos=n,g=m,c=2,n=s
pravizwam	praviS	pos=va,g=m,c=2,n=s,f=part
maMsyante	man	pos=v,p=3,n=p,l=lrt
viDim	viDi	pos=n,g=m,c=2,n=s
awavI	awavI	pos=n,comp=y
devIH	devI	pos=n,g=f,c=1,n=p
tvayi	tvad	pos=n,g=,c=7,n=s
gate	gam	pos=va,g=m,c=7,n=s,f=part

# id = HamDu.29
prasara	prasara	pos=n,comp=y
laharI	lahari	pos=n,comp=y
picCila	picCila	pos=a,comp=y
paTa	paTa	pos=n,comp=y
sKalat	sKal	pos=va,comp=y,f=part
pAdanyAsa	pAdanyAsa	pos=n,comp=y
praRiDA	praRiDA	pos=va,comp=y,f=part
vilamba	vilamba	pos=n,comp=y
Akula	Akula	pos=a,comp=y
DiyaH	DI	pos=n,g=f,c=1,n=p
harO	hari	pos=n,g=m,c=7,n=s
yasmin	yad	pos=n,g=m,c=7,n=s
magne	majj	pos=va,g=m,c=7,n=s,f=part
tvarita	tvarita	pos=a,comp=y
yamunA	yamunA	pos=n,comp=y
kUla	kUla	pos=n,comp=y
gamana	gamana	pos=n,comp=y
spfhA	spfhA	pos=n,comp=y
kzip	kzip	pos=va,g=f,c=1,n=p,f=part
gopyo	gopI	pos=n,g=f,c=1,n=p
yayuH	yA	pos=v,p=3,n=p,l=lit
anupadam	anupada	pos=n,g=n,c=2,n=s
kAm	ka	pos=n,g=f,c=2,n=s
api	api	pos=i
daSAm	daSA	pos=n,g=f,c=2,n=s

# id = HamDu.30
muhuH	muhur	pos=i
lAsya	lAsya	pos=n,comp=y
krIqA	krIqA	pos=n,comp=y
pramada	pramada	pos=n,comp=y
milat	mil	pos=va,comp=y,f=part
AhopuruzikAH	AhopuruzikA	pos=n,g=f,c=1,n=p
vikASena	vikASa	pos=n,g=m,c=3,n=s
BrazwEH	BraMS	pos=va,g=m,c=3,n=p,f=part
PaRi	PaRin	pos=n,comp=y
maRi	maRi	pos=n,comp=y
kuli	kuli	pos=n,g=m,c=6,n=s
DUmala	DUmala	pos=n,comp=y
rucA	ruci	pos=n,g=f,c=7,n=s
puras	puras	pos=i
tasmin	tad	pos=n,g=m,c=7,n=s
nIpa	nIpa	pos=n,comp=y
druma	druma	pos=n,comp=y
kusuma	kusuma	pos=n,comp=y
kiYjalka	kiYjalka	pos=n,comp=y
suraBO	suraBi	pos=a,g=m,c=7,n=s
tvayA	tvad	pos=n,g=,c=3,n=s
puRye	puRya	pos=a,g=m,c=7,n=s
peyam	pA	pos=va,g=n,c=1,n=s,f=krtya
maDuram	maDura	pos=a,g=n,c=1,n=s
udakam	udaka	pos=n,g=n,c=1,n=s
kAliya	kAliya	pos=n,comp=y
hrade	hrada	pos=n,g=m,c=7,n=s

# id = HamDu.31
tfRAvarta	tfRAvarta	pos=n,comp=y
arAti	arAti	pos=n,g=m,c=6,n=s
viraha	viraha	pos=n,comp=y
dava	dava	pos=n,comp=y
saMtApita	saMtApay	pos=va,comp=y,f=part
tanoH	tanu	pos=n,g=m,c=6,n=s
sadA	sadA	pos=i
ABIrI	ABIrI	pos=n,comp=y
vfnda	vfnda	pos=n,comp=y
praRaya	praRaya	pos=n,comp=y
bahu	bahu	pos=a,comp=y
mAnonnati	mAnonnati	pos=n,comp=y
vidaH	vid	pos=a,g=m,c=6,n=s
praRetavyo	praRI	pos=va,g=m,c=1,n=s,f=krtya
navya	navya	pos=n,comp=y
stabaka	stabaka	pos=n,comp=y
Bara	Bara	pos=n,comp=y
saMvarDay	saMvarDay	pos=va,comp=y,f=part
SucaH	Suc	pos=n,g=f,c=6,n=s
tvayA	tvad	pos=n,g=,c=3,n=s
vfndA	vfndA	pos=n,comp=y
devyAH	devI	pos=n,g=f,c=6,n=s
parama	parama	pos=a,comp=y
vinayAt	vinaya	pos=n,g=m,c=5,n=s
vandana	vandana	pos=n,comp=y
viDiH	viDi	pos=n,g=m,c=1,n=s

# id = HamDu.32
iti	iti	pos=i
krAntvA	kram	pos=vi
kekA	kekA	pos=n,comp=y
kfta	kf	pos=va,comp=y,f=part
virutim	viruti	pos=n,g=f,c=2,n=s
ekAdaSa	ekAdaSan	pos=n,comp=y
vanIm	vanI	pos=n,g=f,c=2,n=s
GanIBUtam	GanIBU	pos=va,g=n,c=2,n=s,f=part
cUtEH	cUta	pos=n,g=m,c=3,n=p
vrajam	vraja	pos=n,g=m,c=2,n=s
anuvanam	anuvanam	pos=i
dvAdaSam	dvAdaSa	pos=a,g=n,c=2,n=s
idam	idam	pos=n,g=n,c=2,n=s
purI	purI	pos=n,g=f,c=1,n=s
yasmin	yad	pos=n,g=m,c=7,n=s
Aste	As	pos=v,p=3,n=s,l=lat
yadu	yadu	pos=n,comp=y
kula	kula	pos=n,comp=y
Buvi	BU	pos=n,g=f,c=7,n=s
nirmala	nirmala	pos=a,comp=y
yaSaH	yaSas	pos=n,g=n,c=1,n=s
BarARAm	Bara	pos=n,g=m,c=6,n=p
DArABiH	DArA	pos=n,g=f,c=3,n=p
Davalita	Davalay	pos=va,comp=y,f=part
DaritrI	DaritrI	pos=n,comp=y
parisarA	parisara	pos=n,g=f,c=1,n=s

# id = HamDu.33
niketEH	niketa	pos=n,g=m,c=3,n=p
AkIrRA	Akf	pos=va,g=f,c=1,n=s,f=part
giriSa	giriSa	pos=n,comp=y
giri	giri	pos=n,comp=y
qimBa	qimBa	pos=n,comp=y
pratiBawEH	pratiBawa	pos=a,g=m,c=3,n=p
avazwamBa	avazwamBa	pos=n,comp=y
stamBa	stamBa	pos=n,comp=y
AvalI	Avali	pos=n,comp=y
vilasitEH	vilas	pos=va,g=m,c=3,n=p,f=part
puzpita	puzpita	pos=a,comp=y
vanA	vana	pos=n,g=f,c=1,n=s
nivizwA	niviS	pos=va,g=f,c=1,n=s,f=part
kAlindI	kAlindI	pos=n,comp=y
tawa	tawa	pos=n,comp=y
Buvi	BU	pos=n,g=f,c=7,n=s
te	tvad	pos=n,g=,c=6,n=s
ADAsyati	ADA	pos=v,p=3,n=s,l=lrt
saKe	saKi	pos=n,g=,c=8,n=s
samantAt	samantAt	pos=i
Anandam	Ananda	pos=n,g=m,c=2,n=s
maDura	maDura	pos=a,comp=y
jana	jana	pos=n,comp=y
vfndA	vfnda	pos=n,g=f,c=1,n=s
maDupurI	maDupurI	pos=n,g=f,c=1,n=s

# id = HamDu.34
vfzaH	vfza	pos=n,g=m,c=1,n=s
SamBoH	SamBu	pos=n,g=m,c=6,n=s
yasyAm	yad	pos=n,g=f,c=7,n=s
daSati	daMS	pos=v,p=3,n=s,l=lat
navam	nava	pos=a,g=n,c=2,n=s
ekatra	ekatra	pos=i
yavasam	yavasa	pos=n,g=n,c=2,n=s
viriYceH	viriYci	pos=n,g=m,c=6,n=s
anyasmin	anya	pos=n,g=m,c=7,n=s
gilati	gf	pos=v,p=3,n=s,l=lat
kalahaMso	kalahaMsa	pos=n,g=m,c=1,n=s
bisa	bisa	pos=n,comp=y
latAm	latA	pos=n,g=f,c=2,n=s
kvacit	kvacid	pos=i
krOYcArAteH	krOYcArAti	pos=n,g=m,c=6,n=s
kavalayati	kekin	pos=n,g=m,c=1,n=s
kekI	vizaDara	pos=n,g=m,c=2,n=s
vizaDaram	vilih	pos=va,g=m,c=7,n=s,f=part
vilIQe	SallakI	pos=n,g=f,c=3,n=s
bala	bala	pos=n,comp=y
ripu	ripu	pos=n,comp=y
karI	kara	pos=a,g=f,c=1,n=s
pallava	pallava	pos=n,comp=y
mitaH	mita	pos=a,g=m,c=1,n=s

# id = HamDu.35
kAzAn	nahi	pos=i
nahi	viGaw	pos=va,g=f,c=2,n=s,f=part
pracCada	pracCada	pos=n,comp=y
pawIm	pawI	pos=n,g=f,c=2,n=s
vimuktAm	vimuc	pos=va,g=f,c=2,n=s,f=part
ajYAsIH	jYA	pos=v,p=2,n=s,l=lun
vimuktAmajYAsIH	paTin	pos=n,g=m,c=7,n=s
paTi	paTin	pos=n,g=m,c=7,n=s
paTi	na	pos=i
muktA	muktA	pos=n,comp=y
AvalIm	Avali	pos=n,g=f,c=2,n=s
api	api	pos=i
ayi	ayi	pos=i
SrI	SrI	pos=n,comp=y
govinda	govinda	pos=n,comp=y
smaraRa	smaraRa	pos=n,comp=y
madirA	madirA	pos=n,comp=y
matta	mad	pos=va,comp=y,f=part
hfdaye	hfdaya	pos=n,g=m,c=7,n=s
sati	as	pos=va,g=m,c=7,n=s,f=part
iti	iti	pos=i
KyAtim	KyAti	pos=n,g=f,c=2,n=s
te	tvad	pos=n,g=,c=6,n=s
hasati	has	pos=v,p=3,n=s,l=lat
kulawAnAm	kulawA	pos=n,g=f,c=6,n=p
kulam	kula	pos=n,g=n,c=1,n=s
idam	idam	pos=n,g=n,c=1,n=s

# id = HamDu.36
asavyam	asavya	pos=a,g=n,c=2,n=s
biBrARA	Bf	pos=va,g=f,c=1,n=s,f=part
padam	pada	pos=n,g=n,c=2,n=s
aDfta	aDfta	pos=a,comp=y
lAkzA	lAkzA	pos=n,comp=y
rasam	rasa	pos=n,g=n,c=2,n=s
asO	adas	pos=n,g=f,c=1,n=s
prayAtA	prayA	pos=va,g=f,c=1,n=s,f=part
aham	mad	pos=n,g=,c=1,n=s
mugDe	muh	pos=va,g=f,c=8,n=s,f=part
virama	virama	pos=n,g=m,c=8,n=s
mama	mad	pos=n,g=,c=6,n=s
veSEH	veSa	pos=n,g=m,c=3,n=p
kim	ka	pos=n,g=n,c=1,n=s
aDunA	aDunA	pos=i
amandAd	amanda	pos=a,g=m,c=5,n=s
ASaNke	ASaNk	pos=v,p=1,n=s,l=lat
saKi	saKI	pos=n,g=f,c=8,n=s
pura	pura	pos=n,comp=y
puraMDrI	puraMDrI	pos=n,comp=y
kalakalAt	kalakala	pos=n,g=m,c=5,n=s
alinda	alinda	pos=n,comp=y
agre	agra	pos=n,g=n,c=7,n=s
vfndAvana	vfndAvana	pos=n,comp=y
kusumaDanvA	kusumaDanvan	pos=n,g=m,c=1,n=s
vijayate	viji	pos=v,p=3,n=s,l=lat

# id = HamDu.37
ayam	idam	pos=n,g=m,c=1,n=s
lIlA	lIlA	pos=n,comp=y
apANga	apANga	pos=n,comp=y
snapita	snapay	pos=va,comp=y,f=part
pura	pura	pos=n,comp=y
vITI	vITi	pos=n,comp=y
parisaraH	parisara	pos=n,g=m,c=1,n=s
nava	nava	pos=a,comp=y
aSoka	aSoka	pos=n,comp=y
uttaMsaH	uttaMsa	pos=n,g=m,c=1,n=s
calati	cal	pos=v,p=3,n=s,l=lat
purataH	puratas	pos=i
kaMsa	kaMsa	pos=n,comp=y
vijayI	vijayin	pos=a,g=m,c=1,n=s
kim	ka	pos=n,g=n,c=2,n=s
asmAn	mad	pos=n,g=m,c=2,n=p
etasmAt	etad	pos=n,g=n,c=5,n=s
maRi	maRi	pos=n,comp=y
Bavana	Bavana	pos=n,comp=y
pfzWataH	pfzWa	pos=n,g=n,c=5,n=s
vinudatI	vinud	pos=va,g=f,c=1,n=s,f=part
tvam	tvad	pos=n,g=,c=1,n=s
ekA	eka	pos=n,g=f,c=1,n=s
stabDa	stamB	pos=va,comp=y,f=part
akzi	akza	pos=a,g=f,c=8,n=s
sTagayasi	sTagay	pos=v,p=2,n=s,l=lat
gavAkza	gavAkza	pos=n,comp=y
AvalIm	Avali	pos=n,g=f,c=2,n=s
api	api	pos=i

# id = HamDu.38
muhuH	muhur	pos=i
SUnyAm	SUnya	pos=a,g=f,c=2,n=s
dfzwim	dfzwi	pos=n,g=f,c=2,n=s
vahasi	vah	pos=v,p=2,n=s,l=lat
rahasi	rahas	pos=n,g=n,c=7,n=s
DyAyasi	DyA	pos=v,p=2,n=s,l=lat
sadA	sadA	pos=i
SfRozi	Sru	pos=v,p=2,n=s,l=lat
pratyakzam	pratyakza	pos=a,g=n,c=2,n=s
na	na	pos=i
parijana	parijana	pos=n,comp=y
vijYApana	vijYApana	pos=n,comp=y
Satam	Sata	pos=n,g=n,c=2,n=s
ataH	atas	pos=i
SaNke	SaNk	pos=v,p=1,n=s,l=lat
paNkeruha	paNkeruha	pos=n,comp=y
muKi	muKI	pos=n,g=f,c=8,n=s
yayO	yA	pos=v,p=3,n=s,l=lit
SyAmala	SyAmala	pos=n,comp=y
ruciH	ruci	pos=n,g=m,c=1,n=s
sa	tad	pos=n,g=m,c=1,n=s
yUnAm	yuvan	pos=n,g=m,c=6,n=p
nayana	nayana	pos=n,comp=y
vITI	vITi	pos=n,comp=y
paTikatAm	paTikatA	pos=n,g=f,c=2,n=s

# id = HamDu.39
vilajjam	vilajja	pos=a,g=n,c=2,n=s
mA	mA	pos=i
rodIH	rud	pos=v,p=2,n=s,l=lun_unaug
iha	iha	pos=i
saKi	saKI	pos=n,g=f,c=8,n=s
punaH	punar	pos=i
yAsyati	yA	pos=v,p=3,n=s,l=lrt
haris	hari	pos=n,g=m,c=1,n=s
te	tvad	pos=n,g=,c=6,n=s
apANga	apANga	pos=n,comp=y
krIqA	krIqA	pos=n,comp=y
nibiqa	nibiqa	pos=a,comp=y
paricaryA	paricaryA	pos=n,comp=y
grahi	grahi	pos=n,comp=y
latAm	latA	pos=n,g=f,c=2,n=s
iti	iti	pos=i
KEram	yad	pos=n,g=f,c=7,n=s
yasyAm	paTin	pos=n,g=m,c=7,n=s
paTi	paTin	pos=n,g=m,c=7,n=s
paTi	murAri	pos=n,g=m,c=6,n=s
aBinava	aBinava	pos=a,comp=y
praveSe	praveSa	pos=n,g=m,c=7,n=s
aBinavapraveSe	nArI	pos=n,g=f,c=6,n=p
rati	rati	pos=n,comp=y
raBasa	raBasa	pos=a,comp=y
jalpAH	jalpa	pos=n,g=m,c=1,n=p
ratiraBasajalpA	van	pos=v,p=3,n=p,l=lit

# id = HamDu.40
paYcaBiH	paYcan	pos=n,g=m,c=3,n=p
kulakam	kulaka	pos=n,g=n,c=1,n=s
saKe	saKi	pos=n,g=,c=8,n=s
sAkzAt	sAkzAt	pos=i
dAmodara	dAmodara	pos=n,comp=y
vadana	vadana	pos=n,comp=y
candra	candra	pos=n,g=f,c=1,n=p
muhus	muhur	pos=i
tatra	tatra	pos=i
ABIrI	ABIrI	pos=n,comp=y
samudaya	samudaya	pos=n,comp=y
SiraH	Siras	pos=n,comp=y
nyasta	nyas	pos=va,comp=y,f=part
vipadaH	vipad	pos=n,g=f,c=1,n=p
tavAkzRoH	Ananda	pos=n,g=m,c=2,n=s
Anandam	viDA	pos=v,p=3,n=p,l=lat
vidaDati	purA	pos=i
pOra	pOra	pos=n,comp=y
vanitAH	vanitA	pos=n,g=f,c=1,n=p

# id = HamDu.41
aTa	aTa	pos=i
krama	krama	pos=n,comp=y
GawanayA	Gawana	pos=n,g=f,c=3,n=s
krAmam	saMkawatara	pos=a,g=m,c=2,n=p
kramaGawanayA	nivAsa	pos=n,g=m,c=2,n=p
saMkawatarAn	vfzRi	pos=n,g=m,c=6,n=p
nivAsAn	anusf	pos=v,p=2,n=s,l=lot
purI	purI	pos=n,comp=y
maDya	maDya	pos=n,comp=y
viSiKAn	viSiKa	pos=a,g=m,c=2,n=p
murArAti	murArAti	pos=n,g=m,c=6,n=s
yatra	yatra	pos=i
sTagita	sTagita	pos=a,comp=y
gaganABiH	gagana	pos=n,g=f,c=3,n=p
vijayate	viji	pos=v,p=3,n=s,l=lat
patAkABiH	patAkA	pos=n,g=f,c=3,n=p
saMtarpita	saMtarpay	pos=va,comp=y,f=part
Buvanam	Buvana	pos=n,g=n,c=2,n=s
antaHpura	antaHpura	pos=n,comp=y
varam	vara	pos=a,g=n,c=2,n=s

# id = HamDu.42
yad	yad	pos=n,comp=y
utsaNge	utsaNga	pos=n,g=m,c=7,n=s
tuNga	tuNga	pos=n,comp=y
sPawika	sPawika	pos=n,comp=y
racitAH	racay	pos=va,g=m,c=1,n=p,f=part
santi	as	pos=v,p=3,n=p,l=lat
parito	paritas	pos=i
marAlA	marAla	pos=n,g=m,c=1,n=p
mARikya	mARikya	pos=n,comp=y
prakara	prakara	pos=n,comp=y
Gawita	Gaw	pos=va,comp=y,f=part
trowi	trowi	pos=n,comp=y
caraRAH	caraRa	pos=n,g=m,c=1,n=p
suhfd	suhfd	pos=n,comp=y
budDyA	budDi	pos=n,g=f,c=3,n=s
haMsAH	haMsa	pos=n,g=m,c=1,n=p
kalita	kalay	pos=va,comp=y,f=part
maDurasya	maDura	pos=a,g=m,c=6,n=s
ambuja	ambuja	pos=n,comp=y
BuvaH	BU	pos=n,g=f,c=1,n=p
sa	sa	pos=i
maryAdAH	maryAdA	pos=n,g=f,c=1,n=p
yezAm	yad	pos=n,g=m,c=6,n=p
sapadi	sapadi	pos=i
paricaryAm	paricaryA	pos=n,g=f,c=2,n=s
vidaDati	viDA	pos=v,p=3,n=p,l=lat

# id = HamDu.43
cirAn	cirAt	pos=i
paSu	paSu	pos=n,comp=y
para	para	pos=n,comp=y
maRInAm	maRi	pos=n,g=m,c=6,n=p
api	api	pos=i
paSuparamaRInAmapi	kula	pos=n,g=n,c=3,n=p
kulEH	alabDa	pos=a,g=n,c=1,n=s
kAlindI	kAlindI	pos=n,comp=y
pulina	pulina	pos=n,comp=y
vipine	vipina	pos=n,g=n,c=7,n=s
lInam	lI	pos=va,g=n,c=1,n=s,f=part
aBitas	aBitas	pos=i
mad	mad	pos=n,comp=y
Aloka	Aloka	pos=n,comp=y
ullAsin	ullAsin	pos=a,comp=y
smita	smita	pos=n,comp=y
parici	parici	pos=va,comp=y,f=part
Asyam	Asya	pos=n,g=n,c=1,n=s
priyasakzi	sPur	pos=va,g=m,c=2,n=s,f=part
sPurantam	vIkz	pos=v,p=1,n=s,l=lrt
punaH	punar	pos=i
api	api	pos=i
kim	ka	pos=n,g=n,c=2,n=s
agre	agra	pos=n,g=n,c=7,n=s
kimagre	muraBid	pos=n,g=m,c=2,n=s

# id = HamDu.44
vizAdam	vizAda	pos=n,g=m,c=2,n=s
mAm	mad	pos=n,g=,c=2,n=s
akArzIH	kf	pos=v,p=2,n=s,l=lun
drutam	dru	pos=va,g=n,c=2,n=s,f=part
avitaTa	avitaTa	pos=a,comp=y
vyAhftiH	vyAhfti	pos=n,g=f,c=1,n=s
asO	adas	pos=n,g=f,c=1,n=s
samAgantA	samAgantf	pos=a,g=m,c=1,n=s
rADe	rADA	pos=n,g=f,c=8,n=s
Dfta	Df	pos=va,comp=y,f=part
nava	nava	pos=a,comp=y
SiKaRqaH	SiKaRqa	pos=n,g=m,c=1,n=s
te	tvad	pos=n,g=,c=6,n=s
saKA	saKi	pos=n,g=,c=1,n=s
iti	iti	pos=i
brUte	brU	pos=v,p=3,n=s,l=lat
yasyAm	yad	pos=n,g=f,c=7,n=s
Suka	Suka	pos=n,comp=y
miTunam	miTuna	pos=n,g=n,c=1,n=s
indrAnujEH	indrAnuja	pos=n,g=m,c=8,n=s
kfte	kfta	pos=n,g=n,c=7,n=s
yat	yat	pos=i
ABIrI	ABIrI	pos=n,comp=y
vfndEH	vfnda	pos=n,g=n,c=3,n=p
upahftam	upahf	pos=va,g=n,c=1,n=s,f=part
aBUt	BU	pos=v,p=3,n=s,l=lun
udDava	udDava	pos=n,comp=y
kare	kara	pos=a,g=m,c=7,n=s

# id = HamDu.45
Gana	Gana	pos=a,comp=y
SyAmA	SyAma	pos=a,g=f,c=1,n=s
BrAmyati	Bram	pos=v,p=3,n=s,l=lat
upari	upari	pos=i
hari	hari	pos=n,comp=y
harmyasya	harmya	pos=n,g=n,c=6,n=s
SiKiBiH	SiKin	pos=n,g=m,c=3,n=p
kfta	kf	pos=va,comp=y,f=part
stotrA	stotra	pos=n,g=f,c=1,n=s
mUQEH	muh	pos=va,g=m,c=3,n=p,f=part
aguru	aguru	pos=n,comp=y
janitA	janay	pos=va,g=f,c=1,n=s,f=part
DUma	DUma	pos=n,comp=y
latikA	latikA	pos=n,g=f,c=1,n=s
tad	tad	pos=n,comp=y
AlokAt	Aloka	pos=n,g=m,c=5,n=s
DIra	DIra	pos=a,g=m,c=8,n=s
sPurati	sPur	pos=v,p=3,n=s,l=lat
tava	tvad	pos=n,g=,c=6,n=s
ced	ced	pos=i
mAnasa	mAnasa	pos=n,comp=y
ruciH	ruci	pos=n,g=f,c=1,n=s
jitam	ji	pos=va,g=n,c=1,n=s,f=part
tarhi	tarhi	pos=i
svEram	svEra	pos=n,g=n,c=1,n=s
jana	jana	pos=n,comp=y
saha	saha	pos=i
nivAsa	nivAsa	pos=n,comp=y
priya	priya	pos=a,comp=y
tayA	tA	pos=n,g=f,c=3,n=s

# id = HamDu.46
tato	tatas	pos=i
maDye	maDya	pos=n,g=n,c=7,n=s
kakzam	kakza	pos=n,g=m,c=2,n=s
pratinava	pratinava	pos=a,comp=y
gavAkza	gavAkza	pos=n,comp=y
stavakitam	stavakita	pos=a,g=m,c=2,n=s
calat	cal	pos=va,comp=y,f=part
muktA	muktA	pos=n,comp=y
lamba	lamba	pos=n,comp=y
sPuritam	sPur	pos=va,g=m,c=2,n=s,f=part
amala	amala	pos=a,comp=y
stamBa	stamBa	pos=n,comp=y
nivaham	nivaha	pos=n,g=m,c=2,n=s
BavAn	BU	pos=va,g=m,c=1,n=s,f=part
drazwA	drazwf	pos=n,g=m,c=1,n=s
hema	heman	pos=n,comp=y
ulliK	ulliK	pos=va,comp=y,f=part
daSama	daSama	pos=a,comp=y
skanDa	skanDa	pos=n,comp=y
caritEH	car	pos=va,g=n,c=3,n=p,f=part
lasat	las	pos=va,comp=y,f=part
Bitti	Bitti	pos=n,comp=y
prAntam	prAnta	pos=n,g=m,c=2,n=s
muravijayinaH	muravijayin	pos=n,g=m,c=6,n=s
keli	keli	pos=n,comp=y
nilayam	nilaya	pos=n,g=m,c=2,n=s

# id = HamDu.47
alinde	alinda	pos=n,g=m,c=7,n=s
yasya	yad	pos=n,g=m,c=6,n=s
Aste	As	pos=v,p=3,n=s,l=lat
marakata	marakata	pos=n,comp=y
mayI	maya	pos=a,g=f,c=1,n=s
yazwiH	yazwi	pos=n,g=f,c=1,n=s
amalA	amala	pos=a,g=f,c=1,n=s
SayAluH	SayAlu	pos=a,g=m,c=1,n=s
yAm	yad	pos=n,g=f,c=2,n=s
rAtrO	rAtri	pos=n,g=f,c=7,n=s
mada	mada	pos=n,comp=y
kala	kala	pos=a,comp=y
kalApI	kalApin	pos=n,g=m,c=1,n=s
kalayati	kalay	pos=v,p=3,n=s,l=lat
nirAtaNkam	nirAtaNka	pos=a,g=m,c=2,n=s
tasyAH	tad	pos=n,g=f,c=6,n=s
SiKaram	SiKara	pos=n,g=m,c=2,n=s
aDiruhya	aDiruh	pos=vi
Srama	Srama	pos=n,comp=y
nudam	nud	pos=a,g=m,c=2,n=s
pratIkzeTA	pratIkz	pos=v,p=2,n=s,l=vidhilin
BrAtaH	BrAtf	pos=n,g=m,c=8,n=s
varam	vara	pos=a,g=m,c=2,n=s
avasaram	avasara	pos=n,g=m,c=2,n=s
yAdava	yAdava	pos=n,comp=y
patyuH	pati	pos=n,g=m,c=6,n=s

# id = HamDu.48
nivizwaH	niviS	pos=va,g=m,c=1,n=s,f=part
palyaNke	palyaNka	pos=n,g=m,c=7,n=s
mfdulatara	mfdulatara	pos=a,comp=y
tUlI	tUlI	pos=n,comp=y
Davalite	Davalay	pos=va,g=m,c=7,n=s,f=part
trilokI	trilokI	pos=n,comp=y
lakzmI	lakzmI	pos=n,g=f,c=6,n=p
kakudi	kakud	pos=n,g=f,c=7,n=s
dara	dara	pos=a,comp=y
sAcIkfta	sAcIkfta	pos=a,comp=y
tanuH	tanu	pos=n,g=m,c=1,n=s
amandam	amanda	pos=a,g=m,c=2,n=s
pUrRa	pUrRa	pos=a,comp=y
indu	indu	pos=n,comp=y
pratimam	pratima	pos=a,g=n,c=2,n=s
upaDAnam	upaDAna	pos=n,g=n,c=2,n=s
pramudito	pramud	pos=va,g=m,c=1,n=s,f=part
niDAya	niDA	pos=vi
agre	agra	pos=n,g=n,c=7,n=s
tasminn	tad	pos=n,g=n,c=7,n=s
upaDA	upaDA	pos=va,comp=y,f=part
kaPoli	kaPoli	pos=n,comp=y
dvaya	dvaya	pos=n,comp=y
BaraH	Bara	pos=n,g=m,c=1,n=s

# id = HamDu.49
udaYcat	udaYc	pos=va,comp=y,f=part
kAlindI	kAlindI	pos=n,comp=y
salila	salila	pos=n,comp=y
suBagaMBAvuka	suBagaMBAvuka	pos=a,comp=y
ruciH	ruci	pos=n,g=m,c=1,n=s
kapola	kapola	pos=n,comp=y
ante	anta	pos=n,g=m,c=7,n=s
preNKat	preNK	pos=va,comp=y,f=part
maRi	maRi	pos=n,comp=y
makara	makara	pos=n,comp=y
mudrA	mudrA	pos=n,comp=y
maDurimA	maDuriman	pos=n,g=m,c=1,n=s
vasAnaH	vas	pos=va,g=m,c=1,n=s,f=part
kOSeyam	kOSeya	pos=n,g=n,c=2,n=s
jita	ji	pos=va,comp=y,f=part
kanaka	kanaka	pos=n,comp=y
lakzmi	lakzmI	pos=n,comp=y
parimalam	parimala	pos=n,g=n,c=2,n=s
mukundaH	mukunda	pos=n,g=m,c=1,n=s
te	tvad	pos=n,g=,c=6,n=s
sAkzAt	sAkzAt	pos=i
pramada	pramada	pos=n,comp=y
suDayA	suDA	pos=n,g=f,c=3,n=s
sekzyati	sic	pos=v,p=3,n=s,l=lrt
dfSO	dfS	pos=n,g=f,c=2,n=d

# id = HamDu.50
vikadruH	vikadru	pos=n,g=m,c=1,n=s
aKila	aKila	pos=a,comp=y
kula	kula	pos=n,comp=y
vfdDaH	vfdDa	pos=a,g=m,c=1,n=s
aKilakulavfdDo	yadupati	pos=n,g=m,c=6,n=s
yadupateH	adUra	pos=a,g=n,c=5,n=s
adUrAd	As	pos=va,g=m,c=1,n=s,f=part
maDura	maDura	pos=a,comp=y
BaRiti	BaRiti	pos=n,g=m,c=1,n=s
gAsyati	gA	pos=v,p=3,n=s,l=lrt
maDuraBaRitirgAsyati	tadA	pos=i
purastAd	purastAt	pos=i
ABIrI	ABIrI	pos=n,comp=y
gaRa	gaRa	pos=n,comp=y
Baya	Baya	pos=n,comp=y
da	da	pos=a,comp=y
nAmA	nAman	pos=n,g=m,c=1,n=s
sa	tad	pos=n,g=m,c=1,n=s
kaWino	kaWina	pos=a,g=m,c=1,n=s
maRi	maRi	pos=n,comp=y
stamBa	stamBa	pos=n,comp=y
AlambI	Alambin	pos=a,g=m,c=1,n=s
kuru	kuru	pos=n,comp=y
kula	kula	pos=n,comp=y
kaTAm	kaTA	pos=n,g=f,c=2,n=s
saMkalayitA	saMkalayitf	pos=a,g=m,c=1,n=s

# id = HamDu.51
SilInAm	SilI	pos=n,g=f,c=6,n=p
uttuMsaH	uttuMsa	pos=n,g=m,c=1,n=s
sa	tad	pos=n,g=m,c=1,n=s
kila	kila	pos=i
kfta	kf	pos=va,comp=y,f=part
varma	varman	pos=n,g=n,c=2,n=s
api	api	pos=i
uBayatas	uBayatas	pos=i
praRezyete	praRI	pos=v,p=3,n=d,l=lrt
vAla	vAla	pos=n,comp=y
vyajana	vyajana	pos=n,comp=y
yugala	yugala	pos=n,comp=y
Andolana	Andolana	pos=n,comp=y
viDim	viDi	pos=n,g=m,c=2,n=s
sa	tad	pos=n,g=m,c=1,n=s
jAnuByAm	jAnu	pos=n,g=m,c=3,n=d
azwApada	azwApada	pos=n,comp=y
Buvam	BU	pos=n,g=f,c=2,n=s
avazwaBya	avazwamB	pos=vi
BavitA	Bavitf	pos=a,g=m,c=1,n=s
guroH	guru	pos=n,g=m,c=6,n=s
Sizyo	Sizya	pos=n,g=m,c=1,n=s
nUnam	nUnam	pos=i
pada	pada	pos=n,comp=y
kamala	kamala	pos=n,comp=y
saMvAhana	saMvAhana	pos=n,comp=y
rataH	ram	pos=va,g=m,c=1,n=s,f=part

# id = HamDu.52
vihaNga	vihaMga	pos=n,comp=y
indraH	indra	pos=n,g=m,c=1,n=s
yugmIkf	yugmIkf	pos=va,comp=y,f=part
kara	kara	pos=n,comp=y
sarojaH	saroja	pos=n,g=m,c=1,n=s
Buvi	BU	pos=n,g=f,c=7,n=s
puraH	puras	pos=i
kfta	kf	pos=va,comp=y,f=part
ASaNkaH	ASaNkA	pos=n,g=m,c=1,n=s
BAvI	BAvin	pos=a,g=m,c=1,n=s
prajavini	prajavin	pos=a,g=m,c=7,n=s
nideSe	nideSa	pos=n,g=m,c=7,n=s
arpita	arpay	pos=va,comp=y,f=part
manAH	manas	pos=n,g=m,c=1,n=s
Cada	Cada	pos=n,comp=y
dvandve	dvaMdva	pos=n,g=n,c=7,n=s
yasya	yad	pos=n,g=m,c=6,n=s
Dvanati	Dvan	pos=v,p=3,n=s,l=lat
maTurA	maTurA	pos=n,comp=y
vAsi	vAsin	pos=a,comp=y
vawavaH	vawu	pos=n,g=m,c=1,n=p
vyudasyante	vyudas	pos=v,p=3,n=p,l=lat
sAma	sAman	pos=n,comp=y
svara	svara	pos=n,comp=y
kalitam	kalay	pos=va,g=m,c=2,n=s,f=part
anyonya	anyonya	pos=n,comp=y
kalaham	kalaha	pos=n,g=m,c=2,n=s

# id = HamDu.53
na	na	pos=i
nirvaktum	nirvac	pos=vi
dAmodara	dAmodara	pos=n,comp=y
pada	pada	pos=n,comp=y
kanizWA	kanizWA	pos=n,comp=y
aNguli	aNguli	pos=n,comp=y
naKa	naKa	pos=n,comp=y
dyutInAm	dyuti	pos=n,g=f,c=6,n=p
lAvaRyam	lAvaRya	pos=n,g=n,c=2,n=s
Bavati	BU	pos=v,p=3,n=s,l=lat
caturAsyo	caturAsya	pos=n,g=m,c=1,n=s
'pi	api	pos=i
caturaH	catura	pos=a,g=m,c=1,n=s
taTA	taTA	pos=i
api	api	pos=i
strI	strI	pos=n,comp=y
prajYA	prajYA	pos=n,comp=y
sulaBa	sulaBa	pos=a,comp=y
taralatvAt	taralatva	pos=n,g=n,c=5,n=s
aham	mad	pos=n,g=,c=1,n=s
asO	adas	pos=n,g=f,c=1,n=s
pravfttA	pravft	pos=va,g=f,c=1,n=s,f=part
tad	tad	pos=n,comp=y
mUrti	mUrti	pos=n,comp=y
stava	stava	pos=n,comp=y
rati	rati	pos=n,comp=y
mahAsAhasa	mahAsAhasa	pos=n,comp=y
rase	rasa	pos=n,g=m,c=7,n=s

# id = HamDu.54
virAjante	virAj	pos=v,p=3,n=p,l=lat
yasya	yad	pos=n,g=m,c=6,n=s
vraja	vraja	pos=n,comp=y
SiSu	SiSu	pos=n,comp=y
kula	kula	pos=n,comp=y
steya	steya	pos=n,comp=y
vikala	vikala	pos=a,comp=y
svayaMBU	svayamBu	pos=n,comp=y
cUqA	cUqA	pos=n,comp=y
agrEH	agra	pos=n,g=n,c=3,n=p
lulita	lul	pos=va,comp=y,f=part
SiKarAH	SiKara	pos=n,g=m,c=1,n=p
pAda	pAda	pos=n,comp=y
naKarAH	naKara	pos=n,g=m,c=1,n=p
kzaRam	kzaRa	pos=n,g=m,c=2,n=s
yAn	yad	pos=n,g=m,c=2,n=p
Alokya	Alokay	pos=vi
prakawa	prakawa	pos=a,comp=y
paramAnanda	paramAnanda	pos=n,comp=y
virasaH	virasa	pos=a,g=m,c=1,n=s
sa	tad	pos=n,g=m,c=1,n=s
devarziH	devarzi	pos=n,g=m,c=1,n=s
muktAn	muc	pos=va,g=m,c=2,n=p,f=part
api	api	pos=i
tanuBftaH	tanuBft	pos=n,g=m,c=2,n=p
Socati	Suc	pos=v,p=3,n=s,l=lat
BfSam	BfSam	pos=i

# id = HamDu.55
sarojAnAm	saroja	pos=n,g=n,c=6,n=p
vyUhaH	vyUha	pos=n,g=m,c=1,n=s
Sriyam	SrI	pos=n,g=f,c=2,n=s
aBilazan	aBilaz	pos=va,g=m,c=1,n=s,f=part
yasya	yad	pos=n,g=m,c=6,n=s
padayoH	pada	pos=n,g=n,c=7,n=d
yayO	yA	pos=v,p=3,n=s,l=lit
rAgAQyAnAm	rAgAQyA	pos=n,g=f,c=6,n=p
viDuram	viDura	pos=a,g=n,c=2,n=s
uda	uda	pos=n,comp=y
vAsa	vAsa	pos=n,comp=y
vrata	vrata	pos=n,comp=y
viDim	viDi	pos=n,g=m,c=2,n=s
himam	hima	pos=n,g=m,c=2,n=s
vande	vand	pos=v,p=1,n=s,l=lat
nIcEH	nIca	pos=a,g=m,c=3,n=p
anucita	anucita	pos=a,comp=y
viDAna	viDAna	pos=n,comp=y
vyasaninAm	vyasanin	pos=a,g=m,c=6,n=p
yat	yat	pos=i
ezAm	idam	pos=n,g=m,c=6,n=p
prARAntam	prARAnta	pos=n,g=m,c=2,n=s
damanam	damana	pos=n,g=n,c=2,n=s
anu	anu	pos=i
varzam	varza	pos=n,g=m,c=2,n=s
praRayati	praRI	pos=v,p=3,n=s,l=lat

# id = HamDu.56
rucInAm	ruci	pos=n,g=f,c=6,n=p
ullAsEH	ullAsa	pos=n,g=m,c=3,n=p
marakata	marakata	pos=n,comp=y
maya	maya	pos=a,comp=y
sTUla	sTUla	pos=a,comp=y
kadalI	kadalI	pos=n,g=f,c=1,n=s
kadamba	kadamba	pos=n,comp=y
ahaMkAram	ahaMkAra	pos=n,g=m,c=2,n=s
kavalayati	kavalay	pos=v,p=3,n=s,l=lat
yasya	yad	pos=n,g=m,c=6,n=s
UrU	Uru	pos=n,comp=y
yugalam	yugala	pos=n,g=n,c=2,n=s
yad	yad	pos=n,comp=y
AlAna	AlAna	pos=n,comp=y
stamBa	stamBa	pos=n,comp=y
dyutim	dyuti	pos=n,g=m,c=2,n=s
avalalambe	avalamb	pos=v,p=3,n=s,l=lit
madAt	mada	pos=n,g=m,c=5,n=s
uddAmAnAm	uddAma	pos=a,g=m,c=6,n=p
paSupa	paSupa	pos=n,comp=y
ramaRI	ramaRI	pos=n,comp=y
citta	citta	pos=n,comp=y
karin	karin	pos=a,g=m,c=6,n=p

# id = HamDu.57
saKe	saKi	pos=n,g=,c=8,n=s
yasya	yad	pos=n,g=m,c=6,n=s
ABIrI	ABIrI	pos=n,comp=y
nayana	nayana	pos=n,comp=y
SaParI	SaParI	pos=n,comp=y
jIvana	jIvana	pos=n,comp=y
viDO	viDi	pos=n,g=m,c=7,n=s
nidAnam	nidAna	pos=n,g=n,c=2,n=s
gAmBIrya	gAmBIrya	pos=n,comp=y
prasara	prasara	pos=n,comp=y
kalitA	kalay	pos=va,g=f,c=1,n=s,f=part
nABi	nABi	pos=n,comp=y
sarasI	sarasI	pos=n,g=f,c=1,n=s
yataH	yatas	pos=i
kalpasya	kalpa	pos=n,g=m,c=6,n=s
AdO	Adi	pos=n,g=m,c=7,n=s
sanaka	sanaka	pos=n,comp=y
janaka	janaka	pos=n,comp=y
utpatti	utpatti	pos=n,comp=y
vaqaBI	vaqaBi	pos=n,g=f,c=1,n=d
gaBIra	gaBIra	pos=a,comp=y
antaH	antar	pos=i
kakza	kakza	pos=n,comp=y
ADf	ADf	pos=va,comp=y,f=part
Buvanam	Buvana	pos=n,g=n,c=1,n=s
amBoruham	amBoruha	pos=n,g=n,c=1,n=s
aBUt	BU	pos=v,p=3,n=s,l=lun

# id = HamDu.58
dyutim	dyuti	pos=n,g=f,c=2,n=s
Datte	DA	pos=v,p=3,n=s,l=lat
yasya	yad	pos=n,g=m,c=6,n=s
trivali	trivali	pos=n,comp=y
latikA	latikA	pos=n,g=f,c=1,n=s
saMkawataram	saMkawatara	pos=a,g=n,c=1,n=s
saKe	saKi	pos=n,g=,c=8,n=s
dAma	dAman	pos=n,comp=y
SreRI	SreRI	pos=n,comp=y
kzaRa	kzaRa	pos=n,comp=y
paricaya	paricaya	pos=n,comp=y
aBijYam	aBijYA	pos=n,g=n,c=1,n=s
udaram	udara	pos=n,g=n,c=1,n=s
yaSodA	yaSodA	pos=n,g=f,c=1,n=s
yasya	yad	pos=n,g=m,c=6,n=s
antaH	antar	pos=i
sura	sura	pos=n,comp=y
nara	nara	pos=n,comp=y
BujaMgEH	BujaMga	pos=n,g=m,c=3,n=p
parivftam	parivf	pos=va,g=n,c=1,n=s,f=part
muKadvArAvAradvayam	triBuvana	pos=n,g=n,c=1,n=s

# id = HamDu.59
uro	uras	pos=n,g=n,c=1,n=s
yasya	yad	pos=n,g=m,c=6,n=s
sPAram	sPAra	pos=a,g=n,c=1,n=s
sPurati	sPur	pos=v,p=3,n=s,l=lat
vana	vana	pos=n,comp=y
mAlA	mAlA	pos=n,comp=y
valayitam	valayita	pos=a,g=n,c=1,n=s
vitanvAnam	vitan	pos=va,g=n,c=1,n=s,f=part
tanvI	tanvI	pos=n,comp=y
jana	jana	pos=n,comp=y
manasi	manas	pos=n,g=n,c=7,n=s
sadyo	sadyas	pos=i
manasijam	manasija	pos=n,g=m,c=2,n=s
yasmin	yad	pos=n,g=m,c=7,n=s
ravi	ravi	pos=n,comp=y
nivaha	nivaha	pos=n,comp=y
tulyaH	tulya	pos=a,g=m,c=1,n=s
api	api	pos=i
vahate	vah	pos=v,p=3,n=s,l=lat
sadA	sadA	pos=i
Kadyota	Kadyota	pos=n,comp=y
ABAm	ABA	pos=n,g=f,c=2,n=s
Buvana	Buvana	pos=n,comp=y
maDuraH	maDura	pos=a,g=m,c=1,n=s
kOstuBa	kOstuBa	pos=n,comp=y
maRiH	maRi	pos=n,g=m,c=1,n=s

# id = HamDu.60
samantAd	samantAt	pos=i
unmIl	unmIl	pos=va,comp=y,f=part
vala	vala	pos=n,comp=y
Bid	Bid	pos=a,comp=y
upala	upala	pos=n,comp=y
stamBa	stamBa	pos=n,comp=y
yugala	yugala	pos=n,comp=y
praBA	praBA	pos=n,comp=y
jEtram	jEtra	pos=n,g=n,c=1,n=s
keSi	keSin	pos=n,comp=y
dvija	dvija	pos=n,comp=y
lulita	lul	pos=va,comp=y,f=part
keyUra	keyUra	pos=n,comp=y
lalitam	lalita	pos=a,g=n,c=1,n=s
Buja	Buja	pos=n,comp=y
dvandvam	dvaMdva	pos=n,g=n,c=1,n=s
yasya	yad	pos=n,g=m,c=6,n=s
sPuwa	sPuwa	pos=a,comp=y
suraBi	suraBi	pos=a,comp=y
ganDam	ganDa	pos=n,g=n,c=1,n=s
vijayate	viji	pos=v,p=3,n=s,l=lat

# id = HamDu.61
jihIte	hA	pos=v,p=3,n=s,l=lat
sAmrAjyam	sAmrAjya	pos=n,g=n,c=2,n=s
jagati	jagant	pos=n,g=n,c=7,n=s
nava	navan	pos=n,comp=y
lAvaRya	lAvaRya	pos=n,comp=y
lahariH	lahari	pos=n,g=f,c=1,n=s
parIpAkasya	parIpAka	pos=n,g=m,c=6,n=s
antaH	antar	pos=i
mudita	mud	pos=va,comp=y,f=part
madanA	madanA	pos=n,comp=y
veSa	veSa	pos=n,comp=y
maDuram	maDura	pos=a,g=n,c=2,n=s
naw	naw	pos=va,comp=y,f=part
BrU	BrU	pos=n,comp=y
vallIkam	vallIka	pos=n,g=n,c=1,n=s
smita	smita	pos=n,comp=y
nava	nava	pos=a,comp=y
suDA	suDA	pos=n,comp=y
keli	keli	pos=n,comp=y
sadanam	sadana	pos=n,g=n,c=1,n=s
sPurat	sPur	pos=va,comp=y,f=part
muktA	muktA	pos=n,comp=y
paNkti	paNkti	pos=n,comp=y
pratima	pratima	pos=a,comp=y
radanam	radana	pos=n,g=n,c=1,n=s
yasya	yad	pos=n,g=m,c=6,n=s
vadanam	vadana	pos=n,g=n,c=1,n=s

# id = HamDu.62
kim	ka	pos=n,g=n,c=1,n=s
eBiH	idam	pos=n,g=m,c=3,n=p
vyAhArEH	vyAhAra	pos=n,g=m,c=3,n=p
kalaya	kalay	pos=v,p=2,n=s,l=lot
kaTayAmi	kaTay	pos=v,p=1,n=s,l=lat
sPuwam	sPuwa	pos=a,g=n,c=2,n=s
aham	mad	pos=n,g=,c=1,n=s
saKe	saKi	pos=n,g=,c=8,n=s
niHsaMdeham	niHsaMdeha	pos=a,g=n,c=2,n=s
paricaya	paricaya	pos=n,comp=y
padam	pada	pos=n,g=n,c=2,n=s
kevalam	kevala	pos=a,g=n,c=2,n=s
idam	idam	pos=n,g=n,c=2,n=s
parAnando	parAnanda	pos=n,g=m,c=1,n=s
yasmin	yad	pos=n,g=m,c=7,n=s
nayana	nayana	pos=n,comp=y
padavI	padavI	pos=n,comp=y
BAji	BAj	pos=a,g=m,c=7,n=s
BavitA	BU	pos=v,p=3,n=s,l=lrt
tvayA	tvad	pos=n,g=,c=3,n=s
vijYAtavyo	vijYA	pos=va,g=m,c=1,n=s,f=krtya
maDura	maDura	pos=a,comp=y
ravEH	rava	pos=n,g=m,c=8,n=s
saH	tad	pos=n,g=m,c=1,n=s
ayam	idam	pos=n,g=m,c=1,n=s
maDuripuH	maDuripu	pos=n,g=m,c=1,n=s

# id = HamDu.63
kfzRam	kfzRa	pos=n,g=m,c=2,n=s
madakalamarAlIratikalA	yadi	pos=i
puravaDU	puravaDU	pos=n,comp=y
viBrama	viBrama	pos=n,comp=y
BarEH	Bara	pos=n,g=m,c=3,n=p
tadA	tadA	pos=i
na	na	pos=i
asmAn	mad	pos=n,g=m,c=2,n=p
grAmyAH	grAmya	pos=a,g=f,c=2,n=p
SravaRa	SravaRa	pos=n,comp=y
padavIm	padavI	pos=n,g=f,c=2,n=s
tasya	tad	pos=n,g=m,c=6,n=s
gamayeH	gamay	pos=v,p=2,n=s,l=vidhilin
suDA	suDA	pos=n,comp=y
pUrRam	pUrRa	pos=a,g=n,c=1,n=s
cetaH	cetas	pos=n,g=n,c=1,n=s
kaTam	kaTam	pos=i
api	api	pos=i
na	na	pos=i
takram	takra	pos=n,g=n,c=2,n=s
mfgayate	mfgay	pos=v,p=3,n=s,l=lat

# id = HamDu.64
yadA	yadA	pos=i
vfndAraRya	vfndAraRya	pos=n,comp=y
smaraRa	smaraRa	pos=n,comp=y
laharI	lahari	pos=n,comp=y
hetuH	hetu	pos=n,g=m,c=1,n=s
amalam	amala	pos=a,g=n,c=2,n=s
pikAnAm	pika	pos=n,g=m,c=6,n=p
vevezwi	uccEs	pos=i
kuhu	kuhu	pos=i
rutam	ruta	pos=n,g=n,c=1,n=s
vahante	vah	pos=v,p=3,n=p,l=lat
vA	vA	pos=i
vAtAH	vAta	pos=n,g=m,c=1,n=p
sPurita	sPur	pos=va,comp=y,f=part
giri	giri	pos=n,comp=y
malli	malli	pos=n,comp=y
parimalAH	parimala	pos=n,g=m,c=1,n=p
tadA	tadA	pos=i
eva	eva	pos=i
AsmAkInAm	AsmAkIna	pos=a,g=f,c=2,n=s
giram	gir	pos=n,g=f,c=2,n=s
upahareTA	upahf	pos=v,p=2,n=s,l=vidhilin
muraBidi	muraBid	pos=n,g=m,c=7,n=s

# id = HamDu.65
purA	purA	pos=i
tizWan	sTA	pos=va,g=m,c=1,n=s,f=part
gozWe	gozWa	pos=n,g=m,c=7,n=s
niKila	niKila	pos=a,comp=y
ramaRI	ramaRI	pos=n,g=f,c=4,n=p
priya	priya	pos=a,comp=y
tayA	tA	pos=n,g=f,c=3,n=s
BavAn	Bavat	pos=a,g=m,c=1,n=s
yasyAm	yad	pos=n,g=f,c=7,n=s
gopI	gopI	pos=n,comp=y
ramaREH	ramaRa	pos=n,g=m,c=8,n=s
vidaDe	viDA	pos=v,p=3,n=s,l=lit
gOrava	gOrava	pos=n,comp=y
Baram	Bara	pos=n,g=m,c=2,n=s
saKI	saKI	pos=n,g=f,c=1,n=s
tasyA	tad	pos=n,g=f,c=6,n=s
vijYApayati	vijYApay	pos=v,p=3,n=s,l=lat
lalitA	lalitA	pos=n,g=f,c=1,n=s
DIra	DIra	pos=a,comp=y
lalitEH	lalita	pos=a,g=m,c=8,n=s
praRamya	praRam	pos=vi
SrI	SrI	pos=n,comp=y
pAda	pAda	pos=n,comp=y
ambuja	ambuja	pos=n,comp=y
kanaka	kanaka	pos=n,comp=y
pIWI	pIWI	pos=n,comp=y
parisare	parisara	pos=n,g=m,c=7,n=s

# id = HamDu.66
nava	navan	pos=n,comp=y
kamalinI	kamalinI	pos=n,comp=y
pallava	pallava	pos=n,comp=y
kulEH	kula	pos=n,g=n,c=3,n=p
tvayA	tvad	pos=n,g=,c=3,n=s
BUyo	BUyas	pos=i
yasyAH	yad	pos=n,g=f,c=6,n=s
kftam	kf	pos=va,g=n,c=1,n=s,f=part
ahaha	ahaha	pos=i
saMvarDanam	saMvarDana	pos=n,g=n,c=1,n=s
aBUt	BU	pos=v,p=3,n=s,l=lun
cirAd	cirAt	pos=i
UDoBAraspuraRagarimAkrAntajaGanA	BU	pos=v,p=3,n=s,l=lit
mura	mura	pos=n,comp=y
maTanEH	maTana	pos=a,g=m,c=8,n=s
sA	tad	pos=n,g=f,c=1,n=s
iyam	idam	pos=n,g=f,c=1,n=s
muramaTana	kapilikA	pos=n,g=f,c=1,n=s

# id = HamDu.67
samIpe	samIpa	pos=n,g=n,c=7,n=s
nIpAnAm	nIpa	pos=n,g=m,c=6,n=p
tricatura	tricatura	pos=a,comp=y
dalA	dala	pos=n,g=f,c=1,n=s
hanta	hanta	pos=i
gamitA	gamay	pos=va,g=f,c=1,n=s,f=part
tvayA	tvad	pos=n,g=,c=3,n=s
mAkandasya	mAkanda	pos=n,g=m,c=6,n=s
priya	priya	pos=a,comp=y
sahacarI	sahacarI	pos=n,g=f,c=1,n=s
BAva	BAva	pos=n,comp=y
niyatim	niyati	pos=n,g=f,c=2,n=s
iyam	idam	pos=n,g=f,c=1,n=s
sA	tad	pos=n,g=f,c=1,n=s
vAsantI	vAsantI	pos=n,g=f,c=1,n=s
gal	gal	pos=va,comp=y,f=part
amala	amala	pos=a,comp=y
mADvIka	mADvIka	pos=n,comp=y
pawalAm	pawala	pos=n,g=f,c=2,n=s
izAd	iza	pos=a,g=m,c=5,n=s
agre	agra	pos=n,g=n,c=7,n=s
gopI	gopI	pos=n,comp=y
ramaREH	ramaRa	pos=a,g=m,c=8,n=s
rudatI	rud	pos=va,g=f,c=1,n=s,f=part
rodayati	roday	pos=v,p=3,n=s,l=lat
naH	mad	pos=n,g=,c=2,n=p

# id = HamDu.68
prasUto	prasU	pos=va,g=m,c=1,n=s,f=part
devakyA	devakI	pos=n,g=f,c=3,n=s
mura	mura	pos=n,comp=y
maTanEH	maTana	pos=a,g=m,c=8,n=s
yaH	yad	pos=n,g=m,c=1,n=s
kaH	ka	pos=n,g=m,c=1,n=s
api	api	pos=i
puruzaH	puruza	pos=n,g=m,c=1,n=s
sa	tad	pos=n,g=m,c=1,n=s
jAto	jan	pos=va,g=m,c=1,n=s,f=part
gopAla	gopAla	pos=n,comp=y
aByudaya	aByudaya	pos=n,comp=y
paramAnanda	paramAnanda	pos=n,comp=y
vasati	vasati	pos=n,g=m,c=1,n=s
Dfto	Df	pos=va,g=m,c=1,n=s,f=part
yo	yad	pos=n,g=m,c=1,n=s
gAnDinyA	gAnDinI	pos=n,g=f,c=3,n=s
kaWina	kaWina	pos=a,comp=y
jaWare	jaWara	pos=n,g=n,c=7,n=s
samprati	samprati	pos=i
tataH	tatas	pos=i
samantAd	samantAt	pos=i
eva	eva	pos=i
astam	asta	pos=n,g=m,c=2,n=s
Siva	Siva	pos=n,g=m,c=8,n=s
Siva	Siva	pos=n,g=m,c=8,n=s
gatA	gam	pos=va,g=f,c=1,n=s,f=part
gokula	gokula	pos=n,comp=y
kaTA	kaTA	pos=n,g=f,c=1,n=s

# id = HamDu.69
arizwena	arizwa	pos=n,g=m,c=3,n=s
AhUtAH	AhvA	pos=va,g=m,c=1,n=p,f=part
paSupa	paSupa	pos=n,comp=y
sudfSaH	sudfS	pos=a,g=m,c=1,n=p
yAnti	yA	pos=v,p=3,n=p,l=lat
vipadam	vipad	pos=n,g=f,c=2,n=s
tfnAvartAkrAntyA	racay	pos=v,p=3,n=s,l=lat
racayati	Baya	pos=n,g=n,c=2,n=s
catvara	catvara	pos=n,comp=y
cayaH	caya	pos=n,g=m,c=1,n=s
amI	adas	pos=n,g=m,c=1,n=p
vyomIBUtA	vyomIBU	pos=va,g=m,c=1,n=p,f=part
vraja	vraja	pos=n,comp=y
vasati	vasati	pos=n,comp=y
BUmi	BUmi	pos=n,comp=y
parisarAH	parisara	pos=n,g=m,c=1,n=p
vahante	vah	pos=v,p=3,n=p,l=lat
naH	mad	pos=n,g=,c=6,n=p
tApam	tApa	pos=n,g=m,c=2,n=s
mura	mura	pos=n,comp=y
harEH	hara	pos=a,g=m,c=8,n=s
vidUram	vidUra	pos=a,g=n,c=2,n=s
tvayi	tvad	pos=n,g=,c=7,n=s
gate	gam	pos=va,g=m,c=7,n=s,f=part

# id = HamDu.70
tvayA	tvad	pos=n,g=,c=3,n=s
na	na	pos=i
Agantavyam	Agam	pos=va,g=n,c=1,n=s,f=krtya
kaTam	kaTam	pos=i
iha	iha	pos=i
hare	hari	pos=n,g=m,c=8,n=s
gozWam	gozWa	pos=n,g=n,c=1,n=s
aDunA	aDunA	pos=i
latA	latA	pos=n,comp=y
SreRI	SreRI	pos=n,g=f,c=1,n=s
vfndAvana	vfndAvana	pos=n,comp=y
Buvi	BU	pos=n,g=f,c=7,n=s
yatas	yatas	pos=i
aBUt	BU	pos=v,p=3,n=s,l=lun
viza	viza	pos=n,comp=y
mayI	maya	pos=a,g=f,c=1,n=s
prasUnAnAm	prasUna	pos=n,g=n,c=6,n=p
ganDam	ganDa	pos=n,g=m,c=2,n=s
kaTam	kaTam	pos=i
itaraTA	itaraTA	pos=i
vAta	vAta	pos=n,comp=y
nihitam	niDA	pos=va,g=m,c=2,n=s,f=part
Bajan	Baj	pos=va,g=m,c=1,n=s,f=part
sadyas	sadyas	pos=i
mUrcCAm	mUrCA	pos=n,g=f,c=2,n=s
vahati	vah	pos=v,p=3,n=s,l=lat
nivaho	nivaha	pos=n,g=m,c=1,n=s
gopa	gopa	pos=n,comp=y
sudfH	sudfS	pos=a,g=m,c=6,n=p

# id = HamDu.71
kaTam	kaTam	pos=i
saNgo	saNga	pos=n,g=m,c=1,n=s
'smABiH	mad	pos=n,g=,c=3,n=p
saha	saha	pos=i
samucitaH	samucita	pos=a,g=m,c=1,n=s
samprati	samprati	pos=i
hare	hari	pos=n,g=m,c=8,n=s
vayam	mad	pos=n,g=,c=1,n=p
grAmyA	grAmya	pos=a,g=f,c=1,n=p
nAryaH	nArI	pos=n,g=f,c=1,n=p
tvam	tvad	pos=n,g=,c=1,n=s
asi	as	pos=v,p=2,n=s,l=lat
nfpa	nfpa	pos=n,comp=y
kanyA	kanyA	pos=n,comp=y
arc	arc	pos=va,comp=y,f=part
padaH	pada	pos=n,g=m,c=1,n=s
gataH	gam	pos=va,g=m,c=1,n=s,f=part
kAlo	kAla	pos=n,g=m,c=1,n=s
yasmin	yad	pos=n,g=m,c=7,n=s
paSupa	paSupa	pos=n,comp=y
ramaRI	ramaRI	pos=n,comp=y
saNgam	saNga	pos=n,g=m,c=2,n=s
akfte	akfta	pos=n,g=n,c=7,n=s
BavAn	Bavat	pos=a,g=m,c=1,n=s
vyagraH	vyagra	pos=a,g=m,c=1,n=s
tasTO	sTA	pos=v,p=3,n=s,l=lit
tamasi	tamas	pos=n,g=n,c=7,n=s

# id = HamDu.72
vayam	mad	pos=n,g=,c=1,n=p
tyaktAH	tyaj	pos=va,g=f,c=1,n=p,f=part
svAmin	svAmin	pos=n,g=m,c=8,n=s
yadi	yadi	pos=i
ha	ha	pos=i
tava	tvad	pos=n,g=,c=6,n=s
kim	ka	pos=n,g=n,c=1,n=s
dUzaRam	dUzaRa	pos=n,g=n,c=1,n=s
idam	idam	pos=n,g=n,c=1,n=s
nisargaH	nisarga	pos=n,g=m,c=1,n=s
SyAmAnAm	SyAmA	pos=n,g=f,c=6,n=p
ayam	idam	pos=n,g=m,c=1,n=s
atitarAm	atitarAm	pos=i
duzpariharaH	duzparihara	pos=a,g=m,c=1,n=s
kuhUkaRWEH	kuhUkaRWa	pos=n,g=m,c=3,n=p
aRqa	aRqa	pos=n,comp=y
avaDi	avaDi	pos=n,comp=y
saha	saha	pos=i
nivAsAt	nivAsa	pos=n,g=m,c=5,n=s
paricitA	parici	pos=va,g=m,c=1,n=p,f=part
visfjyante	visfj	pos=v,p=3,n=p,l=lat
sadyaH	sadyas	pos=i
kalita	kalay	pos=va,comp=y,f=part
nava	nava	pos=a,comp=y
pakzEH	pakza	pos=n,g=m,c=3,n=p
baliBujaH	baliBuj	pos=n,g=m,c=1,n=p

# id = HamDu.73
ayam	idam	pos=n,g=m,c=1,n=s
pUrvo	pUrva	pos=n,g=m,c=1,n=s
raNgaH	raNga	pos=n,g=m,c=1,n=s
kila	kila	pos=i
viracito	viracay	pos=va,g=m,c=1,n=s,f=part
yasya	yad	pos=n,g=m,c=6,n=s
tarasA	taras	pos=n,g=n,c=3,n=s
rasataH	rasa	pos=n,g=m,c=5,n=s
AKyAtavyam	AKyA	pos=va,g=n,c=1,n=s,f=krtya
parikalaya	parikalay	pos=v,p=2,n=s,l=lot
tat	tad	pos=n,g=n,c=2,n=s
nAwakam	nAwaka	pos=n,g=n,c=2,n=s
idam	idam	pos=n,g=n,c=2,n=s
mayA	mad	pos=n,g=,c=3,n=s
prazwavyo	pracC	pos=va,g=m,c=1,n=s,f=krtya
'si	as	pos=v,p=2,n=s,l=lat
praTamam	praTama	pos=a,g=n,c=2,n=s
iti	iti	pos=i
vfndAvana	vfndAvana	pos=n,comp=y
pate	pati	pos=n,g=m,c=8,n=s
kim	ka	pos=n,g=n,c=1,n=s
rADA	rADA	pos=n,g=f,c=1,n=s
iti	iti	pos=i
rADeti	smf	pos=v,p=2,n=s,l=lat
smarasi	kfpaRa	pos=a,g=n,c=2,n=s
varRa	varRa	pos=n,comp=y
yugalam	yugala	pos=n,g=n,c=2,n=s

# id = HamDu.74
aye	aye	pos=i
kim	ka	pos=n,g=n,c=1,n=s
aDunA	aDunA	pos=i
kimaDunA	parokza	pos=a,g=n,c=1,n=s
parokzam	vac	pos=v,p=3,n=p,l=lrt
pravIRA	pravIRa	pos=a,g=f,c=1,n=s
gopInAm	gopI	pos=n,g=f,c=6,n=p
tava	tvad	pos=n,g=,c=6,n=s
caraRa	caraRa	pos=n,comp=y
padme	padma	pos=n,g=n,c=7,n=s
arpita	arpay	pos=va,comp=y,f=part
manAH	manas	pos=n,g=f,c=1,n=s
yayO	yA	pos=v,p=3,n=s,l=lit
rADA	rADA	pos=n,g=f,c=1,n=s
sADAraRa	sADAraRa	pos=a,comp=y
samucita	samucita	pos=a,comp=y
praSna	praSna	pos=n,comp=y
padavIm	padavI	pos=n,g=f,c=2,n=s

# id = HamDu.75
tvayA	tvad	pos=n,g=,c=3,n=s
gozWam	gozWa	pos=n,g=n,c=1,n=s
gozWI	gozWI	pos=n,comp=y
tilakEH	tilaka	pos=n,g=m,c=8,n=s
kila	kila	pos=i
ced	ced	pos=i
vismftam	vismf	pos=va,g=n,c=1,n=s,f=part
idam	idam	pos=n,g=n,c=1,n=s
na	na	pos=i
tUrRam	tUrRam	pos=i
DUmorRA	DUmorRA	pos=n,comp=y
patiH	pati	pos=n,g=m,c=1,n=s
api	api	pos=i
viDatte	viDA	pos=v,p=3,n=s,l=lat
yadi	yadi	pos=i
kfpAm	kfpA	pos=n,g=f,c=2,n=s
ahaH	ahar	pos=n,g=n,c=2,n=s
vfndam	vfnda	pos=n,g=n,c=2,n=s
vfndAvana	vfndAvana	pos=n,comp=y
kusuma	kusuma	pos=n,comp=y
pAlI	pAlI	pos=n,comp=y
parimalEH	parimala	pos=n,g=m,c=3,n=p
durAlokam	durAloka	pos=a,g=n,c=2,n=s
Soka	Soka	pos=n,comp=y
Aspadam	Aspada	pos=n,g=n,c=2,n=s
aTa	aTa	pos=i
kaTam	kaTam	pos=i
na	na	pos=i
izyati	iz	pos=v,p=3,n=s,l=lat
saKI	saKI	pos=n,g=f,c=1,n=s

# id = HamDu.76
taraMgEH	taraMga	pos=n,g=m,c=3,n=p
kurvARA	kf	pos=va,g=f,c=1,n=s,f=part
Samana	Samana	pos=a,comp=y
BaginI	BaginI	pos=n,comp=y
lAGavam	lAGava	pos=n,g=n,c=2,n=s
asO	adas	pos=n,g=f,c=1,n=s
nadIm	nadI	pos=n,g=f,c=2,n=s
kAMcid	kaScit	pos=n,g=f,c=2,n=s
gozWe	gozWa	pos=n,g=m,c=7,n=s
nayana	nayana	pos=n,comp=y
jalapUrEH	jalapUra	pos=n,g=m,c=3,n=p
ajanayat	janay	pos=v,p=3,n=s,l=lan
iti	iti	pos=i
vA	vA	pos=i
asya	idam	pos=n,g=m,c=6,n=s
a	a	pos=i
dvezAt	dveza	pos=n,g=m,c=5,n=s
aBimata	aBiman	pos=va,comp=y,f=part
daSA	daSA	pos=n,comp=y
prArTana	prArTana	pos=n,comp=y
mayIm	maya	pos=a,g=f,c=2,n=s
murAre	murAri	pos=n,g=m,c=8,n=s
vijYaptim	vijYapti	pos=n,g=f,c=2,n=s
niSamayati	niSamay	pos=v,p=3,n=s,l=lat
mAnI	mAnin	pos=a,g=m,c=1,n=s
na	na	pos=i
SamanaH	Samana	pos=a,g=m,c=1,n=s

# id = HamDu.77
kfta	kf	pos=va,comp=y,f=part
Akfzwi	Akfzwi	pos=n,comp=y
krIqAm	krIqA	pos=n,g=f,c=2,n=s
kim	ka	pos=n,g=n,c=1,n=s
api	api	pos=i
tava	tvad	pos=n,g=,c=6,n=s
rUpam	rUpa	pos=n,g=n,c=1,n=s
mama	mad	pos=n,g=,c=6,n=s
saKI	saKI	pos=n,g=f,c=1,n=s
sakfd	sakft	pos=i
dfzwa	dfS	pos=va,comp=y,f=part
adUrAt	adUra	pos=a,g=n,c=5,n=s
ahita	ahita	pos=a,comp=y
hita	DA	pos=va,comp=y,f=part
boDa	boDa	pos=n,comp=y
ujJita	ujJita	pos=a,comp=y
matiH	mati	pos=n,g=f,c=1,n=s
hatA	han	pos=va,g=f,c=1,n=s,f=part
sA	tad	pos=n,g=f,c=1,n=s
iyam	idam	pos=n,g=f,c=1,n=s
prema	preman	pos=n,comp=y
analam	anala	pos=n,g=m,c=2,n=s
anuviSantI	anuviS	pos=va,g=f,c=1,n=s,f=part
saraBasam	saraBasa	pos=a,g=n,c=2,n=s
pataMgI	pataMgin	pos=n,g=m,c=1,n=s
iva	iva	pos=i
AtmAnam	Atman	pos=n,g=m,c=2,n=s
mura	mura	pos=n,comp=y
harEH	hara	pos=a,g=m,c=8,n=s
muhuH	muhur	pos=i
dAhitavatI	dAhay	pos=va,g=f,c=1,n=s,f=part

# id = HamDu.78
mayA	mad	pos=n,g=,c=3,n=s
vAcyaH	vac	pos=va,g=m,c=1,n=s,f=krtya
kim	ka	pos=n,g=n,c=1,n=s
vA	vA	pos=i
tvam	tvad	pos=n,g=,c=1,n=s
iha	iha	pos=i
nija	nija	pos=a,comp=y
dozataH	doza	pos=n,g=m,c=5,n=s
param	para	pos=n,g=n,c=2,n=s
asO	adas	pos=n,g=f,c=1,n=s
yayO	yA	pos=v,p=3,n=s,l=lit
mandA	manda	pos=a,g=f,c=1,n=s
vfndAvana	vfndAvana	pos=n,comp=y
kumudabanDo	kumudabanDu	pos=n,g=m,c=8,n=s
viDuratAm	viDuratA	pos=n,g=f,c=2,n=s
yadarTam	yadarTa	pos=a,g=m,c=2,n=s
duHKa	duHKa	pos=n,comp=y
agniH	agni	pos=n,g=m,c=1,n=s
dahati	dah	pos=v,p=3,n=s,l=lat
na	na	pos=i
tam	tad	pos=n,g=m,c=2,n=s
adya	adya	pos=i
api	api	pos=i
hfdayAn	hfdaya	pos=n,g=n,c=5,n=s
na	na	pos=i
yasmAt	yad	pos=n,g=n,c=5,n=s
durmeDA	durmeDa	pos=a,g=f,c=1,n=s
lavam	lava	pos=n,g=m,c=2,n=s
api	api	pos=i
Bavantam	Bavat	pos=a,g=m,c=2,n=s
davayati	davay	pos=v,p=3,n=s,l=lat

# id = HamDu.79
trivakrA	trivakrA	pos=n,g=f,c=1,n=s
aho	aho	pos=i
DanyA	Danya	pos=a,g=f,c=1,n=s
hfdayam	hfdaya	pos=n,g=n,c=1,n=s
iva	iva	pos=i
te	tvad	pos=n,g=,c=6,n=s
svam	sva	pos=a,g=n,c=1,n=s
vapuH	vapus	pos=n,g=n,c=1,n=s
iyam	idam	pos=n,g=f,c=1,n=s
samAsAdya	samAsAday	pos=vi
svEram	svEra	pos=a,g=m,c=2,n=s
yat	yat	pos=i
iha	iha	pos=i
vilasantI	vilas	pos=va,g=f,c=1,n=s,f=part
nivasati	nivas	pos=v,p=3,n=s,l=lat
Druvam	Druvam	pos=i
puRya	puRya	pos=n,comp=y
BraMSAt	BraMSa	pos=n,g=m,c=5,n=s
ajani	jan	pos=v,p=3,n=s,l=lun
saralA	sarala	pos=a,g=f,c=1,n=s
iyam	idam	pos=n,g=f,c=1,n=s
mama	mad	pos=n,g=,c=6,n=s
saKI	saKI	pos=n,g=f,c=1,n=s
praveSaH	praveSa	pos=n,g=m,c=1,n=s
tatra	tatra	pos=i
AsIt	as	pos=v,p=3,n=s,l=lan
kzaRam	kzaRa	pos=n,g=m,c=2,n=s
api	api	pos=i
yat	yat	pos=i
asyAH	idam	pos=n,g=f,c=6,n=s
na	na	pos=i
sulaBaH	sulaBa	pos=a,g=m,c=1,n=s

# id = HamDu.80
kim	ka	pos=n,g=n,c=1,n=s
AvizwA	AviS	pos=va,g=f,c=1,n=s,f=part
BUtEH	BUta	pos=n,g=n,c=3,n=p
sapadi	sapadi	pos=i
yadi	yadi	pos=i
vA	vA	pos=i
akrUra	akrUra	pos=n,comp=y
PaRinA	PaRin	pos=n,g=m,c=3,n=s
kzata	kzan	pos=va,comp=y,f=part
apasmArena	apasmAra	pos=n,g=m,c=3,n=s
cyuta	cyu	pos=va,comp=y,f=part
matiH	mati	pos=n,g=f,c=1,n=s
akasmAt	akasmAt	pos=i
kim	ka	pos=n,g=n,c=2,n=s
apatat	pat	pos=v,p=3,n=s,l=lan
iti	iti	pos=i
vyagrEH	vyagra	pos=a,g=m,c=3,n=p
asyAm	idam	pos=n,g=f,c=7,n=s
guruBiH	guru	pos=n,g=m,c=3,n=p
aBito	aBitas	pos=i
veRu	veRu	pos=n,comp=y
ninada	ninada	pos=n,comp=y
SravAt	Srava	pos=n,g=m,c=5,n=s
viBrazwAyAm	viBraMS	pos=va,g=f,c=7,n=s,f=part
mura	mura	pos=n,comp=y
harEH	hara	pos=a,g=m,c=8,n=s
vikalpA	vikalpa	pos=n,g=m,c=1,n=p
vidaDire	viDA	pos=v,p=3,n=p,l=lit

# id = HamDu.81
navInA	navIna	pos=a,g=f,c=1,n=s
iyam	idam	pos=n,g=f,c=1,n=s
samprati	samprati	pos=i
akuSala	akuSala	pos=a,comp=y
parIpAka	parIpAka	pos=n,comp=y
lahariH	lahari	pos=n,g=f,c=1,n=s
narInarti	narInart	pos=v,p=3,n=s,l=lat
smaram	mad	pos=n,g=,c=6,n=s
sahacarI	sahacarI	pos=n,comp=y
citta	citta	pos=n,comp=y
kuhare	kuhara	pos=n,g=n,c=7,n=s
jagat	jagant	pos=n,comp=y
netra	netra	pos=n,comp=y
SreRI	SreRI	pos=n,g=f,c=1,n=s
maDura	maDura	pos=a,comp=y
maTurAyAm	maTurA	pos=n,g=f,c=7,n=s
nivasataH	nivas	pos=va,g=m,c=6,n=s,f=part
cirAt	cirAt	pos=i
ArtA	Arta	pos=a,g=f,c=1,n=s
vArtAm	vArttA	pos=n,g=f,c=2,n=s
api	api	pos=i
tava	tvad	pos=n,g=,c=6,n=s
yat	yat	pos=i
ezA	etad	pos=n,g=f,c=1,n=s
na	na	pos=i
laBate	laB	pos=v,p=3,n=s,l=lat

# id = HamDu.82
janAn	jana	pos=n,g=m,c=2,n=p
sidDAdeSAn	sidDAdeSa	pos=n,g=m,c=2,n=p
namati	nam	pos=v,p=3,n=s,l=lat
Bajate	Baj	pos=v,p=3,n=s,l=lat
mAntrika	mAntrika	pos=n,comp=y
gaRAn	gaRa	pos=n,g=m,c=2,n=p
viDatte	viDA	pos=v,p=3,n=s,l=lat
SuSrUzAm	SuSrUzA	pos=n,g=f,c=2,n=s
aDika	aDika	pos=a,comp=y
vinaye	vinaya	pos=n,g=m,c=7,n=s
na	na	pos=i
ozaDi	ozaDi	pos=n,comp=y
vidAm	vid	pos=a,g=m,c=6,n=p
tvad	tvad	pos=n,comp=y
IkzA	IkzA	pos=n,comp=y
dIkzAyE	dIkzA	pos=n,g=f,c=4,n=s
paricarati	paricar	pos=v,p=3,n=s,l=lat
BaktA	Bakta	pos=a,g=f,c=1,n=s
girisutAm	girisutA	pos=n,g=f,c=2,n=s
manIzA	manIzA	pos=n,g=f,c=1,n=s
hi	hi	pos=i
vyagrA	vyagra	pos=a,g=f,c=1,n=s
kim	ka	pos=n,g=n,c=1,n=s
api	api	pos=i
suKa	suKa	pos=n,comp=y
hetum	hetu	pos=n,g=m,c=2,n=s
na	na	pos=i
manute	man	pos=v,p=3,n=s,l=lat

# id = HamDu.83
paSUnAm	paSu	pos=n,g=m,c=6,n=p
pAtAram	pAtf	pos=a,g=m,c=2,n=s
Bujaga	Bujaga	pos=n,comp=y
ripu	ripu	pos=n,comp=y
pattra	pattra	pos=n,comp=y
praRayinam	praRayin	pos=a,g=m,c=2,n=s
nibiqa	nibiqa	pos=a,comp=y
GanasAra	GanasAra	pos=n,comp=y
dyuti	dyuti	pos=n,comp=y
haram	hara	pos=a,g=m,c=2,n=s
sadA	sadA	pos=i
aByarRe	aByarRa	pos=n,g=n,c=7,n=s
nandISvara	nandISvara	pos=n,comp=y
giriBU	giriBU	pos=n,g=f,c=6,n=s
raNga	raNga	pos=n,comp=y
rasikam	rasika	pos=a,g=m,c=2,n=s
Bavantam	Bavat	pos=a,g=m,c=2,n=s
kaMsAre	kaMsAri	pos=n,g=m,c=8,n=s
Bajati	Baj	pos=v,p=3,n=s,l=lat
Bavat	Bavat	pos=a,comp=y
AptyE	Apti	pos=n,g=f,c=4,n=s
mama	mad	pos=n,g=,c=6,n=s
saKI	saKI	pos=n,g=f,c=1,n=s

# id = HamDu.84
Bavantam	Bavat	pos=a,g=m,c=2,n=s
saMtaptA	saMtap	pos=va,g=f,c=1,n=s,f=part
vidal	vidal	pos=va,comp=y,f=part
tamAla	tamAla	pos=n,comp=y
aNkura	aNkura	pos=n,comp=y
rasEH	rasa	pos=n,g=m,c=3,n=p
viliKya	viliK	pos=vi
BU	BU	pos=n,comp=y
BaNgI	BaNgI	pos=n,comp=y
kfta	kf	pos=va,comp=y,f=part
madana	madana	pos=n,comp=y
kodaRqa	kodaRqa	pos=n,comp=y
kadanam	kadana	pos=n,g=m,c=2,n=s
niDAsyantI	niDA	pos=va,g=f,c=1,n=s,f=part
kaRWe	kaRWa	pos=n,g=m,c=7,n=s
tava	tvad	pos=n,g=,c=6,n=s
nija	nija	pos=a,comp=y
BujAH	Buja	pos=n,g=m,c=1,n=p
vallari	vallari	pos=n,g=m,c=2,n=s
asO	adas	pos=n,g=f,c=1,n=s
DaraRyAm	DaraRI	pos=n,g=f,c=7,n=s
unmIl	unmIl	pos=va,comp=y,f=part
jaqiman	jaqiman	pos=n,comp=y
nibiqa	nibiqa	pos=a,comp=y
aNgI	aNga	pos=a,g=f,c=1,n=s
viluWati	viluW	pos=v,p=3,n=s,l=lat

# id = HamDu.85
kadAcid	kadAcid	pos=i
mugDA	muh	pos=va,g=f,c=1,n=s,f=part
iyam	idam	pos=n,g=f,c=1,n=s
nibiqa	nibiqa	pos=a,comp=y
BavadIya	BavadIya	pos=a,comp=y
smfti	smfti	pos=n,comp=y
madAt	mada	pos=n,g=m,c=5,n=s
amandAt	amanda	pos=a,g=m,c=5,n=s
AtmAnam	Atman	pos=n,g=m,c=2,n=s
kalayati	kalay	pos=v,p=3,n=s,l=lat
Bavantam	Bavat	pos=a,g=m,c=2,n=s
mama	mad	pos=n,g=,c=6,n=s
saKI	saKI	pos=n,g=f,c=1,n=s
taTA	taTA	pos=i
asyAH	idam	pos=n,g=f,c=6,n=s
rADAyA	rADA	pos=n,g=f,c=6,n=s
viraha	viraha	pos=n,comp=y
dahana	dahana	pos=n,comp=y
akalpita	akalpita	pos=a,comp=y
DiyAH	DI	pos=n,g=f,c=6,n=s
murAre	murAri	pos=n,g=m,c=8,n=s
duHsADA	duHsADa	pos=a,g=f,c=1,n=s
kzaRam	kzaRa	pos=n,g=m,c=2,n=s
api	api	pos=i
na	na	pos=i
rADA	rADA	pos=n,g=f,c=1,n=s
viramati	viram	pos=v,p=3,n=s,l=lat

# id = HamDu.86
tvayA	tvad	pos=n,g=,c=3,n=s
saMtApAnAm	saMtApa	pos=n,g=m,c=6,n=p
upari	upari	pos=i
parimuktA	parimuc	pos=va,g=f,c=1,n=s,f=part
api	api	pos=i
raBasAd	raBasa	pos=n,g=m,c=5,n=s
idAnIm	idAnIm	pos=i
Apede	Apad	pos=v,p=3,n=s,l=lit
tat	tad	pos=n,g=n,c=2,n=s
api	api	pos=i
tava	tvad	pos=n,g=,c=6,n=s
cezwAm	cezwA	pos=n,g=f,c=2,n=s
priya	priya	pos=a,comp=y
saKI	saKI	pos=n,g=f,c=1,n=s
yat	yat	pos=i
ezA	etad	pos=n,g=f,c=1,n=s
kaMsAre	kaMsAri	pos=n,g=m,c=8,n=s
Bidura	Bidura	pos=a,comp=y
hfdayam	hfdaya	pos=n,g=m,c=2,n=s
tvA	tvad	pos=n,g=,c=2,n=s
ave	ave	pos=va,g=f,c=1,n=s,f=part
satInAm	satI	pos=n,g=f,c=6,n=p
mUrDanyA	mUrDanya	pos=a,g=f,c=1,n=s
Bidura	Bidura	pos=n,comp=y
hfdayA	hfdaya	pos=n,g=f,c=1,n=s
BUt	BU	pos=v,p=3,n=s,l=lun_unaug
anudinam	anudinam	pos=i

# id = HamDu.87
samakzam	samakza	pos=a,g=n,c=2,n=s
sarvezAm	sarva	pos=n,g=m,c=6,n=p
nivasasi	nivas	pos=v,p=2,n=s,l=lat
samADi	samADi	pos=n,comp=y
praRayin	praRayin	pos=a,g=m,c=6,n=p
iti	iti	pos=i
SrutvA	Sru	pos=vi
nUnam	nUnam	pos=i
gurutara	gurutara	pos=a,comp=y
samADim	samADi	pos=n,g=m,c=2,n=s
kalayati	kalay	pos=v,p=3,n=s,l=lat
sadA	sadA	pos=i
kaMsArAte	kaMsArAti	pos=n,g=m,c=8,n=s
Bajasi	Baj	pos=v,p=2,n=s,l=lat
yaminAm	yamin	pos=a,g=m,c=6,n=p
netra	netra	pos=n,comp=y
padavIm	padavI	pos=n,g=f,c=2,n=s
iti	iti	pos=i
vyaktam	vyakta	pos=a,g=n,c=2,n=s
sajjIBavati	sajjIBU	pos=v,p=3,n=s,l=lat
yamam	yama	pos=n,g=m,c=2,n=s
Alambitum	api	pos=i

# id = HamDu.88
murAre	murAri	pos=n,g=m,c=8,n=s
kAlindI	kAlindI	pos=n,comp=y
salila	salila	pos=n,comp=y
calat	cal	pos=va,comp=y,f=part
indIvarEH	indIvara	pos=n,g=m,c=8,n=s
ruce	ruci	pos=a,g=m,c=8,n=s
mukunda	mukunda	pos=n,g=m,c=8,n=s
SrI	SrI	pos=n,comp=y
vfndAvana	vfndAvana	pos=n,comp=y
madana	madana	pos=n,comp=y
vfndAraka	vfndAraka	pos=n,comp=y
maRe	maRi	pos=n,g=m,c=8,n=s
vraja	vraja	pos=n,comp=y
Anandin	Anandin	pos=a,g=m,c=8,n=s
nandISvarEH	nandISvara	pos=n,g=m,c=8,n=s
dayita	dayita	pos=a,g=m,c=8,n=s
nandAtmaja	nandAtmaja	pos=n,g=m,c=8,n=s
hare	hari	pos=n,g=m,c=8,n=s
sadA	sadA	pos=i
iti	iti	pos=i
krandantI	krand	pos=va,g=f,c=1,n=s,f=part
parijana	parijana	pos=n,comp=y
Sucam	Suc	pos=n,g=f,c=2,n=s
kandalayati	kandalay	pos=v,p=3,n=s,l=lat

# id = HamDu.89
samantAd	samantAt	pos=i
uttaptaH	uttapta	pos=a,g=m,c=1,n=s
te	tvad	pos=n,g=,c=6,n=s
viraha	viraha	pos=n,comp=y
dAva	dAva	pos=n,comp=y
agni	agni	pos=n,comp=y
SiKayA	SiKA	pos=n,g=f,c=3,n=s
kfta	kf	pos=va,comp=y,f=part
udvegaH	udvega	pos=n,g=m,c=1,n=s
paYca	paYcan	pos=n,comp=y
ASuga	ASuga	pos=n,comp=y
mfgayu	mfgayu	pos=n,comp=y
veDa	veDa	pos=n,comp=y
vyatikarEH	vyatikara	pos=n,g=m,c=3,n=p
tanUBUtam	tanUBUta	pos=a,g=n,c=1,n=s
sadyas	sadyas	pos=i
tanu	tanu	pos=n,comp=y
vanam	vana	pos=n,g=n,c=1,n=s
idam	idam	pos=n,g=n,c=1,n=s
hAsyati	hA	pos=v,p=3,n=s,l=lrt
hare	hari	pos=n,g=m,c=8,n=s
haWAt	haWa	pos=n,g=m,c=5,n=s
adya	adya	pos=i
Svo	Svas	pos=i
vA	vA	pos=i
mama	mad	pos=n,g=,c=6,n=s
sahacarI	sahacarI	pos=n,g=f,c=1,n=s
prARa	prARa	pos=n,comp=y
hari	hari	pos=n,g=n,c=6,n=s

# id = HamDu.90
payaH	payas	pos=n,comp=y
rASi	rASi	pos=n,comp=y
sPIta	sPIta	pos=a,comp=y
tviH	tviz	pos=n,g=f,c=7,n=s
himakara	himakara	pos=a,comp=y
uttaMsa	uttaMsa	pos=n,comp=y
maDure	maDura	pos=a,g=m,c=7,n=s
daDAne	DA	pos=va,g=m,c=7,n=s,f=part
dfH	dfS	pos=n,comp=y
BaNgyA	BaNgI	pos=n,g=f,c=3,n=s
smara	smara	pos=n,comp=y
vijayin	vijayin	pos=a,comp=y
rUpam	rUpa	pos=n,g=n,c=2,n=s
mama	mad	pos=n,g=,c=6,n=s
saKI	saKI	pos=n,g=f,c=1,n=s
hare	hari	pos=n,g=m,c=8,n=s
datta	dA	pos=va,comp=y,f=part
svAntA	svAnta	pos=n,g=f,c=1,n=s
Bavati	BU	pos=v,p=3,n=s,l=lat
tat	tad	pos=n,g=n,c=2,n=s
imAm	idam	pos=n,g=f,c=2,n=s
kim	ka	pos=n,g=n,c=2,n=s
praBavati	praBU	pos=v,p=3,n=s,l=lat
smaro	smara	pos=n,g=m,c=1,n=s
hantum	han	pos=vi
kim	ka	pos=n,g=n,c=1,n=s
tu	tu	pos=i
BavAn	Bavat	pos=a,g=m,c=1,n=s
eva	eva	pos=i
BavAneva	kutukin	pos=a,g=m,c=1,n=s

# id = HamDu.91
vijAnIze	vijYA	pos=v,p=2,n=s,l=lat
BAvam	BAva	pos=n,g=m,c=2,n=s
paSupa	paSupa	pos=n,comp=y
ramaRI	ramaRI	pos=n,g=f,c=6,n=p
yadupate	yadupati	pos=n,g=m,c=8,n=s
na	na	pos=i
jAnImaH	jYA	pos=v,p=1,n=p,l=lat
kasmAt	ka	pos=n,g=n,c=5,n=s
tat	tad	pos=n,g=n,c=2,n=s
api	api	pos=i
bata	bata	pos=i
mAyAm	mAyA	pos=n,g=f,c=2,n=s
racayasi	racay	pos=v,p=2,n=s,l=lat
samantAt	samantAt	pos=i
aDyAtmam	aDyAtma	pos=a,g=n,c=2,n=s
yat	yad	pos=n,g=n,c=2,n=s
iha	iha	pos=i
pavanavyADi	pavanavyADi	pos=n,g=m,c=1,n=s
alapat	lap	pos=v,p=3,n=s,l=lan
balAd	bala	pos=n,g=n,c=5,n=s
asyAH	idam	pos=n,g=f,c=6,n=s
tena	tad	pos=n,g=m,c=3,n=s
vyasana	vyasana	pos=n,comp=y
kulam	kula	pos=n,g=n,c=1,n=s
eva	eva	pos=i
dvi	dvi	pos=n,comp=y
guRitam	guRay	pos=va,g=n,c=1,n=s,f=part

# id = HamDu.92
guroH	guru	pos=n,g=m,c=6,n=s
antevAsI	antevAsin	pos=n,g=m,c=1,n=s
sa	tad	pos=n,g=m,c=1,n=s
Bajati	Baj	pos=v,p=3,n=s,l=lat
yadUnAm	yadu	pos=n,g=m,c=6,n=p
sacivatAm	sacivatA	pos=n,g=f,c=2,n=s
saKI	saKI	pos=n,g=f,c=1,n=s
kAlindI	kAlindI	pos=n,g=f,c=1,n=s
iyam	idam	pos=n,g=f,c=1,n=s
kila	kila	pos=i
Bavati	BU	pos=v,p=3,n=s,l=lat
kAlasya	kAla	pos=n,g=m,c=6,n=s
BaginI	BaginI	pos=n,g=f,c=1,n=s
Bavet	BU	pos=v,p=3,n=s,l=vidhilin
anyaH	anya	pos=n,g=m,c=1,n=s
ko	ka	pos=n,g=m,c=1,n=s
vA	vA	pos=i
narapati	narapati	pos=n,comp=y
pure	pura	pos=n,g=n,c=7,n=s
mad	mad	pos=n,comp=y
paricitaH	parici	pos=va,g=m,c=1,n=s,f=part
daSAm	daSA	pos=n,g=f,c=2,n=s
asyAH	idam	pos=n,g=f,c=6,n=s
SaMsan	SaMs	pos=va,g=m,c=1,n=s,f=part
yadu	yadu	pos=n,comp=y
tilakEH	tilaka	pos=n,g=m,c=8,n=s
yaH	yad	pos=n,g=m,c=1,n=s
tvA	tvad	pos=n,g=,c=2,n=s
anunayet	anunI	pos=v,p=3,n=s,l=vidhilin

# id = HamDu.93
viSIrRa	viSf	pos=va,comp=y,f=part
aNgIm	aNga	pos=a,g=f,c=2,n=s
antaH	antar	pos=i
vraRa	vraRa	pos=n,comp=y
viluWanAt	viluWana	pos=n,g=n,c=5,n=s
utkalikayA	utkalikA	pos=n,g=f,c=3,n=s
parItAm	parI	pos=va,g=f,c=2,n=s,f=part
BUyasyA	BUyas	pos=a,g=f,c=3,n=s
satatam	satatam	pos=i
aparAga	aparAga	pos=n,comp=y
vyatikarAm	vyatikara	pos=n,g=f,c=2,n=s
pariDvaMs	pariDvaMs	pos=va,comp=y,f=part
AmodAm	Amoda	pos=n,g=f,c=2,n=s
viramay	viramay	pos=va,comp=y,f=part
samasta	samasta	pos=a,comp=y
ali	ali	pos=n,comp=y
kutukAm	kutuka	pos=n,g=f,c=2,n=s
viDo	viDu	pos=n,g=m,c=8,n=s
pAda	pAda	pos=n,comp=y
sparSataH	sparSa	pos=n,g=m,c=5,n=s
api	api	pos=i
suKaya	suKay	pos=v,p=2,n=s,l=lot
rADA	rADA	pos=n,comp=y
kumudinIm	kumudinI	pos=n,g=f,c=2,n=s

# id = HamDu.94
vipattiByaH	vipatti	pos=n,g=f,c=5,n=p
prARAn	prARa	pos=n,g=m,c=2,n=p
kaTam	kaTam	pos=i
api	api	pos=i
Bavat	Bavat	pos=a,comp=y
saNgam	saNga	pos=n,g=m,c=2,n=s
asuKa	asuKa	pos=n,comp=y
spfhA	spfhA	pos=n,comp=y
aDInA	aDIna	pos=a,g=f,c=1,n=s
SOre	SOri	pos=n,g=m,c=8,n=s
mama	mad	pos=n,g=,c=6,n=s
sahacarI	sahacarI	pos=n,g=f,c=1,n=s
rakzitavatI	rakz	pos=va,g=f,c=1,n=s,f=part
atikrAnte	atikram	pos=va,g=m,c=7,n=s,f=part
samprati	samprati	pos=i
avaDi	avaDi	pos=n,comp=y
divase	divasa	pos=n,g=m,c=7,n=s
jIvana	jIvana	pos=n,comp=y
viDO	viDi	pos=n,g=m,c=7,n=s
hatASA	hatASa	pos=a,g=f,c=1,n=s
niHSaNkam	niHSaNka	pos=a,g=m,c=2,n=s
vitarati	vitf	pos=v,p=3,n=s,l=lat
dfSO	dfS	pos=n,g=f,c=2,n=d
cUta	cUta	pos=n,comp=y
mukule	mukula	pos=n,g=m,c=7,n=s

# id = HamDu.95
pratIkAra	pratIkAra	pos=n,comp=y
AramBa	AramBa	pos=n,comp=y
SlaTa	SlaTa	pos=a,comp=y
matiBiH	mati	pos=n,g=f,c=3,n=p
udi	udi	pos=va,comp=y,f=part
pariRateH	pariRati	pos=n,g=f,c=6,n=s
vimuktAyA	vimuc	pos=va,g=f,c=6,n=s,f=part
vyakta	vyakta	pos=a,comp=y
smara	smara	pos=n,comp=y
kadana	kadana	pos=n,comp=y
BAj	BAj	pos=a,g=f,c=6,n=s
parijanEH	parijana	pos=n,g=m,c=3,n=p
amuYcantI	amuYcat	pos=a,g=f,c=1,n=s
saNgam	saNga	pos=n,g=m,c=2,n=s
kuvalaya	kuvalaya	pos=n,comp=y
dfSaH	dfS	pos=n,g=m,c=6,n=s
kevalam	kevala	pos=a,g=n,c=2,n=s
asO	adas	pos=n,g=f,c=1,n=s
balAt	bala	pos=n,g=n,c=5,n=s
adya	adya	pos=i
prARAn	prARa	pos=n,g=m,c=2,n=p
avati	av	pos=v,p=3,n=s,l=lat
Bavat	Bavat	pos=a,comp=y
ASA	ASA	pos=n,g=f,c=1,n=s
sahacarI	sahacarI	pos=n,g=f,c=1,n=s

# id = HamDu.96
aye	aye	pos=i
rAsakrIqA	rAsakrIqA	pos=n,comp=y
rasikEH	rasika	pos=a,g=m,c=8,n=s
mama	mad	pos=n,g=,c=6,n=s
saKyAm	saKI	pos=n,g=f,c=7,n=s
nava	nava	pos=a,comp=y
navA	nava	pos=a,g=f,c=1,n=s
purA	purA	pos=i
badDA	banD	pos=va,g=f,c=1,n=s,f=part
yena	yad	pos=n,g=m,c=3,n=s
praRaya	praRaya	pos=n,comp=y
lahariH	lahari	pos=n,g=f,c=1,n=s
hanta	hanta	pos=i
gahanA	gahana	pos=a,g=f,c=1,n=s
sa	tad	pos=n,g=m,c=1,n=s
ced	ced	pos=i
mukta	muc	pos=va,comp=y,f=part
apekzaH	apekzA	pos=n,g=m,c=1,n=s
tvam	tvad	pos=n,g=,c=1,n=s
asi	as	pos=v,p=2,n=s,l=lat
Dig	Dik	pos=i
imAm	idam	pos=n,g=f,c=2,n=s
tUla	tUla	pos=n,comp=y
Sakalam	Sakala	pos=n,g=n,c=1,n=s
yat	yad	pos=n,g=n,c=1,n=s
etasyAH	etad	pos=n,g=f,c=6,n=s
nAsA	nAsA	pos=n,comp=y
nihitam	niDA	pos=va,g=n,c=1,n=s,f=part
idam	idam	pos=n,g=n,c=1,n=s
adya	adya	pos=i
api	api	pos=i
calati	cal	pos=v,p=3,n=s,l=lat

# id = HamDu.97
mukunda	mukunda	pos=n,g=m,c=8,n=s
BrAnta	Bram	pos=va,comp=y,f=part
akzI	akza	pos=a,g=f,c=1,n=s
kim	ka	pos=n,g=n,c=1,n=s
api	api	pos=i
yad	yat	pos=i
asaMkalpita	asaMkalpita	pos=a,comp=y
Satam	Sata	pos=n,g=n,c=2,n=s
viDatte	viDA	pos=v,p=3,n=s,l=lat
tat	tad	pos=n,g=n,c=2,n=s
vaktum	vac	pos=vi
jagati	jagant	pos=n,g=n,c=7,n=s
manujaH	manuja	pos=n,g=m,c=1,n=s
kaH	ka	pos=n,g=m,c=1,n=s
praBavati	praBU	pos=v,p=3,n=s,l=lat
kadAcid	kadAcid	pos=i
kalyARI	kalyARa	pos=a,g=f,c=1,n=s
vilapati	vilap	pos=v,p=3,n=s,l=lat
yat	yat	pos=i
utkaRW	utkaRW	pos=va,comp=y,f=part
matiH	mati	pos=n,g=f,c=1,n=s
tadA	tadA	pos=i
AKyAmi	AKyA	pos=v,p=1,n=s,l=lat
svAmin	svAmin	pos=n,g=m,c=8,n=s
gamaya	gamay	pos=v,p=2,n=s,l=lot
makara	makara	pos=n,comp=y
uttaMsa	uttaMsa	pos=n,comp=y
padavIm	padavI	pos=n,g=f,c=2,n=s

# id = HamDu.98
aBUt	BU	pos=v,p=3,n=s,l=lun
ko	ka	pos=n,g=m,c=1,n=s
'pi	api	pos=i
premA	preman	pos=n,g=m,c=1,n=s
mayi	mad	pos=n,g=,c=7,n=s
murAri	murAri	pos=n,comp=y
ripoH	ripu	pos=n,g=m,c=6,n=s
yaH	yad	pos=n,g=m,c=1,n=s
saKi	saKI	pos=n,g=f,c=8,n=s
purA	purA	pos=i
parAm	para	pos=n,g=f,c=2,n=s
karma	karman	pos=n,comp=y
apekzAm	apekzA	pos=n,g=f,c=2,n=s
api	api	pos=i
tad	tad	pos=n,comp=y
avalambAt	avalamba	pos=n,g=m,c=5,n=s
na	na	pos=i
gaRayet	gaRay	pos=v,p=3,n=s,l=vidhilin
taTA	taTA	pos=i
idAnIm	idAnIm	pos=i
hA	hA	pos=i
Dik	Dik	pos=i
samajani	saMjan	pos=v,p=3,n=s,l=lun
tawasTaH	tawasTa	pos=a,g=m,c=1,n=s
sPuwam	sPuwa	pos=a,g=n,c=2,n=s
aham	mad	pos=n,g=,c=1,n=s
Baje	Baj	pos=v,p=1,n=s,l=lat
lajjAm	lajjA	pos=n,g=f,c=2,n=s
yena	yena	pos=i
kzaRam	kzaRa	pos=n,g=m,c=2,n=s
api	api	pos=i
punaH	punar	pos=i
jIvitum	jIv	pos=vi

# id = HamDu.99
garIyAn	garIyas	pos=a,g=m,c=1,n=s
me	mad	pos=n,g=,c=6,n=s
premA	preman	pos=n,g=m,c=1,n=s
tvayi	tvad	pos=n,g=,c=7,n=s
param	param	pos=i
iti	iti	pos=i
sneha	sneha	pos=n,comp=y
laGu	laGu	pos=a,comp=y
tA	tA	pos=n,g=f,c=1,n=s
na	na	pos=i
jIvizyAmi	jIv	pos=v,p=1,n=s,l=lrt
iti	iti	pos=i
praRaya	praRaya	pos=n,comp=y
garima	gariman	pos=n,comp=y
KyApana	KyApana	pos=n,comp=y
viDiH	viDi	pos=n,g=m,c=1,n=s
kaTam	kaTam	pos=i
nA	na	pos=i
yAsi	yA	pos=v,p=2,n=s,l=lat
iti	iti	pos=i
smaraRa	smaraRa	pos=n,comp=y
paripAwI	paripAwi	pos=n,comp=y
prakawanam	prakawana	pos=n,g=n,c=1,n=s
harO	hari	pos=n,g=m,c=7,n=s
sandeSAya	saMdeSa	pos=n,g=m,c=4,n=s
priya	priya	pos=a,comp=y
saKi	saKI	pos=n,g=f,c=8,n=s
na	na	pos=i
me	mad	pos=n,g=,c=6,n=s
vAc	vAc	pos=n,comp=y
avasaraH	avasara	pos=n,g=m,c=1,n=s

# id = HamDu.100
amI	adas	pos=n,g=m,c=1,n=p
kuYjaH	kuYja	pos=n,g=m,c=1,n=s
pUrvam	pUrvam	pos=i
na	na	pos=i
mama	mad	pos=n,g=,c=6,n=s
daDire	DA	pos=v,p=3,n=p,l=lit
kAm	ka	pos=n,g=f,c=2,n=s
api	api	pos=i
mudam	mud	pos=n,g=f,c=2,n=s
dru	dru	pos=n,comp=y
mAlIyam	mAlIya	pos=a,g=n,c=1,n=s
cetaH	cetas	pos=n,g=n,c=1,n=s
saKi	saKI	pos=n,g=f,c=8,n=s
na	na	pos=i
katiSo	katiSas	pos=i
idAnIm	idAnIm	pos=i
paSya	paS	pos=v,p=2,n=s,l=lot
ete	etad	pos=n,g=m,c=1,n=p
yugapadapatApam	viDA	pos=v,p=3,n=p,l=lat
vidaDate	praBu	pos=n,g=m,c=8,n=s
mukta	muc	pos=va,comp=y,f=part
upekze	upekzA	pos=n,g=f,c=8,n=s
muktopekze	Baj	pos=v,p=3,n=s,l=lat
Bajati	na	pos=i
na	hi	pos=i
hi	ka	pos=n,g=m,c=1,n=s
ko	vA	pos=i
vimuKa	vimuKa	pos=a,comp=y
tAm	tA	pos=n,g=f,c=2,n=s

