# id = Kokila.1.1
sODe	sODa	pos=n,g=m,c=7,n=s
tuNge	tuNga	pos=a,g=m,c=7,n=s
saha	saha	pos=i
dayitayA	dayitA	pos=n,g=f,c=3,n=s
ko	ka	pos=n,g=m,c=1,n=s
'pi	api	pos=i
saMkrIqamAnaH	saMkrIq	pos=va,g=m,c=1,n=s,f=part
prApa	prAp	pos=v,p=3,n=s,l=lit
svApam	svApa	pos=n,g=m,c=2,n=s
paramapuruzaH	paramapuruza	pos=n,g=m,c=1,n=s
Seza	Seza	pos=n,comp=y
Boge	Boga	pos=n,g=m,c=7,n=s
SriyA	SrI	pos=n,g=f,c=3,n=s
iva	iva	pos=i
citrA	citra	pos=a,g=f,c=1,n=s
dEvI	dEva	pos=a,g=f,c=1,n=s
gatiH	gati	pos=n,g=f,c=1,n=s
iyam	idam	pos=n,g=f,c=1,n=s
asO	adas	pos=n,g=f,c=1,n=s
SElajA	SElajA	pos=n,comp=y
maRqitAyAm	maRqay	pos=va,g=f,c=7,n=s,f=part
kAYcyAm	kAYcI	pos=n,g=f,c=7,n=s
kampA	kampA	pos=n,comp=y
tawa	tawa	pos=n,comp=y
Buvi	BU	pos=n,g=f,c=7,n=s
tayA	tad	pos=n,g=f,c=3,n=s
an	an	pos=i
anvitaH	anvita	pos=a,g=m,c=1,n=s
buDyate	buD	pos=v,p=3,n=s,l=lat
sma	sma	pos=i

# id = Kokila.1.2
tvA	tvad	pos=n,g=,c=2,n=s
AninyuH	AnI	pos=v,p=3,n=p,l=lit
suBaga	suBaga	pos=a,g=m,c=8,n=s
Sayitam	Sayita	pos=n,g=n,c=2,n=s
lIlayA	lIlA	pos=n,g=f,c=3,n=s
nIla	nIla	pos=a,comp=y
keSyaH	keSa	pos=a,g=f,c=1,n=p
drazwum	dfS	pos=vi
devam	deva	pos=n,g=m,c=2,n=s
varuRa	varuRa	pos=n,comp=y
purAt	pura	pos=n,g=n,c=5,n=s
saMpatantyo	sampat	pos=va,g=f,c=1,n=p,f=part
vimAnEH	vimAna	pos=n,g=n,c=3,n=p
atra	atra	pos=i
amuYcan	muc	pos=v,p=3,n=p,l=lan
api	api	pos=i
BagavatI	BagavatI	pos=n,comp=y
kiMkara	kiMkara	pos=n,comp=y
uktyA	ukti	pos=n,g=f,c=3,n=s
sa	sa	pos=i
SaNkA	SaNkA	pos=n,g=m,c=1,n=p
SuSrAva	Sru	pos=v,p=3,n=s,l=lit
itTam	itTam	pos=i
sa	tad	pos=n,g=m,c=1,n=s
punaH	punar	pos=i
a	a	pos=i
vapuH	vapus	pos=n,comp=y
saMgrahAm	saMgraha	pos=n,g=f,c=2,n=s
vyomni	vyoman	pos=n,g=m,c=7,n=s
vARIm	vARI	pos=n,g=f,c=2,n=s

# id = Kokila.1.3
kzetre	kzetra	pos=n,g=n,c=7,n=s
ca	ca	pos=i
asmin	idam	pos=n,g=n,c=7,n=s
sakala	sakala	pos=a,comp=y
vipad	vipad	pos=n,g=f,c=6,n=p
BaYjane	BaYjana	pos=n,g=n,c=7,n=s
paYca	paYcan	pos=n,g=m,c=2,n=p
mAsAn	mAsa	pos=n,g=m,c=2,n=p
AsITAH	As	pos=v,p=2,n=s,l=vidhilin
ced	ced	pos=i
priya	priya	pos=a,comp=y
jana	jana	pos=n,comp=y
viyoga	viyoga	pos=n,comp=y
ArtiH	Arti	pos=n,g=f,c=1,n=s
UrDvam	UrDvam	pos=i
na	na	pos=i
te	tvad	pos=n,g=,c=6,n=s
syAt	as	pos=v,p=3,n=s,l=vidhilin
AkarRya	AkarRay	pos=vi
imAm	idam	pos=n,g=f,c=2,n=s
punaH	punar	pos=i
iti	iti	pos=i
taTA	taTA	pos=i
saH	tad	pos=n,g=m,c=1,n=s
eza	etad	pos=n,g=m,c=1,n=s
cakre	kf	pos=v,p=3,n=s,l=lit
nivAsam	nivAsa	pos=n,g=m,c=2,n=s
kleSo	kleSa	pos=n,g=m,c=1,n=s
BUyAn	BUyas	pos=a,g=m,c=1,n=s
api	api	pos=i
bahu	bahu	pos=a,comp=y
mataH	man	pos=va,g=m,c=1,n=s,f=part
SlAGyate	SlAG	pos=v,p=3,n=s,l=lat
ced	ced	pos=i
udarkaH	udarka	pos=n,g=m,c=1,n=s

# id = Kokila.1.4
tatra	tatra	pos=i
dvitrAn	dvitra	pos=a,g=m,c=2,n=p
priya	priya	pos=a,comp=y
sahacarI	sahacarI	pos=n,comp=y
viprayoga	viprayoga	pos=n,comp=y
ati	ati	pos=i
dIrGAn	dIrGa	pos=a,g=m,c=2,n=p
kAma	kAma	pos=n,comp=y
ArtaH	Arta	pos=a,g=m,c=1,n=s
'yam	idam	pos=n,g=m,c=1,n=s
Siva	Siva	pos=n,comp=y
SivEH	Siva	pos=n,g=m,c=8,n=s
samullaNGya	samullaNGay	pos=vi
mAsAn	mAsa	pos=n,g=m,c=2,n=p
kaTaYcit	kaTaMcid	pos=i
cEtra	cEtra	pos=n,comp=y
AramBe	AramBa	pos=n,g=m,c=7,n=s
samudi	samudi	pos=va,comp=y,f=part
maDu	maDu	pos=a,comp=y
SrI	SrI	pos=n,comp=y
kawAkza	kawAkza	pos=n,comp=y
aBirAmam	aBirAma	pos=a,g=m,c=2,n=s
cUta	cUta	pos=n,comp=y
aNkUra	aNkUra	pos=n,comp=y
Asvadana	Asvadana	pos=n,comp=y
rasikam	rasika	pos=a,g=m,c=2,n=s
kokilam	kokila	pos=n,g=m,c=2,n=s
saMdadarSa	saMdfS	pos=v,p=3,n=s,l=lit

# id = Kokila.1.5
tam	tad	pos=n,g=m,c=2,n=s
kUjantam	kUj	pos=va,g=m,c=2,n=s,f=part
kala	kala	pos=a,comp=y
maDurayA	maDura	pos=a,g=f,c=3,n=s
paYcama	paYcama	pos=a,comp=y
svAna	svAna	pos=n,comp=y
BaNgyA	BaNgI	pos=n,g=f,c=3,n=s
kAntA	kAnta	pos=a,g=f,c=1,n=s
AlApa	AlApa	pos=n,comp=y
smaraRa	smaraRa	pos=n,comp=y
vivaSaH	vivaSa	pos=a,g=m,c=1,n=s
kiMcid	kaScit	pos=n,g=n,c=2,n=s
ArAt	ArAt	pos=i
upetya	upe	pos=vi
dattvA	dA	pos=vi
netra	netra	pos=n,comp=y
aYjali	aYjali	pos=n,comp=y
puwa	puwa	pos=n,comp=y
BftEH	Bf	pos=va,g=m,c=3,n=p,f=part
arGyam	arGya	pos=n,g=n,c=2,n=s
aSru	aSru	pos=n,comp=y
pravAhEH	pravAha	pos=n,g=m,c=3,n=p
jAta	jan	pos=va,comp=y,f=part
ASvAsaH	ASvAsa	pos=n,g=m,c=1,n=s
sPuwam	sPuwa	pos=a,g=n,c=1,n=s
iti	iti	pos=i
girA	gir	pos=n,g=f,c=3,n=s
SrAvyayA	Sru	pos=va,g=f,c=3,n=s,f=krtya
saMdideSa	saMdiS	pos=v,p=3,n=s,l=lit

# id = Kokila.1.6
atra	atra	pos=i
AyAhi	AyA	pos=v,p=2,n=s,l=lot
priya	priya	pos=a,comp=y
saKEH	saKa	pos=n,g=m,c=8,n=s
nanu	nanu	pos=i
svAgatam	svAgata	pos=n,g=n,c=1,n=s
paSya	paS	pos=v,p=2,n=s,l=lot
pArSve	pArSva	pos=n,g=m,c=7,n=s
pratyagra	pratyagra	pos=a,comp=y
udi	udi	pos=va,comp=y,f=part
maDu	maDu	pos=a,comp=y
rasa	rasa	pos=n,comp=y
kaRa	kaRa	pos=n,comp=y
svedin	svedin	pos=a,g=f,c=2,n=s
cUta	cUta	pos=n,comp=y
vallIm	vallI	pos=n,g=f,c=2,n=s
tvad	tvad	pos=n,comp=y
samparkam	samparka	pos=n,g=m,c=2,n=s
suBaga	suBaga	pos=a,g=m,c=8,n=s
niyatam	niyatam	pos=i
kANkzate	kANkz	pos=v,p=3,n=s,l=lat
'sO	adas	pos=n,g=f,c=1,n=s
vilolA	vilola	pos=a,g=f,c=1,n=s
lolamba	lolamba	pos=n,comp=y
akzI	akza	pos=a,g=f,c=1,n=s
cala	cala	pos=a,comp=y
kisalayEH	kisalaya	pos=n,g=m,c=3,n=p
AhvA	AhvA	pos=va,g=f,c=1,n=s,f=part
sa	sa	pos=i
rAgA	rAga	pos=n,g=f,c=1,n=s

# id = Kokila.1.7
antaH	antar	pos=i
tozam	toza	pos=n,g=m,c=2,n=s
mama	mad	pos=n,g=,c=6,n=s
vitanuze	vitan	pos=v,p=2,n=s,l=lat
hanta	hanta	pos=i
jAne	jYA	pos=v,p=1,n=s,l=lat
Bavantam	Bavat	pos=a,g=m,c=2,n=s
skanDAvAra	skanDAvAra	pos=n,comp=y
praTama	praTama	pos=a,comp=y
su	su	pos=i
Bawam	Bawa	pos=n,g=m,c=2,n=s
paYcabARasya	paYcabARa	pos=n,g=m,c=6,n=s
rAjYaH	rAjan	pos=n,g=m,c=6,n=s
kUja	kUj	pos=v,p=2,n=s,l=lot
a	a	pos=i
vyAjAt	vyAja	pos=n,g=m,c=5,n=s
hitam	hita	pos=a,g=n,c=2,n=s
upadiSan	upadiS	pos=va,g=m,c=1,n=s,f=part
kokilEH	kokila	pos=n,g=m,c=8,n=s
a	a	pos=i
vyAja	vyAja	pos=n,comp=y
banDo	banDu	pos=n,g=m,c=8,n=s
kAntEH	kAnta	pos=a,g=m,c=3,n=p
sAkam	sAkam	pos=i
nanu	nanu	pos=i
Gawayase	Gaway	pos=v,p=2,n=s,l=lat
kAminIH	kAminI	pos=n,g=f,c=2,n=p
mAna	mAna	pos=n,comp=y
BAjaH	BAj	pos=a,g=f,c=2,n=p

# id = Kokila.1.8
vAcAlam	vAcAla	pos=a,g=m,c=2,n=s
mA	mA	pos=i
paraBfta	paraBfta	pos=n,g=m,c=8,n=s
kfTA	kf	pos=v,p=2,n=s,l=lun_unaug
mAm	mad	pos=n,g=,c=2,n=s
priyA	priyA	pos=n,comp=y
viprayuktam	viprayuj	pos=va,g=m,c=2,n=s,f=part
prAyaH	prAyas	pos=i
prAptam	prAp	pos=va,g=n,c=1,n=s,f=part
praRaya	praRaya	pos=n,comp=y
vacanam	vacana	pos=n,g=n,c=1,n=s
tvAdfSe	tvAdfSa	pos=a,g=m,c=7,n=s
mAdfSAnAm	mAdfSa	pos=a,g=m,c=6,n=p
kiMcid	kaScit	pos=n,g=n,c=2,n=s
lInAm	lI	pos=va,g=f,c=2,n=s,f=part
kisalaya	kisalaya	pos=n,comp=y
puwe	puwa	pos=n,g=m,c=7,n=s
kokilAm	kokilA	pos=n,g=f,c=2,n=s
Akula	Akula	pos=a,comp=y
AtmA	Atman	pos=n,g=m,c=1,n=s
tvam	tvad	pos=n,g=,c=1,n=s
ca	ca	pos=i
a	a	pos=i
paSyan	dfS	pos=va,g=m,c=1,n=s,f=part
bata	bata	pos=i
virahiRAm	virahin	pos=a,g=m,c=6,n=p
yena	yena	pos=i
jAnAsi	jYA	pos=v,p=2,n=s,l=lat
tApam	tApa	pos=n,g=m,c=2,n=s

# id = Kokila.1.9
yAvatkAlam	yAvatkAlam	pos=i
mahita	mahita	pos=a,comp=y
pataga	pataga	pos=n,comp=y
aDISa	aDISa	pos=n,g=m,c=8,n=s
kArye	kArya	pos=n,g=n,c=7,n=s
niyoktum	niyuj	pos=vi
saNkocam	saMkoca	pos=n,g=m,c=2,n=s
me	mad	pos=n,g=,c=6,n=s
vrajati	vraj	pos=v,p=3,n=s,l=lat
rasanA	rasanA	pos=n,g=f,c=1,n=s
saMdidikzoH	saMdidikzu	pos=a,g=m,c=6,n=s
mfgAkzyAH	mfgAkzI	pos=n,g=f,c=6,n=s
tAvatkAlam	tAvatkAlam	pos=i
tava	tvad	pos=n,g=,c=6,n=s
ca	ca	pos=i
hfdayam	hfdaya	pos=n,g=n,c=1,n=s
tAntim	tAnti	pos=n,g=f,c=2,n=s
eti	i	pos=v,p=3,n=s,l=lat
iti	iti	pos=i
SaNke	SaNk	pos=v,p=1,n=s,l=lat
dIna	dIna	pos=a,comp=y
Apanna	Apad	pos=va,comp=y,f=part
praRaya	praRaya	pos=n,comp=y
Gawane	Gawana	pos=n,g=n,c=7,n=s
dIrGasUtrEH	dIrGasUtra	pos=a,g=m,c=8,n=s
itarasya	itara	pos=n,g=m,c=6,n=s

# id = Kokila.1.10
sandeSam	saMdeSa	pos=n,g=m,c=2,n=s
me	mad	pos=n,g=,c=6,n=s
naya	nI	pos=v,p=2,n=s,l=lot
Kaga	Kaga	pos=n,comp=y
pate	pati	pos=n,g=m,c=8,n=s
sADaya	sADay	pos=v,p=2,n=s,l=lot
BrAtf	BrAtf	pos=n,comp=y
kftyam	kftya	pos=n,g=n,c=2,n=s
saMtApa	saMtApa	pos=n,comp=y
ArtAm	Arta	pos=a,g=f,c=2,n=s
su	su	pos=i
vacanEH	vacana	pos=n,g=m,c=8,n=s
samASvAsaya	samASvAsay	pos=v,p=2,n=s,l=lot
preyasIm	preyas	pos=a,g=f,c=2,n=s
me	mad	pos=n,g=,c=6,n=s
kAnta	kAnta	pos=a,comp=y
udantaH	udanta	pos=a,g=m,c=1,n=s
suhfd	suhfd	pos=n,g=m,c=1,n=s
upanataH	upanam	pos=va,g=m,c=1,n=s,f=part
viprayoga	viprayoga	pos=n,comp=y
arditAnAm	arday	pos=va,g=f,c=6,n=p,f=part
prAyaH	prAyas	pos=i
strIRAm	strI	pos=n,g=f,c=6,n=p
Bavati	BU	pos=v,p=3,n=s,l=lat
kim	ka	pos=n,g=n,c=1,n=s
api	api	pos=i
prARa	prARa	pos=n,comp=y
saMDAraRAya	saMDAraRa	pos=n,g=n,c=4,n=s

# id = Kokila.1.11
gantavyaH	gam	pos=va,g=m,c=1,n=s,f=krtya
te	tvad	pos=n,g=,c=6,n=s
tridiva	tridiva	pos=n,comp=y
vijayI	vijayin	pos=a,g=m,c=1,n=s
maNgala	maNgala	pos=n,comp=y
agreRa	agra	pos=n,g=n,c=3,n=s
deSaH	deSa	pos=n,g=m,c=1,n=s
prAptaH	prAp	pos=va,g=m,c=1,n=s,f=part
KyAtim	KyAti	pos=n,g=f,c=2,n=s
vihita	viDA	pos=va,comp=y,f=part
tapasaH	tapas	pos=n,g=m,c=6,n=s
prAc	prAYc	pos=a,comp=y
jayantasya	jayanta	pos=n,g=m,c=6,n=s
nAmnA	nAman	pos=n,g=n,c=3,n=s
pAre	pAra	pos=n,g=n,c=7,n=s
cUrRyAH	cUrRI	pos=n,g=f,c=6,n=s
parisara	parisara	pos=n,comp=y
samAs	samAs	pos=va,comp=y,f=part
govinda	govinda	pos=n,comp=y
vakzaH	vakzas	pos=n,comp=y
lakzmi	lakzmI	pos=n,comp=y
vIkzA	vIkzA	pos=n,comp=y
vivalana	vivalana	pos=n,comp=y
suDA	suDA	pos=n,comp=y
SItalaH	SItala	pos=a,g=m,c=1,n=s
keralezu	kerala	pos=n,g=m,c=7,n=p

# id = Kokila.1.12
tatra	tatra	pos=i
drakzyasi	dfS	pos=v,p=2,n=s,l=lrt
aKila	aKila	pos=a,comp=y
mahilA	mahilA	pos=n,comp=y
mOli	mOli	pos=n,comp=y
mAlAy	mAlAy	pos=va,g=f,c=2,n=s,f=part
bAlAm	bAlA	pos=n,g=f,c=2,n=s
enAm	enad	pos=n,g=f,c=2,n=s
niyatam	niyatam	pos=i
aDunA	aDunA	pos=i
mad	mad	pos=n,comp=y
viyogena	viyoga	pos=n,g=m,c=3,n=s
dInAm	dIna	pos=a,g=f,c=2,n=s
kalyARI	kalyARa	pos=a,g=f,c=1,n=s
sA	tad	pos=n,g=f,c=1,n=s
kanakakadalI	kanakakadalI	pos=n,comp=y
kandalI	kandalI	pos=n,comp=y
komala	komala	pos=a,comp=y
aNgI	aNga	pos=a,g=f,c=1,n=s
kandarpa	kandarpa	pos=n,comp=y
agnim	agni	pos=n,g=m,c=2,n=s
kaTam	kaTam	pos=i
iva	iva	pos=i
kukUla	kukUla	pos=n,comp=y
agni	agni	pos=n,comp=y
kalpam	kalpa	pos=a,g=m,c=2,n=s
saheta	sah	pos=v,p=3,n=s,l=vidhilin

# id = Kokila.1.13
aDvAnam	aDvan	pos=n,g=m,c=2,n=s
te	tvad	pos=n,g=,c=6,n=s
hitam	hita	pos=a,g=m,c=2,n=s
upadiSAmi	upadiS	pos=v,p=1,n=s,l=lat
a	a	pos=i
SrameRa	Srama	pos=n,g=m,c=3,n=s
eva	eva	pos=i
gantum	gam	pos=vi
snigDa	snigDa	pos=a,comp=y
CAyA	CAyA	pos=n,g=m,c=3,n=p
taruBiH	taru	pos=n,g=m,c=3,n=p
aBitas	aBitas	pos=i
SAnta	Sam	pos=va,comp=y,f=part
Garma	Garma	pos=n,comp=y
pracAram	pracAra	pos=n,g=m,c=2,n=s
saMskartAsi	saMskf	pos=v,p=2,n=s,l=lrt
Druvam	Druvam	pos=i
upagataH	upagam	pos=va,g=m,c=1,n=s,f=part
yatra	yatra	pos=i
pattrin	pattrin	pos=n,comp=y
indra	indra	pos=n,g=m,c=8,n=s
tezAm	tad	pos=n,g=m,c=6,n=p
uddAmAnAm	uddAma	pos=a,g=m,c=6,n=p
api	api	pos=i
nava	nava	pos=a,comp=y
nava	nava	pos=a,comp=y
udyAna	udyAna	pos=n,comp=y
lIlAyitAnAm	lIlAy	pos=va,g=m,c=6,n=p,f=part

# id = Kokila.1.14
SrI	SrI	pos=n,comp=y
kAmAkzyAH	kAmAkzI	pos=n,g=f,c=6,n=s
vinatam	vinam	pos=va,g=m,c=2,n=s,f=part
amarEH	amara	pos=n,g=m,c=3,n=p
utsavam	utsava	pos=n,g=m,c=2,n=s
PAlguna	PAlguna	pos=n,comp=y
AKyam	AKyA	pos=n,g=m,c=2,n=s
dfzwvA	dfS	pos=vi
yAntyaH	yA	pos=va,g=f,c=1,n=p,f=part
sva	sva	pos=a,comp=y
Bavanam	Bavana	pos=n,g=n,c=2,n=s
upArUQa	upAruh	pos=va,comp=y,f=part
nAnA	nAnA	pos=i
vimAna	vimAna	pos=n,g=f,c=1,n=p
tvad	tvad	pos=n,comp=y
saMlApa	saMlApa	pos=n,comp=y
SravaRa	SravaRa	pos=n,comp=y
taralAH	tarala	pos=a,g=m,c=1,n=p
paScima	paScima	pos=a,comp=y
amBoDi	amBoDi	pos=n,comp=y
velA	velA	pos=n,comp=y
paryantam	paryanta	pos=n,g=m,c=2,n=s
te	tvad	pos=n,g=,c=6,n=s
varuRa	varuRa	pos=n,comp=y
nagarI	nagarI	pos=n,comp=y
maYju	maYju	pos=a,comp=y
vAcaH	vAc	pos=n,g=m,c=1,n=p
sahAyAH	sahAya	pos=n,g=m,c=1,n=p

# id = Kokila.1.15
AkarzantaH	Akfz	pos=va,g=m,c=1,n=p,f=part
pratinava	pratinava	pos=a,comp=y
latA	latA	pos=n,comp=y
puzpa	puzpa	pos=n,comp=y
ganDa	ganDa	pos=n,comp=y
upahArAn	upahAra	pos=n,g=m,c=2,n=p
AsiYcantaH	Asic	pos=va,g=m,c=1,n=p,f=part
saraRim	saraRi	pos=n,g=f,c=2,n=s
aBitas	aBitas	pos=i
SItalEH	SItala	pos=a,g=m,c=3,n=p
SITu	SITu	pos=n,comp=y
leSEH	leSa	pos=n,g=m,c=3,n=p
BfNgI	BfNgI	pos=n,comp=y
nAdEH	nAda	pos=n,g=m,c=3,n=p
maDura	maDura	pos=a,comp=y
maDuram	maDura	pos=a,g=n,c=2,n=s
vyAharanto	vyAhf	pos=va,g=m,c=1,n=p,f=part
valante	val	pos=v,p=3,n=p,l=lat
kampA	kampA	pos=n,comp=y
kUla	kUla	pos=n,comp=y
upavana	upavana	pos=n,comp=y
pavanAH	pavana	pos=n,g=m,c=1,n=p
banDavaH	banDu	pos=n,g=m,c=1,n=p
te	tvad	pos=n,g=,c=6,n=s
'nukUlAH	anukUla	pos=a,g=m,c=1,n=p

# id = Kokila.1.16
vandasva	vand	pos=v,p=2,n=s,l=lot
ArAt	ArAt	pos=i
priya	priya	pos=a,comp=y
saKEH	saKa	pos=n,g=m,c=8,n=s
punaH	punar	pos=i
darSanAya	darSana	pos=n,g=n,c=4,n=s
atra	atra	pos=i
SOreH	SOri	pos=n,g=m,c=6,n=s
kAYcI	kAYcI	pos=n,comp=y
BartuH	Bartf	pos=n,g=m,c=6,n=s
karigiri	karigiri	pos=n,comp=y
tawe	tawa	pos=n,g=n,c=7,n=s
puRyam	puRya	pos=a,g=m,c=2,n=s
enam	enad	pos=n,g=m,c=2,n=s
vimAnam	vimAna	pos=n,g=m,c=2,n=s
ADatte	ADA	pos=v,p=3,n=s,l=lat
yat	yad	pos=n,g=n,c=2,n=s
kanaka	kanaka	pos=n,comp=y
valaBI	valaBi	pos=n,comp=y
nIqa	nIqa	pos=n,comp=y
lInEH	lI	pos=va,g=m,c=3,n=p,f=part
kapotEH	kapota	pos=n,g=m,c=3,n=p
adya	adya	pos=i
api	api	pos=i
amBoruha	amBoruha	pos=n,comp=y
Bava	Bava	pos=n,comp=y
maKa	maKa	pos=n,comp=y
Alag	Alag	pos=va,comp=y,f=part
DUma	DUma	pos=n,comp=y
aBiSaNkAm	aBiSaNkA	pos=n,g=f,c=2,n=s

# id = Kokila.1.17
pIWezu	pIWa	pos=n,g=n,c=7,n=p
azwAdaSan	azwAdaSan	pos=a,g=n,c=7,n=p
mahitam	mahita	pos=a,g=n,c=2,n=s
kAma	kAma	pos=n,comp=y
pIWam	pIWa	pos=n,g=n,c=2,n=s
BajeTAH	Baj	pos=v,p=2,n=s,l=vidhilin
pArekampam	pArekampa	pos=n,g=n,c=2,n=s
svayam	svayam	pos=i
iha	iha	pos=i
parA	para	pos=n,g=f,c=1,n=s
devatA	devatA	pos=n,g=f,c=1,n=s
saMniDatte	saMniDA	pos=v,p=3,n=s,l=lat
sa	sa	pos=i
BrU	BrU	pos=n,comp=y
cApam	cApa	pos=n,g=m,c=2,n=s
nayana	nayana	pos=n,comp=y
jaladam	jalada	pos=n,g=m,c=2,n=s
prApya	prAp	pos=vi
yasyAH	yad	pos=n,g=f,c=6,n=s
tuRqIra	tuRqIra	pos=n,comp=y
kzmA	kzmA	pos=n,g=f,c=1,n=s
sulaBa	sulaBa	pos=a,comp=y
kavi	kavi	pos=n,comp=y
tA	tA	pos=n,comp=y
sasya	sasya	pos=n,comp=y
vfdDiH	vfdDi	pos=n,g=f,c=1,n=s
sulaBakavitAsasyavfdDiH	saminD	pos=v,p=1,n=s,l=lat

# id = Kokila.1.18
uqqIya	uqqI	pos=vi
asmAt	idam	pos=n,g=m,c=5,n=s
bakula	bakula	pos=n,comp=y
sarasAt	sarasa	pos=a,g=m,c=5,n=s
sa	tad	pos=n,g=m,c=1,n=s
tvam	tvad	pos=n,g=,c=1,n=s
udyAna	udyAna	pos=n,comp=y
deSAt	deSa	pos=n,g=m,c=5,n=s
prAdakziRyAd	prAdakziRya	pos=n,g=n,c=5,n=s
vraja	vraj	pos=v,p=2,n=s,l=lot
parisare	parisara	pos=n,g=m,c=7,n=s
puRyam	puRya	pos=a,g=m,c=2,n=s
eka	eka	pos=n,comp=y
Amra	Amra	pos=n,comp=y
vfkzam	vfkza	pos=n,g=m,c=2,n=s
mUle	mUla	pos=n,g=n,c=7,n=s
yasya	yad	pos=n,g=m,c=6,n=s
prakfti	prakfti	pos=n,comp=y
suBage	suBaga	pos=a,g=n,c=7,n=s
mukta	muc	pos=va,comp=y,f=part
kElAsa	kElAsa	pos=n,comp=y
loBaH	loBa	pos=n,g=m,c=1,n=s
devaH	deva	pos=n,g=m,c=1,n=s
sAkzAt	sAkzAt	pos=i
vasati	vas	pos=v,p=3,n=s,l=lat
valaya	valaya	pos=n,comp=y
aNka	aNka	pos=n,comp=y
AhvayaH	Ahvaya	pos=n,g=m,c=1,n=s
candracUqaH	candracUqa	pos=n,g=m,c=1,n=s

# id = Kokila.1.19
dfzwvA	dfS	pos=vi
SamBum	SamBu	pos=n,g=m,c=2,n=s
gagana	gagana	pos=n,comp=y
saraRO	saraRi	pos=n,g=f,c=7,n=s
ujjihAne	ujjihAna	pos=a,g=m,c=7,n=s
tvayi	tvad	pos=n,g=,c=7,n=s
drAk	drAk	pos=i
pakza	pakza	pos=n,comp=y
dvandva	dvaMdva	pos=n,comp=y
vyajana	vyajana	pos=n,comp=y
pavana	pavana	pos=n,comp=y
uccAlay	uccAlay	pos=va,g=f,c=5,n=p,f=part
latAByaH	latA	pos=n,g=f,c=5,n=p
utTAsyanti	utTA	pos=v,p=3,n=p,l=lrt
Bramara	Bramara	pos=n,comp=y
taruRAH	taruRa	pos=a,g=m,c=1,n=p
sic	sic	pos=va,comp=y,f=part
dehAH	deha	pos=n,g=m,c=1,n=p
marandEH	maranda	pos=n,g=m,c=3,n=p
udyAna	udyAna	pos=n,comp=y
SrI	SrI	pos=n,comp=y
prahita	prahi	pos=va,comp=y,f=part
sajala	sajala	pos=a,comp=y
apANga	apANga	pos=n,comp=y
BaNga	BaNga	pos=n,comp=y
anukArAH	anukAra	pos=n,g=m,c=1,n=p

# id = Kokila.1.20
spazwa	spazwa	pos=a,comp=y
Alakzay	Alakzay	pos=va,g=m,c=1,n=s,f=krtya
tve	tvad	pos=n,g=,c=7,n=s
pika	pika	pos=n,g=m,c=8,n=s
samAlambamAne	samAlamb	pos=va,g=m,c=7,n=s,f=part
ambara	ambara	pos=n,comp=y
antam	anta	pos=n,g=m,c=2,n=s
kAYcI	kAYcI	pos=n,comp=y
deSaH	deSa	pos=n,g=m,c=1,n=s
kim	ka	pos=n,g=n,c=2,n=s
api	api	pos=i
vasuDAm	vasuDA	pos=n,g=f,c=2,n=s
BUzayan	BUzay	pos=va,g=m,c=1,n=s,f=part
gOraveRa	gOrava	pos=n,g=n,c=3,n=s
tad	tad	pos=n,comp=y
sOndarya	sOndarya	pos=n,comp=y
apahfta	apahf	pos=va,comp=y,f=part
hfdayaH	hfdaya	pos=n,g=m,c=1,n=s
mA	mA	pos=i
vilambasva	vilamb	pos=v,p=2,n=s,l=lot
gantum	gam	pos=vi
banDu	banDu	pos=n,comp=y
trARAt	trARa	pos=n,g=n,c=5,n=s
bahu	bahu	pos=a,comp=y
mati	mati	pos=n,comp=y
padam	pada	pos=n,g=n,c=1,n=s
na	na	pos=i
aparam	apara	pos=n,g=n,c=1,n=s
tvadviDAnAm	tvadviDa	pos=a,g=m,c=6,n=p

# id = Kokila.1.21
ASAm	ASA	pos=n,g=f,c=2,n=s
pASa	pASa	pos=n,comp=y
AyuDa	AyuDa	pos=n,comp=y
tilakitAm	tilakita	pos=a,g=f,c=2,n=s
ASri	ASri	pos=va,g=m,c=1,n=s,f=part
Atta	AdA	pos=va,comp=y,f=part
vegaH	vega	pos=n,g=m,c=1,n=s
kUla	kUla	pos=n,comp=y
unmIl	unmIl	pos=va,comp=y,f=part
kramuka	kramuka	pos=n,comp=y
kuhalI	kuhalI	pos=n,comp=y
cAmara	cAmara	pos=n,comp=y
Andolay	Andolay	pos=va,comp=y,f=part
Urmim	Urmi	pos=n,g=m,c=2,n=s
drakzyasi	dfS	pos=v,p=2,n=s,l=lrt
agre	agra	pos=n,g=n,c=7,n=s
vikaca	vikaca	pos=a,comp=y
kamala	kamala	pos=n,comp=y
udganDi	udganDi	pos=a,comp=y
mADvIka	mADvIka	pos=n,comp=y
pAnAt	pAna	pos=n,g=n,c=5,n=s
kzIba	kzIba	pos=a,comp=y
kzIba	kzIba	pos=a,comp=y
Bramara	Bramara	pos=n,comp=y
taruRI	taruRI	pos=n,comp=y
sevitAm	sev	pos=va,g=f,c=2,n=s,f=part
kzIra	kzIra	pos=n,comp=y
siMDum	sinDu	pos=n,g=f,c=2,n=s

# id = Kokila.1.22
pataga	pataga	pos=n,g=m,c=8,n=s
purajit	purajit	pos=n,comp=y
kaMDara	kaMDara	pos=n,comp=y
kARqa	kARqa	pos=n,comp=y
nIlEH	nIla	pos=a,g=m,c=3,n=p
vyApta	vyAp	pos=va,comp=y,f=part
ABogA	ABoga	pos=n,g=f,c=1,n=s
visfmaratarEH	visfmaratara	pos=a,g=m,c=3,n=p
vyoma	vyoman	pos=n,g=n,c=2,n=s
sImantayantI	sImantay	pos=va,g=f,c=1,n=s,f=part
su	su	pos=i
vyaktam	vyakta	pos=a,g=n,c=2,n=s
te	tvad	pos=n,g=,c=6,n=s
gamana	gamana	pos=n,comp=y
saraRiH	saraRi	pos=n,g=f,c=1,n=s
sUtrayet	sUtray	pos=v,p=3,n=s,l=vidhilin
UrDvam	UrDvam	pos=i
asyAH	idam	pos=n,g=f,c=6,n=s
sinDu	sinDu	pos=n,comp=y
sneha	sneha	pos=n,comp=y
upagata	upagam	pos=va,comp=y,f=part
yamunA	yamunA	pos=n,comp=y
veRI	veRI	pos=n,comp=y
vITI	vITi	pos=n,comp=y
vilAsam	vilAsa	pos=n,g=m,c=2,n=s

# id = Kokila.1.23
cUte	cUta	pos=n,g=m,c=7,n=s
cUte	cUta	pos=n,g=m,c=7,n=s
kusuma	kusuma	pos=n,comp=y
kalikAm	kalikA	pos=n,g=f,c=2,n=s
tvAm	tvad	pos=n,g=,c=2,n=s
ca	ca	pos=i
dfzwvA	dfS	pos=vi
sametam	same	pos=va,g=m,c=2,n=s,f=part
bAlA	bAlA	pos=n,comp=y
Soka	Soka	pos=n,comp=y
Ahananam	Ahanana	pos=n,g=m,c=2,n=s
aruREH	aruRa	pos=a,g=m,c=3,n=p
aNGriBiH	aNGri	pos=n,g=m,c=3,n=p
tan	tan	pos=va,g=f,c=6,n=p,f=part
tanvaNgInAm	tanvaNgI	pos=n,g=f,c=6,n=p
SravaRa	SravaRa	pos=n,comp=y
suBagEH	suBaga	pos=a,g=m,c=3,n=p
nUpurAnAm	nUpura	pos=n,g=m,c=6,n=p
virAvEH	virAva	pos=n,g=m,c=3,n=p
vAcAlAH	vAcAla	pos=a,g=f,c=1,n=p
syuH	as	pos=v,p=3,n=p,l=vidhilin
niyatam	niyatam	pos=i
aBitas	aBitas	pos=i
kUlam	kUla	pos=n,g=n,c=2,n=s
ArAma	ArAma	pos=n,comp=y
sImAH	sImA	pos=n,g=f,c=1,n=p

# id = Kokila.1.24
snAta	snA	pos=va,comp=y,f=part
uttIrRAH	uttf	pos=va,g=f,c=2,n=p,f=part
sa	sa	pos=i
jala	jala	pos=n,comp=y
kaRikA	kaRikA	pos=n,comp=y
sundara	sundara	pos=a,comp=y
uroja	uroja	pos=n,comp=y
kumBAH	kumBa	pos=n,g=f,c=2,n=p
SyAmA	SyAmA	pos=n,comp=y
paNkEH	paNka	pos=n,g=m,c=3,n=p
SuBa	SuBa	pos=a,comp=y
parimalEH	parimala	pos=n,g=m,c=3,n=p
spfzwa	spfS	pos=va,comp=y,f=part
mANgalya	mANgalya	pos=n,comp=y
BUzAH	BUzA	pos=n,g=f,c=2,n=p
tIre	tIra	pos=n,g=n,c=7,n=s
tasyA	tad	pos=n,g=f,c=6,n=s
dramiqa	dramiqa	pos=n,comp=y
sudfH	sudfS	pos=a,g=f,c=2,n=p
darSanIyA	darSanIya	pos=a,g=f,c=2,n=p
vilokya	vilokay	pos=vi
prAyo	prAyas	pos=i
BAvI	BAvin	pos=a,g=m,c=1,n=s
kzaRam	kzaRa	pos=n,g=m,c=2,n=s
iva	iva	pos=i
saKe	saKi	pos=n,g=,c=8,n=s
gacCataH	gam	pos=va,g=m,c=6,n=s,f=part
te	tvad	pos=n,g=,c=6,n=s
vilambaH	vilamba	pos=n,g=m,c=1,n=s

# id = Kokila.1.25
DUma	DUma	pos=n,comp=y
stomEH	stoma	pos=n,g=m,c=3,n=p
savana	savana	pos=n,comp=y
janitEH	janay	pos=va,g=m,c=3,n=p,f=part
DUsara	DUsara	pos=a,comp=y
upAnta	upAnta	pos=n,comp=y
vfkzAH	vfkza	pos=n,g=m,c=1,n=p
prOQa	prOQa	pos=a,comp=y
SlAG	SlAG	pos=va,g=m,c=3,n=p,f=krtya
muKarita	muKaray	pos=va,comp=y,f=part
maWAH	maWa	pos=n,g=m,c=1,n=p
pAvanEH	pAvana	pos=a,g=m,c=3,n=p
brahmaGozEH	brahmaGoza	pos=n,g=m,c=3,n=p
rudDa	ruD	pos=va,comp=y,f=part
ABogAH	ABoga	pos=n,g=m,c=1,n=p
dvijavara	dvijavara	pos=n,comp=y
viDi	viDi	pos=n,comp=y
snAna	snAna	pos=n,comp=y
pUtEH	pU	pos=va,g=n,c=3,n=p,f=part
tawAkEH	tawAka	pos=n,g=n,c=3,n=p
drazwavyAH	dfS	pos=va,g=m,c=1,n=p,f=krtya
te	tvad	pos=n,g=,c=6,n=s
tadanu	tadanu	pos=i
saritam	sarit	pos=n,g=f,c=2,n=s
dakziRena	dakziRa	pos=a,g=m,c=3,n=s
agrahArAH	agrahAra	pos=n,g=m,c=1,n=p

# id = Kokila.1.26
sA	tad	pos=n,g=f,c=1,n=s
vEdagDI	vEdagDI	pos=n,g=f,c=1,n=s
Srutizu	Sruti	pos=n,g=f,c=7,n=p
sa	tad	pos=n,g=m,c=1,n=s
punaH	punar	pos=i
sarva	sarva	pos=n,comp=y
SAstra	SAstra	pos=n,comp=y
avagAhaH	avagAha	pos=n,g=m,c=1,n=s
tat	tad	pos=n,g=n,c=1,n=s
ca	ca	pos=i
a	a	pos=i
mlAna	mlA	pos=va,comp=y,f=part
prasara	prasara	pos=n,comp=y
sarasam	sarasa	pos=a,g=n,c=1,n=s
nizkalaNkam	nizkalaNka	pos=a,g=n,c=1,n=s
kavi	kavi	pos=n,comp=y
tvam	tva	pos=n,g=n,c=1,n=s
tatratyAnAm	tatratya	pos=a,g=m,c=6,n=p
kim	ka	pos=n,g=n,c=1,n=s
iha	iha	pos=i
bahunA	bahu	pos=a,g=n,c=3,n=s
sarvam	sarva	pos=n,g=n,c=2,n=s
etat	etad	pos=n,g=n,c=2,n=s
paWantaH	paW	pos=va,g=m,c=1,n=p,f=part
SfNge	SfNga	pos=n,g=n,c=7,n=s
SfNge	SfNga	pos=n,g=n,c=7,n=s
gfha	gfha	pos=n,comp=y
viwapinAm	viwapin	pos=n,g=m,c=6,n=p
spazwayizyanti	spazway	pos=v,p=3,n=p,l=lrt
kIrAH	kIra	pos=n,g=m,c=1,n=p

# id = Kokila.1.27
tAn	tad	pos=n,g=m,c=2,n=p
ullaNGya	ullaNGay	pos=vi
smita	smita	pos=n,comp=y
kuvalaya	kuvalaya	pos=n,comp=y
snigDam	snigDa	pos=a,g=n,c=2,n=s
utkanDarAnAm	utkanDara	pos=a,g=f,c=6,n=p
cola	cola	pos=n,comp=y
strIRAm	strI	pos=n,g=f,c=6,n=p
ayi	ayi	pos=i
saPalayan	saPalay	pos=va,g=m,c=1,n=s,f=part
netram	netra	pos=n,g=n,c=2,n=s
utpakzma	utpakzman	pos=a,comp=y
mAlam	mAlA	pos=n,g=n,c=2,n=s
bilva	bilva	pos=n,comp=y
kzetram	kzetra	pos=n,g=n,c=2,n=s
viSa	viS	pos=v,p=2,n=s,l=lot
paSupateH	paSupati	pos=n,g=m,c=6,n=s
veSma	veSman	pos=n,g=n,c=2,n=s
Duta	DU	pos=va,comp=y,f=part
alinda	alinda	pos=n,comp=y
Dvaja	Dvaja	pos=n,comp=y
pawa	pawa	pos=n,comp=y
SiKA	SiKA	pos=n,g=m,c=3,n=p
DUtAlindaDvajapawaSiKEH	nUnam	pos=i
nUnam	AhvA	pos=va,g=m,c=1,n=s,f=part

# id = Kokila.1.28
kAmaH	kAma	pos=n,g=m,c=1,n=s
svAmI	svAmin	pos=n,g=m,c=1,n=s
kila	kila	pos=i
SalaBa	SalaBa	pos=n,comp=y
tAm	tA	pos=n,g=f,c=2,n=s
Apa	Ap	pos=v,p=3,n=s,l=lit
netra	netra	pos=n,comp=y
sPuliNge	sPuliNga	pos=n,g=m,c=7,n=s
mA	mA	pos=i
mA	mad	pos=n,g=,c=2,n=s
BEzIH	BI	pos=v,p=2,n=s,l=lun_unaug
iti	iti	pos=i
Bava	Bava	pos=n,comp=y
Bid	Bid	pos=a,g=m,c=6,n=s
darSanAt	darSana	pos=n,g=n,c=5,n=s
candramOli	candramOli	pos=n,g=m,c=6,n=s
SyAmA	SyAma	pos=a,g=f,c=1,n=s
varRe	varRa	pos=n,g=m,c=7,n=s
vacasi	vacas	pos=n,g=n,c=7,n=s
maDurA	maDura	pos=a,g=f,c=1,n=s
caYcalA	caYcala	pos=a,g=f,c=1,n=s
dfH	dfS	pos=n,comp=y
vilAse	vilAsa	pos=n,g=m,c=7,n=s
vAma	vAma	pos=a,comp=y
utsaNge	utsaNga	pos=n,g=m,c=7,n=s
lasati	las	pos=v,p=3,n=s,l=lat
karuRA	karuRa	pos=a,g=f,c=1,n=s
kA	ka	pos=n,g=f,c=1,n=s
api	api	pos=i
kAmam	kAmam	pos=i
duhAnA	duh	pos=va,g=f,c=1,n=s,f=part

# id = Kokila.1.29
pakzi	pakzin	pos=n,comp=y
svAneBiH	svAna	pos=n,g=m,c=3,n=p
pawu	pawu	pos=a,comp=y
mada	mada	pos=n,comp=y
kalEH	kala	pos=a,g=m,c=3,n=p
svAgatAni	svAgata	pos=n,g=n,c=2,n=p
bruvARA	brU	pos=va,g=m,c=1,n=p,f=part
vyAkF	vyAkF	pos=va,comp=y,f=part
arGyAH	arGya	pos=n,g=m,c=1,n=p
kusuma	kusuma	pos=n,comp=y
maDuBiH	maDu	pos=a,g=m,c=3,n=p
vIjay	vIjay	pos=va,g=m,c=1,n=p,f=part
pravAlEH	pravAla	pos=n,g=m,c=3,n=p
tatra	tatra	pos=i
ArAmAH	ArAma	pos=n,g=m,c=1,n=p
suraBi	suraBi	pos=a,comp=y
sacivam	saciva	pos=n,g=m,c=2,n=s
tvAm	tvad	pos=n,g=,c=2,n=s
saKe	saKi	pos=n,g=,c=8,n=s
mAnayeyus	mAnay	pos=v,p=3,n=p,l=vidhilin
tulya	tulya	pos=a,comp=y
prItiH	prIti	pos=n,g=m,c=1,n=s
Bavati	BU	pos=v,p=3,n=s,l=lat
hi	hi	pos=i
jano	jana	pos=n,g=m,c=1,n=s
rAja	rAjan	pos=n,comp=y
vat	vat	pos=i
rAja	rAjan	pos=n,comp=y
mitre	mitra	pos=n,g=m,c=7,n=s

# id = Kokila.1.30
kAle	kAla	pos=n,g=m,c=7,n=s
tasmin	tad	pos=n,g=m,c=7,n=s
kara	kara	pos=n,comp=y
Dfta	Df	pos=va,comp=y,f=part
gal	gal	pos=va,comp=y,f=part
nIvyaH	nIvi	pos=n,g=f,c=1,n=p
vAraka	vAraka	pos=n,comp=y
antAH	anta	pos=n,g=f,c=1,n=p
saMBoga	samBoga	pos=n,comp=y
ante	anta	pos=n,g=m,c=7,n=s
nibiqa	nibiqa	pos=a,comp=y
latikA	latikA	pos=n,comp=y
mandireByaH	mandira	pos=n,g=n,c=5,n=p
cal	cal	pos=va,g=f,c=1,n=p,f=part
vIta	vI	pos=va,comp=y,f=part
sveda	sveda	pos=n,g=f,c=1,n=p
te	tvad	pos=n,g=,c=6,n=s
viharataH	vihf	pos=va,g=m,c=6,n=s,f=part
pakza	pakza	pos=n,comp=y
pAli	pAli	pos=n,comp=y
samIrEH	samIra	pos=n,g=m,c=3,n=p
AKid	AKid	pos=va,comp=y,f=part
BrU	BrU	pos=n,comp=y
valanam	valana	pos=n,g=n,c=2,n=s
alasEH	alasa	pos=a,g=m,c=3,n=p
arcayizyanti	arcay	pos=v,p=3,n=p,l=lrt
apANgEH	apANga	pos=n,g=m,c=3,n=p

# id = Kokila.1.31
BUyo	BUyas	pos=i
gacCan	gam	pos=va,g=m,c=1,n=s,f=part
janapadam	janapada	pos=n,g=m,c=2,n=s
imam	idam	pos=n,g=m,c=2,n=s
sa	tad	pos=n,g=m,c=1,n=s
tvam	tvad	pos=n,g=,c=1,n=s
ullaNGya	ullaNGay	pos=vi
colAn	cola	pos=n,g=m,c=2,n=p
AlokeTAs	Alok	pos=v,p=2,n=s,l=vidhilin
tarala	tarala	pos=a,comp=y
hariRI	hariRI	pos=n,comp=y
netra	netra	pos=n,comp=y
tApiYCitAni	tApiYCita	pos=n,g=n,c=2,n=p
kAntArARi	kAntAra	pos=n,g=n,c=2,n=p
prasava	prasava	pos=n,comp=y
SayanEH	Sayana	pos=n,g=n,c=3,n=p
Cinna	Cid	pos=va,comp=y,f=part
guYjA	guYjA	pos=n,comp=y
kalApEH	kalApa	pos=n,g=m,c=3,n=p
kuYje	kuYja	pos=n,g=m,c=7,n=s
kuYje	kuYja	pos=n,g=m,c=7,n=s
kaTita	kaTay	pos=va,comp=y,f=part
Sabara	Sabara	pos=n,comp=y
dvandva	dvaMdva	pos=n,comp=y
lIlAyitAni	lIlAy	pos=va,g=n,c=2,n=p,f=part

# id = Kokila.1.32
tatratyAH	tatratya	pos=a,g=m,c=1,n=p
tvA	tvad	pos=n,g=,c=2,n=s
kusuma	kusuma	pos=n,comp=y
kalikA	kalikA	pos=n,comp=y
SITu	SITu	pos=n,comp=y
DArAm	DArA	pos=n,g=f,c=2,n=s
vamanto	vam	pos=va,g=m,c=1,n=p,f=part
nIranDrezu	nIranDra	pos=a,g=m,c=7,n=p
sKalita	sKal	pos=va,comp=y,f=part
gatayaH	gati	pos=n,g=m,c=1,n=p
nirJarI	nirJarI	pos=n,comp=y
SIkarezu	SIkara	pos=n,g=m,c=7,n=p
vallI	vallI	pos=n,comp=y
qolA	qolA	pos=n,comp=y
vihf	vihf	pos=va,comp=y,f=part
awavI	awavI	pos=n,comp=y
devatA	devatA	pos=n,comp=y
lAlay	lAlay	pos=va,g=m,c=1,n=p,f=krtya
sevizyante	sev	pos=v,p=3,n=p,l=lrt
capala	capala	pos=a,comp=y
camarI	camarI	pos=n,comp=y
bAla	bAla	pos=n,comp=y
BArAH	BAra	pos=n,g=m,c=1,n=p
samIrAH	samIra	pos=n,g=m,c=1,n=p

# id = Kokila.1.33
cumban	cumb	pos=va,g=m,c=1,n=s,f=part
biMba	bimba	pos=n,comp=y
aDaram	aDara	pos=n,g=m,c=2,n=s
iva	iva	pos=i
navam	nava	pos=a,g=m,c=2,n=s
pallavam	pallava	pos=n,g=m,c=2,n=s
SITu	SITu	pos=n,comp=y
garBam	garBa	pos=n,g=m,c=2,n=s
prApta	prAp	pos=va,comp=y,f=part
ASlezaH	ASleza	pos=n,g=m,c=1,n=s
stana	stana	pos=n,g=m,c=7,n=s
iva	iva	pos=i
nave	nava	pos=a,g=m,c=7,n=s
korake	koraka	pos=n,g=m,c=7,n=s
kAma	kAma	pos=n,comp=y
cArI	cArin	pos=a,g=m,c=1,n=s
BoktAsi	Buj	pos=v,p=2,n=s,l=lrt
tvam	tvad	pos=n,g=,c=1,n=s
kam	ka	pos=n,g=m,c=2,n=s
api	api	pos=i
samayam	samaya	pos=n,g=m,c=2,n=s
tatra	tatra	pos=i
mAkanda	mAkanda	pos=n,comp=y
vallIH	vallI	pos=n,g=f,c=2,n=p
kAntA	kAntA	pos=n,comp=y
rAge	rAga	pos=n,g=m,c=7,n=s
sati	as	pos=va,g=m,c=7,n=s,f=part
vikasite	vikas	pos=va,g=m,c=7,n=s,f=part
kaH	ka	pos=n,g=m,c=1,n=s
pumAn	puMs	pos=n,g=m,c=1,n=s
tyaktum	tyaj	pos=vi
Izwe	IS	pos=v,p=3,n=s,l=lat

# id = Kokila.1.34
dazwvA	daMS	pos=vi
caYcvA	caYcu	pos=n,g=f,c=3,n=s
kanaka	kanaka	pos=n,comp=y
kapiSAH	kapiSa	pos=a,g=f,c=2,n=p
maYjarI	maYjarI	pos=n,g=f,c=2,n=p
cUta	cUta	pos=n,comp=y
zaRqAt	zaRqa	pos=n,g=m,c=5,n=s
pakza	pakza	pos=n,comp=y
CAyA	CAyA	pos=n,comp=y
Sabalita	Sabalita	pos=a,comp=y
naBaH	naBas	pos=n,comp=y
BAga	BAga	pos=n,comp=y
mudga	mudga	pos=n,comp=y
tvaram	tvarA	pos=n,g=m,c=2,n=s
tvAm	tvad	pos=n,g=,c=2,n=s
vidyutvantam	vidyutvat	pos=a,g=m,c=2,n=s
nava	nava	pos=a,comp=y
jalaDaram	jalaDara	pos=n,g=m,c=2,n=s
manyamAnAH	man	pos=va,g=m,c=1,n=p,f=part
sa	sa	pos=i
lIlam	lIlA	pos=n,g=n,c=2,n=s
nartizyanti	nft	pos=v,p=3,n=p,l=lrt
priya	priya	pos=a,comp=y
saKEH	saKa	pos=n,g=m,c=8,n=s
calat	cal	pos=va,comp=y,f=part
piYCa	piYCa	pos=n,comp=y
BArAH	BAra	pos=n,g=m,c=1,n=p
mayUrAH	mayUra	pos=n,g=m,c=1,n=p

# id = Kokila.1.35
dfSyA	dfSya	pos=a,g=f,c=1,n=s
dUre	dUra	pos=a,g=n,c=7,n=s
tadanu	tadanu	pos=i
laharI	lahari	pos=n,comp=y
sampat	sampat	pos=va,comp=y,f=part
rAjahaMsA	rAjahaMsa	pos=n,g=f,c=1,n=s
sA	tad	pos=n,g=f,c=1,n=s
kAverI	kAverI	pos=n,g=f,c=1,n=s
madajala	madajala	pos=n,comp=y
JarA	Jara	pos=n,g=f,c=1,n=s
sahya	sahya	pos=n,comp=y
dantAvalasya	dantAvala	pos=n,g=m,c=6,n=s
meGa	meGa	pos=n,comp=y
SyAmaH	SyAma	pos=a,g=m,c=1,n=s
Bujaga	Bujaga	pos=n,comp=y
SayanaH	Sayana	pos=n,g=m,c=1,n=s
medinI	medinI	pos=n,comp=y
hAra	hAra	pos=n,comp=y
yazwyAH	yazwi	pos=n,g=f,c=6,n=s
maDye	maDya	pos=n,g=n,c=7,n=s
yasyA	yad	pos=n,g=f,c=6,n=s
marataka	marataka	pos=n,g=m,c=1,n=s
iva	iva	pos=i
prekzyate	prekz	pos=v,p=3,n=s,l=lat
raNganATaH	raNganATa	pos=n,g=m,c=1,n=s

# id = Kokila.1.36
puRyAn	puRya	pos=a,g=m,c=2,n=p
asyAH	idam	pos=n,g=f,c=6,n=s
tawa	tawa	pos=n,comp=y
Buvi	BU	pos=n,g=f,c=7,n=s
purI	purI	pos=n,comp=y
Karvawa	Karvawa	pos=n,comp=y
grAma	grAma	pos=n,comp=y
rudDAn	ruD	pos=va,g=m,c=2,n=p,f=part
udyAna	udyAna	pos=n,comp=y
dru	dru	pos=n,comp=y
prasava	prasava	pos=n,comp=y
suraBIn	suraBi	pos=a,g=m,c=2,n=p
hosalAn	hosala	pos=n,g=m,c=2,n=p
gAhamAnaH	gAh	pos=va,g=m,c=1,n=s,f=part
lakzmInArAyaRapuram	lakzmInArAyaRapura	pos=n,g=n,c=1,n=s
iti	iti	pos=i
KyAtam	KyA	pos=va,g=n,c=1,n=s,f=part
antaH	antar	pos=i
murAri	murAri	pos=n,g=m,c=6,n=s
prApya	prAp	pos=vi
AvAsam	AvAsa	pos=n,g=m,c=2,n=s
Bava	BU	pos=v,p=2,n=s,l=lot
pika	pika	pos=n,comp=y
pate	pati	pos=n,g=m,c=8,n=s
pAvanAnAm	pAvana	pos=a,g=m,c=6,n=p
purogaH	puroga	pos=a,g=m,c=1,n=s

# id = Kokila.1.37
tatratyAnAm	tatratya	pos=a,g=m,c=6,n=p
rucira	rucira	pos=a,comp=y
cikura	cikura	pos=n,comp=y
nyasta	nyas	pos=va,comp=y,f=part
sOganDikAnAm	sOganDika	pos=n,g=f,c=6,n=p
tAruRya	tAruRya	pos=n,comp=y
Uzma	Uzman	pos=n,comp=y
AYc	AYc	pos=va,comp=y,f=part
kuca	kuca	pos=n,comp=y
tawI	tawI	pos=n,comp=y
vitruw	vitruw	pos=va,comp=y,f=part
kaYcukAnAm	kaYcuka	pos=n,g=f,c=6,n=p
nAsA	nAsA	pos=n,comp=y
muktA	muktA	pos=n,comp=y
ABaraRa	ABaraRa	pos=n,comp=y
kiraRa	kiraRa	pos=n,comp=y
unmiSra	unmiSra	pos=a,comp=y
manda	manda	pos=a,comp=y
smitAnAm	smita	pos=n,g=f,c=6,n=p
veSa	veSa	pos=n,comp=y
strIRAm	strI	pos=n,g=f,c=6,n=p
Bavati	BU	pos=v,p=3,n=s,l=lat
vivaSo	vivaSa	pos=a,g=m,c=1,n=s
viBramEH	viBrama	pos=n,g=m,c=3,n=p
darpakaH	darpaka	pos=n,g=m,c=1,n=s
'pi	api	pos=i

# id = Kokila.1.38
tAH	tad	pos=n,g=f,c=1,n=p
ced	ced	pos=i
mAna	mAna	pos=n,comp=y
graTita	granT	pos=va,comp=y,f=part
hfdayAH	hfdaya	pos=n,g=f,c=1,n=p
saMnatAn	saMnam	pos=va,g=m,c=2,n=p,f=part
na	na	pos=i
Adriyeran	Adf	pos=v,p=3,n=p,l=vidhilin
kAntAH	kAntA	pos=n,g=f,c=1,n=p
kAntAn	kAnta	pos=a,g=m,c=2,n=p
paraBfta	paraBfta	pos=n,g=m,c=8,n=s
kuhU	kuhU	pos=n,comp=y
kAram	kAra	pos=n,g=m,c=2,n=s
ekam	eka	pos=n,g=m,c=2,n=s
vimuYca	vimuc	pos=v,p=2,n=s,l=lot
santu	as	pos=v,p=3,n=p,l=lot
tras	tras	pos=va,comp=y,f=part
nija	nija	pos=a,comp=y
nija	nija	pos=a,comp=y
vaDU	vaDU	pos=n,comp=y
dos	dos	pos=n,comp=y
latA	latA	pos=n,comp=y
AliNgitAnAm	AliNgay	pos=va,g=f,c=6,n=p,f=part
yUnAm	yuvan	pos=n,g=m,c=6,n=p
Ardra	Ardra	pos=a,comp=y
smita	smita	pos=n,comp=y
sahacarAH	sahacara	pos=n,g=m,c=1,n=p
tve	tvad	pos=n,g=,c=7,n=s
apANga	apANga	pos=n,comp=y
anuzaNgAH	anuzaNga	pos=n,g=m,c=1,n=p

# id = Kokila.1.39
krIqantInAm	krIq	pos=va,g=f,c=6,n=p,f=part
muKarita	muKaray	pos=va,comp=y,f=part
latA	latA	pos=n,comp=y
mandiram	mandira	pos=n,g=n,c=2,n=s
KecarIRAm	KecarI	pos=n,g=f,c=6,n=p
BUzA	BUzA	pos=n,comp=y
nAdEH	nAda	pos=n,g=m,c=3,n=p
Buvana	Buvana	pos=n,comp=y
viditam	vid	pos=va,g=m,c=2,n=s,f=part
sahya	sahya	pos=n,comp=y
SElam	SEla	pos=n,g=m,c=2,n=s
SrayeTAH	Sri	pos=v,p=2,n=s,l=vidhilin
kzatra	kzatra	pos=n,comp=y
DvaMsAt	DvaMsa	pos=n,g=m,c=5,n=s
svayam	svayam	pos=i
uparataH	uparam	pos=va,g=m,c=1,n=s,f=part
viprasAtkftya	viprasAtkf	pos=vi
kftsnam	kftsna	pos=a,g=n,c=2,n=s
pfTvI	pfTvI	pos=n,comp=y
cakram	cakra	pos=n,g=n,c=2,n=s
Bfgu	Bfgu	pos=n,comp=y
kula	kula	pos=n,comp=y
patiH	pati	pos=n,g=m,c=1,n=s
yat	yad	pos=n,g=n,c=2,n=s
tawe	tawa	pos=n,g=n,c=7,n=s
saMniDatte	saMniDA	pos=v,p=3,n=s,l=lat

# id = Kokila.1.40
tu	tu	pos=i
aYc	aYc	pos=va,comp=y,f=part
DUmAn	DUma	pos=n,g=m,c=2,n=p
dava	dava	pos=n,comp=y
hutaBuj	hutaBuj	pos=n,g=m,c=2,n=p
jvAla	jvAla	pos=n,comp=y
mAlA	mAlA	pos=n,comp=y
jawAlAn	jawAla	pos=a,g=m,c=2,n=p
valgat	valg	pos=va,comp=y,f=part
BfNgAn	BfNga	pos=n,g=m,c=2,n=p
vana	vana	pos=n,comp=y
viwapin	viwapin	pos=n,g=m,c=2,n=p
BAsurAn	BAsura	pos=a,g=m,c=2,n=p
pallava	pallava	pos=n,comp=y
oGEH	oGa	pos=n,g=m,c=3,n=p
dfzwvA	dfS	pos=vi
dUrAd	dUra	pos=a,g=n,c=5,n=s
uzRa	uzRa	pos=a,comp=y
SItEH	SIta	pos=a,g=m,c=3,n=p
uzRaSItEH	samIra	pos=n,g=m,c=3,n=p
samIrEH	saMdih	pos=va,g=f,c=7,n=s,f=part
saMdigDAyAm	vipad	pos=n,g=f,c=7,n=s
sahasA	sahas	pos=n,g=n,c=3,n=s
AvfttiH	Avftti	pos=n,g=f,c=1,n=s
Artim	Arti	pos=n,g=f,c=2,n=s
sahasAvfttirArtim	hi	pos=i
hi	sU	pos=v,p=3,n=s,l=lat

# id = Kokila.1.41
dfzwvA	dfS	pos=vi
tatra	tatra	pos=i
Amalaka	Amalaka	pos=n,comp=y
DaraRI	DaraRI	pos=n,comp=y
mandiram	mandira	pos=n,g=n,c=2,n=s
SArNgapARim	SArNgapARi	pos=n,g=m,c=2,n=s
tasmAt	tad	pos=n,g=m,c=5,n=s
SElAt	SEla	pos=n,g=m,c=5,n=s
tawam	tawa	pos=n,g=n,c=2,n=s
avataran	avatf	pos=va,g=m,c=1,n=s,f=part
kiMcid	kaScit	pos=n,g=n,c=2,n=s
AkuYcya	AkuYcay	pos=vi
pakzO	pakza	pos=n,g=m,c=2,n=d
kUle	kUla	pos=n,g=n,c=7,n=s
'mBoDeH	amBoDi	pos=n,g=m,c=6,n=s
kramuka	kramuka	pos=n,comp=y
kalilAm	kalila	pos=a,g=f,c=2,n=s
kerala	kerala	pos=n,comp=y
kzoRim	kzoRi	pos=n,g=f,c=2,n=s
agre	agra	pos=n,g=n,c=7,n=s
paSya	paS	pos=v,p=2,n=s,l=lot
sPItAm	sPIta	pos=a,g=f,c=2,n=s
Bfgusuta	Bfgusuta	pos=n,comp=y
Buja	Buja	pos=n,comp=y
a	a	pos=i
vikrama	vikrama	pos=n,comp=y
upakramam	upakrama	pos=n,g=m,c=2,n=s
yA	yad	pos=n,g=f,c=1,n=s

# id = Kokila.1.42
prAp	prAp	pos=va,g=m,c=1,n=s,f=krtya
te	tvad	pos=n,g=,c=6,n=s
yadi	yadi	pos=i
kfta	kf	pos=va,comp=y,f=part
mahaH	maha	pos=n,g=m,c=1,n=s
vANmayI	vANmayI	pos=n,comp=y
tIra	tIra	pos=n,comp=y
vAsI	vAsin	pos=a,g=m,c=1,n=s
devo	deva	pos=n,g=m,c=1,n=s
dakza	dakza	pos=n,comp=y
aDvara	aDvara	pos=n,comp=y
vimaTana	vimaTana	pos=n,comp=y
uqqAmaraH	uqqAmara	pos=a,g=m,c=1,n=s
candracUqaH	candracUqa	pos=n,g=m,c=1,n=s
Aste	As	pos=v,p=3,n=s,l=lat
Sita	SA	pos=va,comp=y,f=part
triSiKa	triSiKa	pos=n,comp=y
SiKayA	SiKA	pos=n,g=f,c=3,n=s
dArukam	dAruka	pos=n,g=m,c=2,n=s
jaGnuzI	han	pos=va,g=f,c=1,n=s,f=part
sA	tad	pos=n,g=f,c=1,n=s
yasya	yad	pos=n,g=m,c=6,n=s
adUre	adUra	pos=n,g=n,c=7,n=s
mfgapati	mfgapati	pos=n,comp=y
SiraH	Siras	pos=n,comp=y
sTA	sTA	pos=va,g=f,c=1,n=s,f=part
BadrakAlI	BadrakAlI	pos=n,g=f,c=1,n=s

# id = Kokila.1.43
siktaH	sic	pos=va,g=m,c=1,n=s,f=part
su	su	pos=i
acCEH	acCa	pos=a,g=m,c=3,n=p
Jara	Jara	pos=n,comp=y
jala	jala	pos=n,comp=y
kaREH	kaRa	pos=n,g=m,c=3,n=p
tam	tad	pos=n,g=m,c=2,n=s
Baja	Baj	pos=v,p=2,n=s,l=lot
vyomni	vyoman	pos=n,g=m,c=7,n=s
tizWan	sTA	pos=va,g=m,c=1,n=s,f=part
DvANkza	DvANkza	pos=n,comp=y
BrAntyA	BrAnti	pos=n,g=f,c=3,n=s
yadi	yadi	pos=i
parijanAH	parijana	pos=n,g=m,c=1,n=p
tvA	tvad	pos=n,g=,c=2,n=s
samutsArayeran	samutsAray	pos=v,p=3,n=p,l=vidhilin
kUjAm	kUjA	pos=n,g=f,c=2,n=s
kiMcit	kaScit	pos=n,g=n,c=2,n=s
kuru	kf	pos=v,p=2,n=s,l=lot
nanu	nanu	pos=i
girA	gir	pos=n,g=f,c=3,n=s
vyajyate	vyaYj	pos=v,p=3,n=s,l=lat
san	as	pos=va,g=m,c=1,n=s,f=part
asan	asat	pos=a,g=m,c=1,n=s
ca	ca	pos=i

# id = Kokila.1.44
itTam	itTam	pos=i
BaktyA	Bakti	pos=n,g=f,c=3,n=s
pura	pura	pos=n,comp=y
maTanam	maTana	pos=a,g=m,c=2,n=s
ArADya	ArADay	pos=vi
labDa	laB	pos=va,comp=y,f=part
prasAdaH	prasAda	pos=n,g=m,c=1,n=s
kfzwaH	kfz	pos=va,g=m,c=1,n=s,f=part
kfzwaH	kfz	pos=va,g=m,c=1,n=s,f=part
paTi	paTin	pos=n,g=,c=7,n=s
paTi	paTin	pos=n,g=,c=7,n=s
saKe	saKi	pos=n,g=,c=8,n=s
keralInAm	keralI	pos=n,g=f,c=6,n=p
kawAkzEH	kawAkza	pos=n,g=m,c=3,n=p
uccEH	uccEs	pos=i
sODEH	sODa	pos=n,g=m,c=3,n=p
uqu	uqu	pos=n,comp=y
gaRa	gaRa	pos=n,comp=y
gatIH	gati	pos=n,g=f,c=2,n=p
UrDvam	UrDvam	pos=i
utsAray	utsAray	pos=va,g=f,c=2,n=s,f=part
Pulla	Pulla	pos=a,comp=y
ArAmAm	ArAma	pos=n,g=f,c=2,n=s
praviSa	praviS	pos=v,p=2,n=s,l=lot
puralI	puralI	pos=n,comp=y
kzmABft	kzmABft	pos=n,g=m,c=6,n=p
rAjaDAnIm	rAjaDAnI	pos=n,g=f,c=2,n=s

# id = Kokila.1.45
yezAm	yad	pos=n,g=m,c=6,n=p
vaMSe	vaMSa	pos=n,g=m,c=7,n=s
samajani	saMjan	pos=v,p=3,n=s,l=lun
hariScandra	hariScandra	pos=n,comp=y
nAmA	nAman	pos=n,g=m,c=1,n=s
narendraH	narendra	pos=n,g=m,c=1,n=s
pratyApattiH	pratyApatti	pos=n,g=f,c=1,n=s
pataga	pataga	pos=n,g=m,c=8,n=s
yad	yad	pos=n,comp=y
upajYam	upajYA	pos=n,g=n,c=1,n=s
ca	ca	pos=i
kOmArilAnAm	kOmArila	pos=a,g=m,c=6,n=p
yudDe	yudDa	pos=n,g=n,c=7,n=s
yezAm	yad	pos=n,g=m,c=6,n=p
ahita	ahita	pos=a,comp=y
hatyE	hati	pos=n,g=f,c=4,n=s
caRqikA	caRqikA	pos=n,g=f,c=1,n=s
saMniDatte	saMniDA	pos=v,p=3,n=s,l=lat
tezAm	tad	pos=n,g=m,c=6,n=p
ezAm	idam	pos=n,g=m,c=6,n=p
stutizu	stuti	pos=n,g=f,c=7,n=p
na	na	pos=i
Bavet	BU	pos=v,p=3,n=s,l=vidhilin
kasya	ka	pos=n,g=m,c=6,n=s
vaktram	vaktra	pos=n,g=n,c=1,n=s
pavitram	pavitra	pos=n,g=n,c=1,n=s

# id = Kokila.1.46
putrasya	putra	pos=n,g=m,c=6,n=s
asO	adas	pos=n,g=m,c=1,n=s
priya	priya	pos=a,comp=y
saKaH	saKa	pos=n,g=m,c=1,n=s
iti	iti	pos=i
prIti	prIti	pos=n,comp=y
garBEH	garBa	pos=n,g=m,c=3,n=p
kawAkzEH	kawAkza	pos=n,g=m,c=3,n=p
dfzwaH	dfS	pos=va,g=m,c=1,n=s,f=part
tasyAm	tad	pos=n,g=f,c=7,n=s
puri	pur	pos=n,g=f,c=7,n=s
viharatA	vihf	pos=va,g=m,c=3,n=s,f=part
rukmiRI	rukmiRI	pos=n,comp=y
vallaBena	vallaBa	pos=a,g=m,c=3,n=s
tasya	tad	pos=n,g=m,c=6,n=s
eva	eva	pos=i
agre	agra	pos=n,g=n,c=7,n=s
sat	as	pos=va,g=n,c=1,n=s,f=part
ayam	idam	pos=n,g=m,c=1,n=s
abalA	abalA	pos=n,comp=y
lUna	lU	pos=va,comp=y,f=part
sUna	sUna	pos=n,comp=y
pravAle	pravAla	pos=n,g=m,c=7,n=s
bAla	bAla	pos=a,comp=y
udyAne	udyAna	pos=n,g=n,c=7,n=s
kvacana	kvacana	pos=i
viharan	vihf	pos=va,g=m,c=1,n=s,f=part
mArga	mArga	pos=n,comp=y
Kedam	Keda	pos=n,g=m,c=2,n=s
vijahyAH	vihA	pos=v,p=2,n=s,l=vidhilin

# id = Kokila.1.47
keli	keli	pos=n,comp=y
yAna	yAna	pos=n,comp=y
kvaR	kvaR	pos=va,comp=y,f=part
raSanA	raSanA	pos=n,g=f,c=1,n=s
komalAByAm	komala	pos=a,g=n,c=3,n=d
padAByAm	pada	pos=n,g=n,c=3,n=d
AlI	Ali	pos=n,comp=y
hasta	hasta	pos=n,comp=y
arpita	arpay	pos=va,comp=y,f=part
kara	kara	pos=n,comp=y
talA	tala	pos=n,g=f,c=1,n=s
tatra	tatra	pos=i
ced	ced	pos=i
AgatA	Agam	pos=va,g=f,c=1,n=s,f=part
syAt	as	pos=v,p=3,n=s,l=vidhilin
svAtI	svAti	pos=n,g=f,c=1,n=s
nAma	nAma	pos=i
kzitipati	kzitipati	pos=n,comp=y
sutA	sutA	pos=n,g=f,c=1,n=s
sevitum	sev	pos=vi
devam	deva	pos=n,g=m,c=2,n=s
asyAH	idam	pos=n,g=f,c=6,n=s
svEra	svEra	pos=a,comp=y
AlApEH	AlApa	pos=n,g=m,c=3,n=p
te	tvad	pos=n,g=,c=6,n=s
pika	pika	pos=n,g=m,c=8,n=s
girAm	gir	pos=n,g=f,c=6,n=p
kA	ka	pos=n,g=f,c=1,n=s
api	api	pos=i
SikzA	SikzA	pos=n,g=f,c=1,n=s
BavitrI	Bavitf	pos=a,g=f,c=1,n=s

# id = Kokila.1.48
tAm	tad	pos=n,g=f,c=2,n=s
AyAntIm	AyA	pos=va,g=f,c=2,n=s,f=part
stana	stana	pos=n,comp=y
Bara	Bara	pos=n,comp=y
paritras	paritras	pos=va,comp=y,f=part
Bugna	Buj	pos=va,comp=y,f=part
avalagnAm	avalagna	pos=n,g=f,c=2,n=s
sveda	sveda	pos=n,comp=y
Ceda	Ceda	pos=n,comp=y
Curita	Curita	pos=a,comp=y
vadanAm	vadana	pos=n,g=f,c=2,n=s
SroRi	SroRi	pos=n,comp=y
BAreRa	BAra	pos=n,g=m,c=3,n=s
KinnAm	Kid	pos=va,g=f,c=2,n=s,f=part
kiMcid	kaScit	pos=n,g=n,c=2,n=s
caYcU	caYcU	pos=n,comp=y
kalita	kalay	pos=va,comp=y,f=part
kalikA	kalikA	pos=n,comp=y
SITu	SITu	pos=n,comp=y
BAreRa	BAra	pos=n,g=m,c=3,n=s
siYceH	sic	pos=v,p=2,n=s,l=vidhilin
caYcat	caYc	pos=va,comp=y,f=part
cillI	cillI	pos=n,comp=y
calana	calana	pos=n,comp=y
suBagAn	suBaga	pos=a,g=m,c=2,n=p
lapsyase	laB	pos=v,p=2,n=s,l=lrt
'syAH	idam	pos=n,g=f,c=6,n=s
kawAkzAn	kawAkza	pos=n,g=m,c=2,n=p

# id = Kokila.1.49
kaMcid	kaScit	pos=n,g=m,c=2,n=s
kAlam	kAla	pos=n,g=m,c=2,n=s
Duta	DU	pos=va,comp=y,f=part
kisalaya	kisalaya	pos=n,comp=y
AcCAdanam	AcCAdana	pos=n,g=n,c=1,n=s
sa	sa	pos=i
prakampam	prakampa	pos=n,g=n,c=1,n=s
pratyAKyA	pratyAKyA	pos=va,comp=y,f=part
Bramara	Bramara	pos=n,comp=y
taruRI	taruRa	pos=a,g=f,c=1,n=s
maYjarI	maYjarI	pos=n,g=f,c=1,n=s
BujyamAnA	Buj	pos=va,g=f,c=1,n=s,f=part
yAtrA	yAtrA	pos=n,comp=y
udyukte	udyuj	pos=va,g=m,c=7,n=s,f=part
suBaga	suBaga	pos=a,g=m,c=8,n=s
Bavati	BU	pos=v,p=3,n=s,l=lat
vyaYjayet	vyaYjay	pos=v,p=3,n=s,l=vidhilin
Atma	Atman	pos=n,comp=y
sAdam	sAda	pos=n,g=m,c=2,n=s
muktAScyotanmaDurasamizAn	muc	pos=va,g=f,c=1,n=s,f=part
bAzpa	bAzpa	pos=n,comp=y
leSam	leSa	pos=n,g=m,c=2,n=s

# id = Kokila.1.50
diH	diS	pos=n,g=f,c=1,n=s
yA	yA	pos=va,g=f,c=1,n=s,f=krtya
yat	yat	pos=i
api	api	pos=i
Bavato	Bavat	pos=a,g=m,c=6,n=s
dakziRA	dakziRa	pos=a,g=f,c=1,n=s
rakzaRa	rakzaRa	pos=n,comp=y
arTam	arTa	pos=n,g=m,c=2,n=s
mad	mad	pos=n,comp=y
prARAnAm	prARa	pos=n,g=m,c=6,n=p
punaH	punar	pos=i
api	api	pos=i
saKe	saKi	pos=n,g=,c=8,n=s
paScimAm	paScima	pos=a,g=f,c=2,n=s
eva	eva	pos=i
yAyAH	yA	pos=v,p=2,n=s,l=vidhilin
Duta	DU	pos=va,comp=y,f=part
ArAmam	ArAma	pos=n,g=m,c=2,n=s
mukuwa	mukuwa	pos=n,comp=y
tawinI	tawinI	pos=n,comp=y
mArutEH	mAruta	pos=n,g=m,c=3,n=p
tatra	tatra	pos=i
SamBoH	SamBu	pos=n,g=m,c=6,n=s
saMpad	sampad	pos=n,comp=y
grAmam	grAma	pos=n,g=m,c=2,n=s
yadi	yadi	pos=i
na	na	pos=i
Bajase	Baj	pos=v,p=2,n=s,l=lat
janmanA	janman	pos=n,g=n,c=3,n=s
kim	ka	pos=n,g=n,c=1,n=s
Bftena	Bf	pos=va,g=n,c=3,n=s,f=part

# id = Kokila.1.51
sODEH	sODa	pos=n,g=m,c=3,n=p
tuNgEH	tuNga	pos=a,g=m,c=3,n=p
has	has	pos=va,g=n,c=2,n=s,f=part
iva	iva	pos=i
suDA	suDA	pos=n,comp=y
kzAlitEH	kzAlay	pos=va,g=m,c=3,n=p,f=part
rAjatAdrim	rAjatAdri	pos=n,g=m,c=2,n=s
tejorASeH	tejorASi	pos=n,g=m,c=6,n=s
praviSa	praviS	pos=v,p=2,n=s,l=lot
Bavanam	Bavana	pos=n,g=n,c=2,n=s
DUrjaweH	DUrjawi	pos=n,g=m,c=6,n=s
Urjitam	Urjay	pos=va,g=n,c=2,n=s,f=part
tat	tad	pos=n,g=n,c=2,n=s
pArSve	pArSva	pos=n,g=m,c=7,n=s
pArSve	pArSva	pos=n,g=m,c=7,n=s
parici	parici	pos=va,comp=y,f=part
namaskAra	namaskAra	pos=n,comp=y
jAta	jan	pos=va,comp=y,f=part
SramAnAm	Srama	pos=n,g=m,c=6,n=p
kzmA	kzmA	pos=n,comp=y
devAnAm	deva	pos=n,g=m,c=6,n=p
kzaRam	kzaRa	pos=n,g=m,c=2,n=s
anuBavan	anuBU	pos=va,g=m,c=1,n=s,f=part
tAlavfntasya	tAlavfnta	pos=n,g=n,c=6,n=s
lIlAm	lIlA	pos=n,g=f,c=2,n=s

# id = Kokila.1.52
utkIrRAnAm	utkf	pos=va,g=m,c=6,n=p,f=part
kanaka	kanaka	pos=n,comp=y
valaBIzu	valaBi	pos=n,g=f,c=7,n=p
udgataH	udgam	pos=va,g=m,c=1,n=s,f=part
vizkirARAm	vizkira	pos=n,g=m,c=6,n=p
tyakta	tyaj	pos=va,comp=y,f=part
ASaNkam	ASaNkA	pos=n,g=m,c=2,n=s
praRama	praRam	pos=v,p=2,n=s,l=lot
giriSam	giriSa	pos=n,g=m,c=2,n=s
DyAna	DyAna	pos=n,comp=y
nizkampa	nizkampa	pos=a,comp=y
gAtraH	gAtra	pos=n,g=m,c=1,n=s
kaRWa	kaRWa	pos=n,comp=y
CAyA	CAyA	pos=n,g=f,c=1,n=s
pratiPalati	pratiPal	pos=v,p=3,n=s,l=lat
kim	kim	pos=i
BartuH	Bartf	pos=n,g=m,c=6,n=s
iti	iti	pos=i
adri	adri	pos=n,comp=y
putryA	putrI	pos=n,g=f,c=3,n=s
niDyAtaH	niDyA	pos=va,g=m,c=1,n=s,f=part
san	as	pos=va,g=m,c=1,n=s,f=part
kutuka	kutuka	pos=n,comp=y
niBftEH	niBfta	pos=a,g=m,c=3,n=p
netra	netra	pos=n,comp=y
pAtEH	pAta	pos=n,g=m,c=3,n=p
pavitrEH	pavitra	pos=a,g=m,c=3,n=p

# id = Kokila.1.53
SrI	SrI	pos=n,comp=y
nandi	nandin	pos=n,comp=y
BrU	BrU	pos=n,comp=y
niyamay	niyamay	pos=va,comp=y,f=part
miTas	miTas	pos=i
roDam	roDa	pos=n,g=m,c=2,n=s
AbadDa	AbanD	pos=va,comp=y,f=part
sevA	sevA	pos=n,g=m,c=2,n=p
brahma	brahman	pos=n,comp=y
indra	indra	pos=n,comp=y
AdyAn	Adya	pos=a,g=m,c=2,n=p
kvacana	kvacana	pos=i
vibuDAn	vibuDa	pos=n,g=m,c=2,n=p
sAdaram	sAdara	pos=a,g=n,c=2,n=s
vIkzamARaH	vIkz	pos=va,g=m,c=1,n=s,f=part
gAyantInAm	gA	pos=va,g=f,c=6,n=p,f=part
kvacid	kvacid	pos=i
api	api	pos=i
saKe	saKi	pos=n,g=,c=8,n=s
komalAn	komala	pos=a,g=m,c=2,n=p
kinnarIRAm	kiMnarI	pos=n,g=f,c=6,n=p
vIRA	vIRA	pos=n,comp=y
rAvAn	rAva	pos=n,g=m,c=2,n=p
upaSfRu	upaSru	pos=v,p=2,n=s,l=lot
Bavat	Bavat	pos=a,comp=y
kUjitena	kUjita	pos=n,g=n,c=3,n=s
a	a	pos=i
viSizwAn	viSiz	pos=va,g=m,c=2,n=p,f=part

# id = Kokila.1.54
divya	divya	pos=a,comp=y
ESvaryam	ESvarya	pos=n,g=n,c=2,n=s
diSasi	diS	pos=v,p=2,n=s,l=lat
BajatAm	Baj	pos=va,g=m,c=6,n=p,f=part
vartase	vft	pos=v,p=2,n=s,l=lat
BikzamARo	Bikz	pos=va,g=m,c=1,n=s,f=part
gOryam	gOrI	pos=n,g=f,c=2,n=s
aNke	aNka	pos=n,g=m,c=7,n=s
vahasi	vah	pos=v,p=2,n=s,l=lat
Basitam	Basita	pos=n,g=n,c=2,n=s
paYcabARam	paYcabARa	pos=n,g=m,c=2,n=s
cakarTa	kf	pos=v,p=2,n=s,l=lit
kftsnam	kftsna	pos=a,g=n,c=2,n=s
vyApya	vyAp	pos=vi
sPurasi	sPur	pos=v,p=2,n=s,l=lat
Buvanam	Buvana	pos=n,g=n,c=2,n=s
mfgyase	mfgay	pos=v,p=2,n=s,l=lat
ca	ca	pos=i
Agama	Agama	pos=n,comp=y
antEH	anta	pos=n,g=m,c=3,n=p
kaH	ka	pos=n,g=m,c=1,n=s
te	tvad	pos=n,g=,c=6,n=s
tattvam	tattva	pos=n,g=n,c=2,n=s
praBavati	praBU	pos=v,p=3,n=s,l=lat
paricCettum	paricCid	pos=vi
AScarya	AScarya	pos=a,comp=y
sinDo	sinDu	pos=n,g=m,c=8,n=s

# id = Kokila.1.55
itTam	itTam	pos=i
stutvA	stu	pos=vi
bahis	bahis	pos=i
upavana	upavana	pos=n,comp=y
upAnta	upAnta	pos=n,comp=y
mAkanda	mAkanda	pos=n,comp=y
SfNge	SfNga	pos=n,g=n,c=7,n=s
yAvat	yAvat	pos=i
BAnuH	BAnu	pos=n,g=m,c=1,n=s
vrajati	vraj	pos=v,p=3,n=s,l=lat
caramam	carama	pos=a,g=m,c=2,n=s
BUDaram	BUDara	pos=n,g=m,c=2,n=s
tAvat	tAvat	pos=i
Assva	As	pos=v,p=2,n=s,l=lot
drakzyasy	dfS	pos=v,p=2,n=s,l=lrt
tARqavAni	tARqava	pos=n,g=n,c=2,n=p
indumOleH	indumOli	pos=n,g=m,c=6,n=s
lAsya	lAsya	pos=n,comp=y
krIqA	krIqA	pos=n,comp=y
lalita	lal	pos=va,comp=y,f=part
girijA	girijA	pos=n,comp=y
apANga	apANga	pos=n,comp=y
saMBAvitAni	samBAvay	pos=va,g=n,c=2,n=p,f=part

# id = Kokila.1.56
tasmin	tad	pos=n,g=m,c=7,n=s
kAle	kAla	pos=n,g=m,c=7,n=s
bali	bali	pos=n,comp=y
maha	maha	pos=n,comp=y
juzAm	juz	pos=a,g=m,c=6,n=p
vAra	vAra	pos=n,comp=y
vAma	vAma	pos=a,comp=y
alakAnAm	alaka	pos=n,g=m,c=6,n=p
sTAlI	sTAlI	pos=n,comp=y
cakre	cakra	pos=n,g=n,c=7,n=s
stana	stana	pos=n,comp=y
tawa	tawa	pos=n,comp=y
Dfte	Df	pos=va,g=n,c=7,n=s,f=part
sa	sa	pos=i
anurAge	anurAga	pos=n,g=n,c=7,n=s
hfdi	hfd	pos=n,g=n,c=7,n=s
iva	iva	pos=i
biMba	bimba	pos=n,comp=y
vyAjAt	vyAja	pos=n,g=m,c=5,n=s
viSati	viS	pos=v,p=3,n=s,l=lat
Bavati	BU	pos=v,p=3,n=s,l=lat
syAt	as	pos=v,p=3,n=s,l=vidhilin
amuzya	adas	pos=n,g=m,c=6,n=s
iti	iti	pos=i
SaNke	SaNk	pos=v,p=1,n=s,l=lat
spazwa	paS	pos=va,comp=y,f=part
aNkasya	aNka	pos=n,g=m,c=6,n=s
kzaRam	kzaRa	pos=n,g=m,c=2,n=s
udaya	udaya	pos=n,comp=y
gasya	ga	pos=a,g=m,c=6,n=s
indu	indu	pos=n,comp=y
bimbasya	bimba	pos=n,g=m,c=6,n=s
lakzmIH	lakzmI	pos=n,g=f,c=1,n=s

# id = Kokila.1.57
vizvak	vizvaYc	pos=a,comp=y
kIrREH	kf	pos=va,g=m,c=3,n=p,f=part
iva	iva	pos=i
paSupateH	paSupati	pos=n,g=m,c=6,n=s
kaMDara	kaMDara	pos=n,comp=y
kAnti	kAnti	pos=n,comp=y
puYjEH	puYja	pos=n,g=m,c=3,n=p
vIta	vI	pos=va,comp=y,f=part
Aloke	Aloka	pos=n,g=n,c=7,n=s
jagati	jagant	pos=n,g=n,c=7,n=s
timirEH	timira	pos=a,g=n,c=3,n=p
vyoma	vyoman	pos=n,comp=y
nIlAbja	nIlAbja	pos=n,comp=y
BfNgEH	BfNga	pos=n,g=m,c=3,n=p
viSrAntaH	viSram	pos=va,g=m,c=1,n=s,f=part
san	as	pos=va,g=m,c=1,n=s,f=part
kvacana	kvacana	pos=i
vipule	vipula	pos=a,g=n,c=7,n=s
vfkza	vfkza	pos=n,comp=y
SAKA	SAKA	pos=n,comp=y
kuwumbe	kuwumba	pos=n,g=n,c=7,n=s
tAm	tad	pos=n,g=f,c=2,n=s
tatra	tatra	pos=i
eva	eva	pos=i
kzapaya	kzapay	pos=v,p=2,n=s,l=lot
rajanIm	rajanI	pos=n,g=f,c=2,n=s
SrAnta	Sram	pos=va,comp=y,f=part
visrasta	visraMs	pos=va,comp=y,f=part
pakzaH	pakza	pos=n,g=m,c=1,n=s

# id = Kokila.1.58
velA	velA	pos=n,comp=y
vAtAH	vAta	pos=n,g=m,c=1,n=p
carama	carama	pos=a,comp=y
jalaDeH	jalaDi	pos=n,g=m,c=6,n=s
vIcim	vIci	pos=n,g=m,c=2,n=s
AndolayantaH	Andolay	pos=va,g=m,c=1,n=p,f=part
stoka	stoka	pos=n,comp=y
unnidrEH	unnidra	pos=a,g=m,c=3,n=p
kumuda	kumuda	pos=n,comp=y
mukulEH	mukula	pos=n,g=m,c=3,n=p
pIta	pA	pos=va,comp=y,f=part
muktavantaH	muc	pos=va,g=m,c=1,n=p,f=part
sarassu	saras	pos=n,g=n,c=7,n=p
sveda	sveda	pos=n,comp=y
aNkUrAn	aNkUra	pos=n,g=m,c=2,n=p
surata	surata	pos=n,comp=y
janitAn	janay	pos=va,g=m,c=2,n=p,f=part
suBruvAm	suBrU	pos=n,g=f,c=7,n=s
corayantaH	coray	pos=va,g=m,c=1,n=p,f=part
sevizyante	sev	pos=v,p=3,n=p,l=lrt
niSi	niS	pos=n,g=f,c=7,n=s
paraBfta	paraBfta	pos=n,g=m,c=8,n=s
tvAm	tvad	pos=n,g=,c=2,n=s
suKena	suKena	pos=i
prasuptam	prasvap	pos=va,g=m,c=2,n=s,f=part

# id = Kokila.1.59
prApta	prAp	pos=va,comp=y,f=part
unmeze	unmeza	pos=n,g=m,c=7,n=s
praTama	praTama	pos=a,comp=y
SiKari	SiKarin	pos=n,comp=y
prasTa	prasTa	pos=n,comp=y
dAva	dAva	pos=n,comp=y
agni	agni	pos=n,comp=y
kalpe	kalpa	pos=a,g=m,c=7,n=s
bAla	bAla	pos=a,comp=y
aSoka	aSoka	pos=n,comp=y
stabaka	stabaka	pos=n,comp=y
rucire	rucira	pos=a,g=m,c=7,n=s
BAnavIye	BAnavIya	pos=a,g=m,c=7,n=s
mayUKe	mayUKa	pos=n,g=m,c=7,n=s
prasTAtum	prasTA	pos=vi
tvam	tvad	pos=n,g=,c=1,n=s
punaH	punar	pos=i
api	api	pos=i
saKe	saKi	pos=n,g=,c=8,n=s
prakrameTAH	prakram	pos=v,p=2,n=s,l=vidhilin
praBAte	praBAta	pos=n,g=n,c=7,n=s
sva	sva	pos=a,comp=y
Atma	Atman	pos=n,comp=y
kleSaH	kleSa	pos=n,g=m,c=1,n=s
suhfd	suhfd	pos=n,comp=y
upakftO	upakfti	pos=n,g=f,c=7,n=s
tvAdfSAnAm	tvAdfSa	pos=a,g=m,c=6,n=p
suKAya	suKa	pos=n,g=n,c=4,n=s

# id = Kokila.1.60
padma	padma	pos=n,comp=y
upAntAt	upAnta	pos=n,g=n,c=5,n=s
uzasi	uzas	pos=n,g=f,c=7,n=s
ramaRe	ramaRa	pos=n,g=m,c=7,n=s
prAp	prAp	pos=va,g=m,c=7,n=s,f=part
eva	eva	pos=i
pArSvam	pArSva	pos=n,g=m,c=2,n=s
maDye	maDya	pos=n,g=n,c=7,n=s
mAra	mAra	pos=n,comp=y
jvara	jvara	pos=n,comp=y
paravaSAm	paravaSa	pos=a,g=f,c=2,n=s
vIkzamARo	vIkz	pos=va,g=m,c=1,n=s,f=part
raTANgIm	raTANgI	pos=n,g=f,c=2,n=s
dUram	dUram	pos=i
prApte	prAp	pos=va,g=m,c=7,n=s,f=part
mayi	mad	pos=n,g=,c=7,n=s
viDi	viDi	pos=n,comp=y
vaSAt	vaSa	pos=n,g=m,c=5,n=s
du	du	pos=va,g=f,c=2,n=s,f=part
saKIm	saKI	pos=n,g=f,c=2,n=s
te	tvad	pos=n,g=,c=6,n=s
smAram	smf	pos=vi
smAram	smf	pos=vi
dviguRa	dviguRa	pos=a,comp=y
gamana	gamana	pos=n,comp=y
utsAhaH	utsAha	pos=n,g=m,c=1,n=s
eva	eva	pos=i
Druvam	Druvam	pos=i
syAH	as	pos=v,p=2,n=s,l=vidhilin

# id = Kokila.1.61
dfzwvA	dfS	pos=vi
devam	deva	pos=n,g=m,c=2,n=s
parisara	parisara	pos=n,comp=y
juH	juz	pos=a,g=m,c=2,n=s
Sambare	Sambara	pos=n,g=m,c=7,n=s
bAlakfzRam	bAlakfzRa	pos=n,g=m,c=2,n=s
lopAmudrA	lopAmudrA	pos=n,comp=y
saKa	saKa	pos=n,comp=y
tilakitam	tilakita	pos=a,g=m,c=2,n=s
diNmuKam	diNmuKa	pos=n,g=n,c=2,n=s
BUzayizyan	BUzay	pos=va,g=m,c=1,n=s,f=part
kolAnelAvana	kolAnelAvana	pos=n,comp=y
suraBilAn	suraBila	pos=n,g=m,c=2,n=p
yAhi	yA	pos=v,p=2,n=s,l=lot
yatra	yatra	pos=i
praTante	praT	pos=v,p=3,n=p,l=lat
velA	velA	pos=n,comp=y
atIta	atI	pos=va,comp=y,f=part
praTita	praT	pos=va,comp=y,f=part
vacasaH	vacas	pos=n,g=m,c=1,n=p
SaNkara	SaMkara	pos=n,comp=y
AdyAH	Adya	pos=a,g=m,c=1,n=p
kavi	kavi	pos=n,comp=y
indrAH	indra	pos=n,g=m,c=1,n=p

# id = Kokila.1.62
unmajjadBiH	unmajj	pos=va,g=m,c=3,n=p,f=part
punaH	punar	pos=i
iva	iva	pos=i
javAt	java	pos=n,g=m,c=5,n=s
pakzavat	pakzavat	pos=a,g=m,c=3,n=p
giri	giri	pos=n,comp=y
indrEH	indra	pos=n,g=m,c=3,n=p
vfndEH	vfnda	pos=n,g=n,c=3,n=p
nAvAm	nAvA	pos=n,g=f,c=2,n=s
Buja	Buja	pos=n,comp=y
pawalikA	pawalikA	pos=n,comp=y
uqqAmarEH	uqqAmara	pos=a,g=m,c=3,n=p
gAhyamAnam	gAh	pos=va,g=n,c=2,n=s,f=part
Sayana	Sayana	pos=n,comp=y
sadanam	sadana	pos=n,g=n,c=2,n=s
puzpa	puzpa	pos=n,comp=y
vAwam	vAwa	pos=n,g=m,c=2,n=s
purAreH	purAri	pos=n,g=m,c=6,n=s
pAkasTAnam	pAkasTAna	pos=n,g=n,c=2,n=s
niKila	niKila	pos=a,comp=y
marutAm	marut	pos=n,g=m,c=6,n=p
paSya	paS	pos=v,p=2,n=s,l=lot
vArAn	vAra	pos=n,g=m,c=2,n=p
niDAnam	niDAna	pos=n,g=n,c=2,n=s

# id = Kokila.1.63
muktA	muktA	pos=n,comp=y
jAlEH	jAla	pos=n,g=n,c=3,n=p
Davala	Davala	pos=a,comp=y
pulinam	pulina	pos=n,g=n,c=2,n=s
vIci	vIci	pos=n,comp=y
mAlA	mAlA	pos=n,comp=y
vikIrREH	vikf	pos=va,g=n,c=3,n=p,f=part
kUla	kUla	pos=n,comp=y
aDvAnam	aDvan	pos=n,g=m,c=2,n=s
kusumita	kusumita	pos=a,comp=y
taru	taru	pos=n,comp=y
snigDam	snigDa	pos=a,g=n,c=2,n=s
Alamb	Alamb	pos=va,g=m,c=1,n=s,f=part
deSAt	deSa	pos=n,g=m,c=5,n=s
deSam	deSa	pos=n,g=m,c=2,n=s
vrajasi	vraj	pos=v,p=2,n=s,l=lat
kutuka	kutuka	pos=n,comp=y
uttAna	uttAna	pos=a,comp=y
mUQa	muh	pos=va,comp=y,f=part
AnanAnAm	Anana	pos=n,g=f,c=6,n=p
vAma	vAma	pos=a,comp=y
akzAnAm	akza	pos=a,g=f,c=6,n=p
nayana	nayana	pos=n,comp=y
culakEH	culaka	pos=n,g=n,c=3,n=p
sAdaram	sAdara	pos=a,g=n,c=2,n=s
pIyamAnaH	pA	pos=va,g=m,c=1,n=s,f=part

# id = Kokila.1.64
kuryAt	kf	pos=v,p=3,n=s,l=vidhilin
prItim	prIti	pos=n,g=f,c=2,n=s
tava	tvad	pos=n,g=,c=6,n=s
nayanayoH	nayana	pos=n,g=n,c=6,n=d
kukkuwakroqa	kukkuwakroqa	pos=n,comp=y
nAma	nAman	pos=n,g=n,c=1,n=s
prAsAda	prAsAda	pos=n,comp=y
agra	agra	pos=n,comp=y
ulliK	ulliK	pos=va,comp=y,f=part
gaganam	gagana	pos=n,g=n,c=1,n=s
pattanam	pattana	pos=n,g=n,c=1,n=s
tat	tad	pos=n,g=n,c=1,n=s
pratItam	pratI	pos=va,g=n,c=1,n=s,f=part
yad	yad	pos=n,g=n,c=2,n=s
dos	dos	pos=n,comp=y
vIrya	vIrya	pos=n,comp=y
draQiman	draQiman	pos=n,comp=y
karadIBUta	karadIBUta	pos=n,comp=y
rAjanya	rAjanya	pos=n,comp=y
vIrAH	vIra	pos=n,g=m,c=1,n=p
SUra	SUra	pos=n,comp=y
agraRI	agraRI	pos=n,g=f,c=1,n=p
SiKari	SiKarin	pos=n,comp=y
jalaDi	jalaDi	pos=n,comp=y
svAmin	svAmin	pos=n,g=m,c=1,n=p
pAlayanti	pAlay	pos=v,p=3,n=p,l=lat

# id = Kokila.1.65
gehe	geha	pos=n,g=n,c=7,n=s
gehe	geha	pos=n,g=n,c=7,n=s
nava	nava	pos=a,comp=y
nava	nava	pos=a,comp=y
suDA	suDA	pos=n,comp=y
kzAlitam	kzAlay	pos=va,g=n,c=1,n=s,f=part
yatra	yatra	pos=i
sODam	sODa	pos=n,g=n,c=1,n=s
sODe	sODa	pos=n,g=n,c=7,n=s
sODe	sODa	pos=n,g=n,c=7,n=s
suraBi	suraBi	pos=a,comp=y
kusumEH	kusuma	pos=n,g=n,c=3,n=p
kalpitam	kalpay	pos=va,g=n,c=1,n=s,f=part
keli	keli	pos=n,comp=y
talpam	talpa	pos=n,g=n,c=1,n=s
talpe	talpa	pos=n,g=m,c=7,n=s
talpe	talpa	pos=n,g=m,c=7,n=s
rasa	rasa	pos=n,comp=y
paravaSam	paravaSa	pos=a,g=n,c=1,n=s
kAminI	kAminI	pos=n,comp=y
kAnta	kAnta	pos=n,comp=y
yugmam	yugma	pos=n,g=n,c=1,n=s
yugme	yugma	pos=n,g=n,c=7,n=s
yugme	yugma	pos=n,g=n,c=7,n=s
sa	tad	pos=n,g=m,c=1,n=s
Kalu	Kalu	pos=i
viharan	vihf	pos=va,g=m,c=1,n=s,f=part
viSva	viSva	pos=n,comp=y
vIraH	vIra	pos=n,g=m,c=1,n=s
manoBUH	manoBU	pos=n,g=m,c=1,n=s

# id = Kokila.1.66
vyarTam	vyarTa	pos=a,g=n,c=1,n=s
karRe	karRa	pos=n,g=m,c=7,n=s
nava	nava	pos=a,comp=y
kuvalayam	kuvalaya	pos=n,g=n,c=1,n=s
vidyamAne	vid	pos=va,g=m,c=7,n=s,f=part
kawAkze	kawAkza	pos=n,g=m,c=7,n=s
BAro	BAra	pos=n,g=m,c=1,n=s
hAraH	hAra	pos=n,g=m,c=1,n=s
stana	stana	pos=n,comp=y
kalaSayoH	kalaSa	pos=n,g=n,c=6,n=d
BAsure	BAsura	pos=a,g=m,c=7,n=s
manda	manda	pos=a,comp=y
hAse	hAsa	pos=n,g=m,c=7,n=s
yatra	yatra	pos=i
snigDezu	snigDa	pos=a,g=m,c=7,n=p
api	api	pos=i
mad	mad	pos=va,comp=y,f=part
BfNge	BfNga	pos=n,g=m,c=7,n=s
mAdyadBfNge	as	pos=va,g=m,c=7,n=s,f=part
sati	parimala	pos=n,g=m,c=7,n=s
parimale	maNgala	pos=n,g=n,c=4,n=s
maNgalAya	prasUna	pos=n,g=n,c=1,n=s

# id = Kokila.1.67
yatra	yatra	pos=i
jYAtvA	jYA	pos=vi
kfta	kf	pos=va,comp=y,f=part
nilayanAm	nilayana	pos=n,g=f,c=2,n=s
indirAm	indirA	pos=n,g=f,c=2,n=s
Atma	Atman	pos=n,comp=y
kanyAm	kanyA	pos=n,g=f,c=2,n=s
manye	man	pos=v,p=1,n=s,l=lat
sneha	sneha	pos=n,comp=y
Akulita	Akulita	pos=a,comp=y
hfdayaH	hfdaya	pos=n,g=m,c=1,n=s
vAhinInAm	vAhinI	pos=n,g=f,c=6,n=p
vivoQA	vivoQf	pos=n,g=m,c=1,n=s
tat	tad	pos=n,g=n,c=2,n=s
tad	tad	pos=n,g=n,c=2,n=s
dvIpa	dvIpa	pos=n,comp=y
antara	antara	pos=a,comp=y
Sata	Sata	pos=n,comp=y
samAnI	samAnI	pos=va,comp=y,f=part
ratna	ratna	pos=n,comp=y
oGa	oGa	pos=n,comp=y
pUrRam	pf	pos=va,g=n,c=2,n=s,f=part
nOkA	nOkA	pos=n,comp=y
jAlam	jAla	pos=n,g=n,c=2,n=s
muhuH	muhur	pos=i
upahf	upahf	pos=va,g=m,c=1,n=s,f=part
vIciBiH	vIci	pos=n,g=m,c=3,n=p
Slizyati	Sliz	pos=v,p=3,n=s,l=lat
iva	iva	pos=i

# id = Kokila.1.68
tad	tad	pos=n,comp=y
sODa	sODa	pos=n,comp=y
agrezu	agra	pos=n,g=n,c=7,n=p
aruRa	aruRa	pos=a,comp=y
dfzad	dfzad	pos=n,g=f,c=6,n=p
sAndra	sAndra	pos=a,comp=y
sindUra	sindUra	pos=n,comp=y
kalpam	kalpa	pos=a,g=m,c=2,n=s
tejaH	tejas	pos=n,comp=y
puYjam	puYja	pos=n,g=m,c=2,n=s
kisalaya	kisalaya	pos=n,comp=y
DiyA	DI	pos=n,g=f,c=3,n=s
carvitum	carv	pos=vi
mA	mA	pos=i
AraBeTAH	AraB	pos=v,p=2,n=s,l=vidhilin
dfzwvA	dfS	pos=vi
vAtAyana	vAtAyana	pos=n,comp=y
vinihitEH	viniDA	pos=va,g=n,c=3,n=p,f=part
locana	locana	pos=n,comp=y
abjEH	abja	pos=n,g=n,c=3,n=p
taruRI	taruRI	pos=n,g=f,c=1,n=p
valgat	valg	pos=va,comp=y,f=part
vakzoruham	vakzoruha	pos=n,g=n,c=2,n=s
upacitEH	upaci	pos=va,g=m,c=3,n=p,f=part
hasta	hasta	pos=n,comp=y
tAlEH	tAla	pos=n,g=m,c=3,n=p
haseyuH	has	pos=v,p=3,n=p,l=vidhilin

# id = Kokila.1.69
kfzwvA	kfz	pos=vi
dfzwim	dfzwi	pos=n,g=f,c=2,n=s
kaTam	kaTam	pos=i
api	api	pos=i
tataH	tatas	pos=i
kOtukAnAm	kOtuka	pos=n,g=n,c=6,n=p
nidAnAd	nidAna	pos=n,g=n,c=5,n=s
uqqIyeTAH	uqqIy	pos=v,p=2,n=s,l=vidhilin
paTi	paTin	pos=n,g=,c=7,n=s
viwapinAm	viwapin	pos=n,g=m,c=6,n=p
puzpa	puzpa	pos=n,comp=y
mADvIm	mADvI	pos=n,g=f,c=2,n=s
lihAnaH	lih	pos=va,g=m,c=1,n=s,f=part
hAram	hAra	pos=n,g=m,c=2,n=s
hAram	hAra	pos=n,g=m,c=2,n=s
madana	madana	pos=n,comp=y
pftanA	pftanA	pos=n,comp=y
kAhalEH	kAhala	pos=a,g=m,c=3,n=p
kaRWa	kaRWa	pos=n,comp=y
nAdEH	nAda	pos=n,g=m,c=3,n=p
utkaRWAnAm	utkaRWa	pos=a,g=f,c=6,n=p
janapada	janapada	pos=n,comp=y
mfgI	mfgI	pos=n,comp=y
locanAnAm	locana	pos=n,g=f,c=6,n=p
manAMsi	manas	pos=n,g=n,c=2,n=p

# id = Kokila.1.70
brahma	brahman	pos=n,comp=y
aByAsa	aByAsa	pos=n,comp=y
praSamay	praSamay	pos=va,comp=y,f=part
kali	kali	pos=n,g=m,c=2,n=p
prApya	prAp	pos=vi
dIprAn	dIpra	pos=a,g=m,c=2,n=p
prakASAn	prakASa	pos=n,g=m,c=2,n=p
Sveta	Sveta	pos=a,comp=y
araRyam	araRya	pos=n,g=n,c=2,n=s
vraja	vraj	pos=v,p=2,n=s,l=lot
bahu	bahu	pos=a,comp=y
matam	man	pos=va,g=n,c=2,n=s,f=part
DAma	DAman	pos=n,g=n,c=2,n=s
mftyuYjayasya	mftyuMjaya	pos=n,g=m,c=6,n=s
dfzwvA	dfS	pos=vi
dUre	dUra	pos=n,g=n,c=7,n=s
sakft	sakft	pos=i
api	api	pos=i
janA	jana	pos=n,g=m,c=1,n=p
yat	yat	pos=i
na	na	pos=i
paSyanti	dfS	pos=v,p=3,n=p,l=lat
avaSyam	avaSyam	pos=i
mftyunaH	mftyu	pos=n,g=m,c=6,n=s
vaktram	vaktra	pos=n,g=n,c=2,n=s
niwila	niwila	pos=a,comp=y
Gawita	Gaw	pos=va,comp=y,f=part
BrUkuwIkam	BrUkuwIka	pos=n,g=n,c=2,n=s
kadAcit	kadAcid	pos=i

# id = Kokila.1.71
sevyam	sev	pos=va,g=n,c=1,n=s,f=krtya
SamBoH	SamBu	pos=n,g=m,c=6,n=s
aruRam	aruRa	pos=a,g=n,c=1,n=s
urasaH	uras	pos=n,g=n,c=6,n=s
tAqanAt	tAqana	pos=n,g=n,c=5,n=s
daRqapAReH	daRqapARi	pos=n,g=m,c=6,n=s
pAda	pAda	pos=n,comp=y
amBojam	amBoja	pos=n,g=n,c=1,n=s
SiKari	SiKarin	pos=n,comp=y
tanayA	tanayA	pos=n,comp=y
pARi	pARi	pos=n,comp=y
saMvAha	saMvAha	pos=n,comp=y
yogyam	yogya	pos=a,g=n,c=1,n=s
yena	yad	pos=n,g=n,c=3,n=s
AkrAnte	Akram	pos=va,g=m,c=7,n=s,f=part
sati	as	pos=va,g=m,c=7,n=s,f=part
giripatO	giripati	pos=n,g=m,c=7,n=s
cakranda	krand	pos=v,p=3,n=s,l=lit
aDas	aDas	pos=i
kfta	kf	pos=va,comp=y,f=part
Buja	Buja	pos=n,comp=y
vanaH	vana	pos=n,g=m,c=1,n=s
cakrandADaHkftaBujavano	rakzas	pos=n,g=n,c=6,n=p
rakzasAm	cakravartin	pos=n,g=m,c=1,n=s

# id = Kokila.1.72
pArSve	pArSva	pos=n,g=m,c=7,n=s
yasya	yad	pos=n,g=m,c=6,n=s
pravahati	pravah	pos=v,p=3,n=s,l=lat
nilA	nAma	pos=i
nAma	kallolinI	pos=n,g=f,c=1,n=s
kallolinI	tad	pos=n,g=f,c=1,n=s
saMDyA	saMDyA	pos=n,comp=y
nftta	nftta	pos=n,comp=y
BramIzu	Brami	pos=n,g=f,c=7,n=p
sanDyAnfttaBramizu	pat	pos=va,g=f,c=1,n=s,f=part
mastakAt	mastaka	pos=n,g=n,c=5,n=s
jAhnavI	jAhnavI	pos=n,g=f,c=1,n=s
iva	iva	pos=i
nAvA	nAvA	pos=n,comp=y
kzetra	kzetra	pos=n,comp=y
praRayin	praRayin	pos=a,g=n,c=1,n=s
ramayA	ramA	pos=n,g=f,c=3,n=s
AkrAnta	Akram	pos=va,comp=y,f=part
dos	dos	pos=n,comp=y
maDyam	maDya	pos=n,g=n,c=2,n=s
Aste	As	pos=v,p=3,n=s,l=lat
kUle	kUla	pos=n,g=n,c=7,n=s
yasyAH	yad	pos=n,g=f,c=6,n=s
kuvalaya	kuvalaya	pos=n,comp=y
dala	dala	pos=n,comp=y
SyAmalam	SyAmala	pos=a,g=n,c=1,n=s
DAma	DAman	pos=n,g=n,c=1,n=s
kiMcit	kaScit	pos=n,g=n,c=1,n=s

# id = Kokila.1.73
sAkam	sAkam	pos=i
kAntEH	kAnta	pos=a,g=m,c=3,n=p
milati	mil	pos=v,p=3,n=s,l=lat
lalitam	lalita	pos=n,g=n,c=1,n=s
keralInAm	keralI	pos=n,g=f,c=6,n=p
kadambe	kadamba	pos=n,g=m,c=7,n=s
mad	mad	pos=n,comp=y
preyasyAH	preyas	pos=a,g=f,c=6,n=s
priya	priya	pos=a,comp=y
saKEH	saKa	pos=n,g=m,c=8,n=s
mahA	mahat	pos=a,comp=y
mAGa	mAGa	pos=n,comp=y
sevA	sevA	pos=n,comp=y
AgatAyAH	Agam	pos=va,g=f,c=6,n=s,f=part
pAyam	pA	pos=vi
pAyam	pA	pos=vi
muKa	muKa	pos=n,comp=y
parimalam	parimala	pos=n,g=m,c=2,n=s
mohanam	mohana	pos=a,g=m,c=2,n=s
yatra	yatra	pos=i
mattAH	mad	pos=va,g=m,c=1,n=p,f=part
prAyo	prAyas	pos=i
adya	adya	pos=i
api	api	pos=i
Bramara	Bramara	pos=n,comp=y
kalaBAH	kalaBa	pos=n,g=m,c=1,n=p
na	na	pos=i
eva	eva	pos=i
jiGranti	GrA	pos=v,p=3,n=p,l=lat
padmAn	padma	pos=n,g=m,c=2,n=p

# id = Kokila.1.74
SEvAla	SEvAla	pos=n,comp=y
oGa	oGa	pos=n,comp=y
Curita	Curita	pos=a,comp=y
kamalA	kamala	pos=n,g=f,c=1,n=s
sEkata	sEkata	pos=n,comp=y
sraMsin	sraMsin	pos=a,comp=y
haMsA	haMsa	pos=n,g=f,c=1,n=s
nItA	nI	pos=va,g=f,c=1,n=s,f=part
kArSyam	kArSya	pos=n,g=n,c=2,n=s
tapana	tapana	pos=n,comp=y
kiraREH	kiraRa	pos=n,g=m,c=3,n=p
vAsarezu	vAsara	pos=n,g=m,c=7,n=p
ezu	idam	pos=n,g=m,c=7,n=p
sinDuH	sinDu	pos=n,g=f,c=1,n=s
AkIrRa	Akf	pos=va,comp=y,f=part
asya	idam	pos=n,g=m,c=6,n=s
Amalaka	Amalaka	pos=n,comp=y
nikarEH	nikara	pos=n,g=m,c=3,n=p
SroRi	SroRi	pos=n,comp=y
viBraMSin	viBraMSin	pos=a,comp=y
kAYcIm	kAYcI	pos=n,g=f,c=2,n=s
manye	man	pos=v,p=1,n=s,l=lat
dInAm	dIna	pos=a,g=f,c=2,n=s
viraha	viraha	pos=n,comp=y
daSayA	daSA	pos=n,g=f,c=3,n=s
preyasIm	preyas	pos=a,g=f,c=2,n=s
me	mad	pos=n,g=,c=6,n=s
'nuyAyAt	anuyA	pos=v,p=3,n=s,l=vidhilin

# id = Kokila.1.75
SAstA	SAstf	pos=n,g=m,c=1,n=s
tasyA	tad	pos=n,g=f,c=6,n=s
yadi	yadi	pos=i
tawa	tawa	pos=n,comp=y
paTEH	paTa	pos=n,g=m,c=3,n=p
Sambara	Sambara	pos=n,comp=y
kroqa	kroqa	pos=n,comp=y
vAsI	vAsin	pos=a,g=m,c=1,n=s
tizWan	sTA	pos=va,g=m,c=1,n=s,f=part
aSve	aSva	pos=n,g=m,c=7,n=s
javini	javin	pos=a,g=m,c=7,n=s
mfgayA	mfgayA	pos=n,comp=y
kOtukI	kOtukin	pos=a,g=m,c=1,n=s
saMcareta	saMcar	pos=v,p=3,n=s,l=vidhilin
lumpeH	lup	pos=v,p=2,n=s,l=vidhilin
tasya	tad	pos=n,g=m,c=6,n=s
Sramajala	Sramajala	pos=n,comp=y
kaRAn	kaRa	pos=n,g=m,c=2,n=p
komalEH	komala	pos=a,g=m,c=3,n=p
pakza	pakza	pos=n,comp=y
vAtEH	vAta	pos=n,g=m,c=3,n=p
BUyAt	BU	pos=v,p=3,n=s,l=ashirlin
prItyE	prIti	pos=n,g=f,c=4,n=s
laGu	laGu	pos=a,g=n,c=1,n=s
ca	ca	pos=i
samaye	samaya	pos=n,g=m,c=7,n=s
sevanam	sevana	pos=n,g=n,c=1,n=s
hi	hi	pos=i
praBURAm	praBu	pos=a,g=m,c=6,n=p

# id = Kokila.1.76
sarva	sarva	pos=n,comp=y
utkfzwAH	utkfzwa	pos=a,g=m,c=1,n=p
jagati	jagant	pos=n,g=n,c=7,n=s
viditAH	vid	pos=va,g=m,c=1,n=p,f=part
keralezu	kerala	pos=n,g=m,c=7,n=p
dvijendrA	dvijendra	pos=n,g=m,c=1,n=p
vallIka	vallIka	pos=n,comp=y
oRi	oRi	pos=n,g=f,c=6,n=d
tat	tad	pos=n,g=n,c=1,n=s
api	api	pos=i
mahimA	mahimA	pos=n,g=f,c=1,n=s
kA	ka	pos=n,g=f,c=1,n=s
api	api	pos=i
maDya	maDya	pos=n,comp=y
SritAnAm	Sri	pos=va,g=m,c=6,n=p,f=part
tatra	tatra	pos=i
api	api	pos=i
asyAH	idam	pos=n,g=f,c=6,n=s
salila	salila	pos=n,comp=y
pavanA	pavana	pos=n,g=f,c=1,n=s
yatra	yatra	pos=i
yatra	yatra	pos=i
praTante	praT	pos=v,p=3,n=p,l=lat
tezAm	tad	pos=n,g=m,c=6,n=p
tezAm	tad	pos=n,g=m,c=6,n=p
atiSaya	atiSaya	pos=n,comp=y
juzaH	juz	pos=a,g=m,c=1,n=p
SIla	SIla	pos=n,comp=y
vidyA	vidyA	pos=n,comp=y
anuBAvAH	anuBAva	pos=n,g=m,c=1,n=p

# id = Kokila.1.77
Izwe	IS	pos=v,p=3,n=s,l=lat
tezAm	tad	pos=n,g=m,c=6,n=p
stutizu	stuti	pos=n,g=f,c=7,n=p
na	na	pos=i
guruH	guru	pos=n,g=m,c=1,n=s
kA	ka	pos=n,g=f,c=1,n=s
kaTA	kaTA	pos=n,g=f,c=1,n=s
alpIyas	alpIyas	pos=a,g=m,c=6,n=p
no	mad	pos=n,g=,c=6,n=p
BrAtaH	BrAtf	pos=n,g=m,c=8,n=s
BUyas	BUyas	pos=i
SfRu	Sru	pos=v,p=2,n=s,l=lot
parimitam	parimA	pos=va,g=n,c=1,n=s,f=part
prastu	prastu	pos=va,comp=y,f=part
Adya	Adya	pos=a,comp=y
avaSezam	avaSeza	pos=n,g=m,c=2,n=s
tAm	tad	pos=n,g=f,c=2,n=s
uttIrRaH	uttf	pos=va,g=m,c=1,n=s,f=part
saritam	sarit	pos=n,g=f,c=2,n=s
amfta	amfta	pos=n,comp=y
syandin	syandin	pos=a,comp=y
mAkanda	mAkanda	pos=n,comp=y
vfndAn	vfnda	pos=n,g=m,c=2,n=p
deSAn	deSa	pos=n,g=m,c=2,n=p
pUtAn	pU	pos=va,g=m,c=2,n=p,f=part
pata	pat	pos=v,p=2,n=s,l=lot
guRa	guRa	pos=n,comp=y
gaREH	gaRa	pos=n,g=m,c=3,n=p
netra	netra	pos=n,comp=y
nArAyaRIyEH	nArAyaRIya	pos=a,g=m,c=3,n=p

# id = Kokila.1.78
yaH	yad	pos=n,g=m,c=1,n=s
prAk	prAk	pos=i
pARigrahaRa	pARigrahaRa	pos=n,comp=y
samaye	samaya	pos=n,g=m,c=7,n=s
SamBunA	SamBu	pos=n,g=m,c=3,n=s
sa	sa	pos=i
anukampam	anukampA	pos=n,g=n,c=2,n=s
haste	hasta	pos=n,g=m,c=7,n=s
kftvA	kf	pos=vi
kaTam	kaTam	pos=i
api	api	pos=i
SanEs	SanEs	pos=i
aSma	aSman	pos=n,comp=y
pfzWe	pfzWa	pos=n,g=n,c=7,n=s
nyaDAyi	niDA	pos=v,p=3,n=s,l=lun
drazwavyo	dfS	pos=va,g=m,c=1,n=s,f=krtya
'sO	adas	pos=n,g=m,c=1,n=s
kisalaya	kisalaya	pos=n,comp=y
mfduH	mfdu	pos=a,g=m,c=1,n=s
mukti	mukti	pos=n,comp=y
purI	purI	pos=n,comp=y
AlayAyAH	Alaya	pos=n,g=f,c=6,n=s
kAtyAyanyA	kAtyAyanI	pos=n,g=f,c=6,n=s
mahiza	mahiza	pos=n,comp=y
maTana	maTana	pos=n,comp=y
uqqAmaraH	uqqAmara	pos=a,g=m,c=1,n=s
pAda	pAda	pos=n,comp=y
padmaH	padma	pos=n,g=m,c=1,n=s

# id = Kokila.1.79
kiMcid	kaScit	pos=n,g=n,c=2,n=s
pUrvam	pUrvam	pos=i
raRa	raRa	pos=n,comp=y
Kala	Kala	pos=n,comp=y
Buvi	BU	pos=n,g=f,c=7,n=s
tad	tad	pos=n,comp=y
mImAMsA	mImAMsA	pos=n,comp=y
dvaya	dvaya	pos=n,comp=y
kula	kula	pos=n,comp=y
guroH	guru	pos=n,g=m,c=6,n=s
tanmImAMsAdvayakulaguroH	sadman	pos=n,g=n,c=1,n=s
sadma	puRya	pos=a,g=n,c=1,n=s
mahA	mahat	pos=a,comp=y
fzeH	fzi	pos=n,g=m,c=6,n=s
vidvas	vidvas	pos=a,comp=y
vfnde	vfnda	pos=n,g=n,c=7,n=s
vivaditu	vivaditu	pos=n,comp=y
manas	manas	pos=n,g=m,c=7,n=s
Agate	Agam	pos=va,g=m,c=7,n=s,f=part
yatra	yatra	pos=i
SaSvat	SaSvat	pos=i
vyAKyA	vyAKyA	pos=n,comp=y
SAlA	SAlA	pos=n,comp=y
valaBI	valaBi	pos=n,comp=y
nilayaH	nilaya	pos=n,g=m,c=1,n=s
tizWate	sTA	pos=v,p=3,n=s,l=lat
kIra	kIra	pos=n,comp=y
saMGaH	saMGa	pos=n,g=m,c=1,n=s

# id = Kokila.1.80
SAstra	SAstra	pos=n,comp=y
vyAKyA	vyAKyA	pos=n,g=f,c=1,n=s
hari	hari	pos=n,comp=y
hara	hara	pos=n,comp=y
kaTA	kaTA	pos=n,g=f,c=1,n=s
satkriyA	satkriyA	pos=n,comp=y
aByAgatAnAm	aByAgam	pos=va,g=m,c=6,n=p,f=part
AlApo	AlApa	pos=n,g=m,c=1,n=s
vA	vA	pos=i
yadi	yadi	pos=i
saha	saha	pos=i
buDEH	buDa	pos=a,g=m,c=3,n=p
Akzipet	Akzip	pos=v,p=3,n=s,l=vidhilin
asya	idam	pos=n,g=m,c=6,n=s
cetaH	cetas	pos=n,g=n,c=2,n=s
tad	tad	pos=n,comp=y
viSrabDa	viSramB	pos=va,comp=y,f=part
dvija	dvija	pos=n,comp=y
parivfte	parivf	pos=va,g=m,c=7,n=s,f=part
nizkuwa	nizkuwa	pos=n,comp=y
adrO	adri	pos=n,g=m,c=7,n=s
nizaRRaH	nizad	pos=va,g=m,c=1,n=s,f=part
kokUyeTAH	kokUy	pos=v,p=2,n=s,l=vidhilin
sa	tad	pos=n,g=m,c=1,n=s
Kalu	Kalu	pos=i
maDurAm	maDura	pos=a,g=f,c=2,n=s
sUktim	sUkti	pos=n,g=f,c=2,n=s
AkarRya	AkarRay	pos=vi
tuzyet	tuz	pos=v,p=3,n=s,l=vidhilin

# id = Kokila.1.81
SlAGanIya	SlAG	pos=va,comp=y,f=krtya
Canda	Canda	pos=n,comp=y
sTiti	sTiti	pos=n,g=m,c=2,n=s
ayi	ayi	pos=i
mayA	mad	pos=n,g=,c=3,n=s
SoBane	SoBana	pos=a,g=m,c=7,n=s
'rTe	arTa	pos=n,g=m,c=7,n=s
niyuktam	niyuj	pos=va,g=m,c=2,n=s,f=part
SrAvyam	Sru	pos=va,g=m,c=2,n=s,f=krtya
SabdEH	Sabda	pos=n,g=m,c=3,n=p
sarasa	sarasa	pos=a,comp=y
sumanaH	sumanas	pos=n,comp=y
BAjam	BAj	pos=a,g=m,c=2,n=s
aBra	aBra	pos=n,comp=y
anta	anta	pos=n,comp=y
vftti	vftti	pos=n,g=m,c=2,n=s
dUra	dUra	pos=a,comp=y
prAptyA	prApti	pos=n,g=f,c=3,n=s
praSiTilam	praSiTila	pos=a,g=m,c=2,n=s
iva	iva	pos=i
tvAm	tvad	pos=n,g=,c=2,n=s
saKe	saKi	pos=n,g=,c=8,n=s
kAvya	kAvya	pos=n,comp=y
kalpam	kalpa	pos=a,g=m,c=2,n=s
DImAn	DImat	pos=a,g=m,c=1,n=s
paSyet	paS	pos=v,p=3,n=s,l=vidhilin
sa	tad	pos=n,g=m,c=1,n=s
yadi	yadi	pos=i
nanu	nanu	pos=i
te	tvad	pos=n,g=,c=6,n=s
SudDa	SuD	pos=va,g=m,c=1,n=s,f=part
eva	eva	pos=i
pracAraH	pracAra	pos=n,g=m,c=1,n=s

# id = Kokila.1.82
pArSvAt	pArSva	pos=n,g=n,c=5,n=s
asya	idam	pos=n,g=m,c=6,n=s
pracalitavataH	pracal	pos=va,g=m,c=6,n=s,f=part
pAvanAn	pAvana	pos=a,g=m,c=2,n=p
Ahf	Ahf	pos=va,g=m,c=1,n=p,f=part
kunda	kunda	pos=n,comp=y
su	su	pos=i
acCAn	acCa	pos=a,g=m,c=2,n=p
vfzapati	vfzapati	pos=n,comp=y
muKa	muKa	pos=n,comp=y
Asakta	AsaYj	pos=va,comp=y,f=part
romanTa	romanTa	pos=n,comp=y
PenAn	Pena	pos=n,g=m,c=2,n=p
CindyuH	Cid	pos=v,p=3,n=p,l=vidhilin
tApam	tApa	pos=n,g=m,c=2,n=s
tava	tvad	pos=n,g=,c=6,n=s
vfza	vfza	pos=n,comp=y
purI	purI	pos=n,comp=y
saNginaH	saNgin	pos=a,g=m,c=6,n=s
SaNkara	SaMkara	pos=n,comp=y
aNka	aNka	pos=n,comp=y
krIqat	krIq	pos=va,comp=y,f=part
gOrI	gOrI	pos=n,comp=y
kaca	kaca	pos=n,comp=y
taralana	taralana	pos=n,comp=y
udganDi	udganDi	pos=a,g=m,c=1,n=p
ganDavAhAH	ganDavAha	pos=n,g=m,c=1,n=p

# id = Kokila.1.83
pUrvo	pUrva	pos=n,g=m,c=1,n=s
BAgaH	BAga	pos=n,g=m,c=1,n=s
stana	stana	pos=n,comp=y
Bara	Bara	pos=n,comp=y
nataH	nam	pos=va,g=m,c=1,n=s,f=part
prekzyate	prekz	pos=v,p=3,n=s,l=lat
ced	ced	pos=i
cala	cala	pos=a,comp=y
akzaH	akza	pos=n,g=m,c=1,n=s
paScAt	paScAt	pos=i
BAgaH	BAga	pos=n,g=m,c=1,n=s
lalita	lal	pos=va,comp=y,f=part
cikuraH	cikura	pos=n,g=m,c=1,n=s
dfSyate	dfS	pos=v,p=3,n=s,l=lat
no	mad	pos=n,g=,c=6,n=p
nitambI	nitambin	pos=a,g=m,c=1,n=s
itTam	itTam	pos=i
gOryA	gOrI	pos=n,g=f,c=6,n=s
yugapad	yugapad	pos=i
uBayam	uBaya	pos=a,g=n,c=2,n=s
drazwu	drazwu	pos=n,comp=y
kAmaH	kAma	pos=n,g=m,c=1,n=s
'zwamUrtiH	azwamUrti	pos=n,g=m,c=1,n=s
mUrti	mUrti	pos=n,comp=y
dvandvam	dvaMdva	pos=n,g=n,c=2,n=s
vahati	vah	pos=v,p=3,n=s,l=lat
BagavAn	Bagavant	pos=n,g=m,c=1,n=s
yaH	yad	pos=n,g=m,c=1,n=s
sa	tad	pos=n,g=m,c=1,n=s
muktyE	mukti	pos=n,g=f,c=4,n=s
nizevyaH	nizev	pos=va,g=m,c=1,n=s,f=krtya

# id = Kokila.1.84
BUzA	BUzA	pos=n,comp=y
Bogi	Bogin	pos=n,comp=y
Svasita	Svasita	pos=n,comp=y
pavanEH	pavana	pos=n,g=m,c=3,n=p
PAla	PAla	pos=n,comp=y
netre	netra	pos=n,g=n,c=1,n=d
pradIpte	pradIp	pos=va,g=n,c=1,n=d,f=part
svinnasya	svid	pos=va,g=m,c=6,n=s,f=part
indoH	indu	pos=n,g=m,c=6,n=s
amfta	amfta	pos=n,comp=y
pfzatEH	pfzata	pos=n,g=m,c=3,n=p
Urjitam	Urjay	pos=va,g=n,c=1,n=s,f=part
nirgaladBiH	nirgal	pos=va,g=m,c=3,n=p,f=part
mOlO	mOli	pos=n,g=m,c=7,n=s
yasya	yad	pos=n,g=m,c=6,n=s
druhiRa	druhiRa	pos=n,comp=y
Siras	Siras	pos=n,g=n,c=6,n=p
maRqalam	maRqala	pos=n,g=n,c=1,n=s
maRqapa	maRqapa	pos=n,comp=y
antaH	antar	pos=i
kzmA	kzmA	pos=n,comp=y
devAnAm	deva	pos=n,g=m,c=6,n=p
Sruti	Sruti	pos=n,comp=y
pada	pada	pos=n,comp=y
juzAm	juz	pos=a,g=m,c=6,n=p
saMSayAn	saMSaya	pos=n,g=m,c=2,n=p
ucCinatti	ucCid	pos=v,p=3,n=s,l=lat

# id = Kokila.1.85
dvAra	dvAra	pos=n,comp=y
upAnta	upAnta	pos=n,comp=y
sTiti	sTiti	pos=n,comp=y
kft	kft	pos=a,comp=y
aRima	aRiman	pos=n,comp=y
apANga	apANga	pos=n,comp=y
datta	dA	pos=va,comp=y,f=part
Ih	Ih	pos=va,comp=y,f=part
arTEH	arTa	pos=n,g=m,c=3,n=p
ASApAlEH	ASApAla	pos=n,g=m,c=3,n=p
nibiqita	nibiqita	pos=a,comp=y
bahis	bahis	pos=i
prANgaRam	prANgaRa	pos=n,g=n,c=2,n=s
sevamAnEH	sev	pos=va,g=m,c=3,n=p,f=part
tasya	tad	pos=n,g=m,c=6,n=s
adUre	adUra	pos=n,g=n,c=7,n=s
kanaka	kanaka	pos=n,comp=y
Bavanam	Bavana	pos=n,g=n,c=2,n=s
pakzapAtAt	pakzapAta	pos=n,g=m,c=5,n=s
pravizwaH	praviS	pos=va,g=m,c=1,n=s,f=part
saMpad	sampad	pos=n,comp=y
mUrtim	mUrti	pos=n,g=f,c=2,n=s
praRama	praRam	pos=v,p=2,n=s,l=lot
girijAm	girijA	pos=n,g=f,c=2,n=s
sA	tad	pos=n,g=f,c=1,n=s
hi	hi	pos=i
viSvasya	viSva	pos=n,g=n,c=6,n=s
mAtA	mAtf	pos=n,g=f,c=1,n=s

# id = Kokila.1.86
saMsfp	saMsfp	pos=va,g=m,c=3,n=p,f=part
tanu	tanu	pos=n,comp=y
ruci	ruci	pos=n,comp=y
BarEH	Bara	pos=a,g=m,c=3,n=p
saMgama	saMgama	pos=n,comp=y
grAma	grAma	pos=n,comp=y
SOreH	SOri	pos=n,g=m,c=6,n=s
tApiYCa	tApiYCa	pos=n,comp=y
ABEH	ABa	pos=a,g=m,c=3,n=p
stabakita	stabakita	pos=a,comp=y
talam	tala	pos=n,g=n,c=2,n=s
gAhamAno	gAh	pos=va,g=m,c=1,n=s,f=part
vihAyaH	vihAyas	pos=n,g=n,c=2,n=s
tulya	tulya	pos=a,comp=y
CAyA	CAyA	pos=n,comp=y
smfta	smf	pos=va,comp=y,f=part
nava	nava	pos=a,comp=y
tamAla	tamAla	pos=n,comp=y
AvalI	Avali	pos=n,comp=y
vAsa	vAsa	pos=n,comp=y
sOKyaH	sOKya	pos=n,g=m,c=1,n=s
manye	man	pos=v,p=1,n=s,l=lat
lokEH	loka	pos=n,g=m,c=3,n=p
kzaRam	kzaRa	pos=n,g=m,c=2,n=s
iva	iva	pos=i
pfTak	pfTak	pos=i
naH	mad	pos=n,g=,c=2,n=p
viBAvizyase	tvad	pos=n,g=,c=1,n=s

# id = Kokila.1.87
kAlI	kAlI	pos=n,comp=y
vAsam	vAsa	pos=n,g=m,c=2,n=s
Baja	Baj	pos=v,p=2,n=s,l=lot
paTi	paTin	pos=n,g=,c=7,n=s
mahat	mahat	pos=a,g=n,c=2,n=s
kAnanam	kAnana	pos=n,g=n,c=2,n=s
yatra	yatra	pos=i
SaSvat	SaSvat	pos=i
sevA	sevA	pos=n,comp=y
AyAte	AyA	pos=va,g=m,c=7,n=s,f=part
tridaSa	tridaSa	pos=n,comp=y
nikare	nikara	pos=n,g=m,c=7,n=s
SrAdDadeva	SrAdDadeva	pos=n,comp=y
OpavAhyam	OpavAhya	pos=a,g=n,c=1,n=s
BUteBiH	BUta	pos=n,g=m,c=3,n=p
Bid	Bid	pos=va,g=m,c=1,n=s,f=krtya
bali	bali	pos=n,comp=y
mahizaH	mahiza	pos=n,g=m,c=1,n=s
iti	iti	pos=i
udBawEH	udBawa	pos=a,g=m,c=3,n=p
kfzwa	kfz	pos=va,comp=y,f=part
SfNge	SfNga	pos=n,g=n,c=7,n=s
rajju	rajju	pos=n,comp=y
gfhItvA	grah	pos=vi
rudati	rud	pos=v,p=3,n=s,l=lat
vijayA	vijayA	pos=n,g=f,c=1,n=s
rUQa	ruh	pos=va,comp=y,f=part
hAsam	hAsa	pos=n,g=m,c=2,n=s
ruRadDi	ruD	pos=v,p=3,n=s,l=lat

# id = Kokila.1.88
ramyAm	ramya	pos=a,g=f,c=2,n=s
harmya	harmya	pos=n,comp=y
Dvaja	Dvaja	pos=n,comp=y
pawa	pawa	pos=n,comp=y
marut	marut	pos=n,comp=y
vIjita	vIjay	pos=va,comp=y,f=part
braDna	braDna	pos=n,comp=y
yugyAm	yugya	pos=n,g=f,c=2,n=s
agre	agra	pos=n,g=n,c=7,n=s
paSya	paS	pos=v,p=2,n=s,l=lot
aYjana	aYjana	pos=n,comp=y
Kala	Kala	pos=n,comp=y
purIm	purI	pos=n,g=f,c=2,n=s
ASritAm	ASri	pos=va,g=f,c=2,n=s,f=part
SaNkareRa	SaMkara	pos=n,g=m,c=3,n=s
yatra	yatra	pos=i
ASlizwaH	ASliz	pos=va,g=m,c=1,n=s,f=part
vara	vara	pos=a,comp=y
yuvatiBiH	yuvati	pos=n,g=f,c=3,n=p
cumbati	cumb	pos=v,p=3,n=s,l=lat
svid	svid	pos=va,comp=y,f=part
gaRqam	gaRqa	pos=n,g=m,c=2,n=s
cUrRI	cUrRI	pos=n,comp=y
vAtaH	vAta	pos=n,g=m,c=1,n=s
priya	priya	pos=a,g=m,c=1,n=s
iva	iva	pos=i
rati	rati	pos=n,comp=y
SrAntam	Sram	pos=va,g=n,c=2,n=s,f=part
Asya	Asya	pos=n,comp=y
aravindam	aravinda	pos=n,g=n,c=2,n=s

# id = Kokila.1.89
sA	tad	pos=n,g=f,c=1,n=s
ca	ca	pos=i
prekzyA	prekz	pos=va,g=f,c=1,n=s,f=krtya
sarit	sarit	pos=n,g=f,c=1,n=s
anupadam	anupada	pos=n,g=n,c=2,n=s
yatra	yatra	pos=i
kalmAzitAyAm	kalmAzita	pos=a,g=f,c=7,n=s
raktAH	rakta	pos=a,g=m,c=1,n=p
padmAH	padma	pos=n,g=m,c=1,n=p
kuvalaya	kuvalaya	pos=n,comp=y
vanI	vanI	pos=n,comp=y
sAmyam	sAmya	pos=n,g=n,c=2,n=s
ApadyamAnAH	Apad	pos=va,g=m,c=1,n=p,f=part
vijYAyante	vijYA	pos=v,p=3,n=p,l=lat
sPuwa	sPuwa	pos=a,comp=y
mahima	mahiman	pos=n,comp=y
DAma	DAman	pos=n,comp=y
udaye	udaya	pos=n,g=m,c=7,n=s
jfmBamARe	jfmB	pos=va,g=m,c=7,n=s,f=part

# id = Kokila.1.90
cAru	cAru	pos=a,comp=y
su	su	pos=i
acCA	acCa	pos=a,g=f,c=1,n=s
SaPara	SaPara	pos=n,comp=y
nayanA	nayana	pos=n,g=f,c=1,n=s
cakravAka	cakravAka	pos=n,comp=y
stana	stana	pos=n,comp=y
SrIH	SrI	pos=n,g=f,c=1,n=s
kallola	kallola	pos=n,comp=y
BrUH	BrU	pos=n,g=f,c=1,n=s
kamala	kamala	pos=n,comp=y
vadanA	vadana	pos=n,g=f,c=1,n=s
kamra	kamra	pos=a,comp=y
SEvAla	SEvAla	pos=n,comp=y
keSA	keSa	pos=n,g=f,c=1,n=s
saMsevyA	saMsev	pos=va,g=f,c=1,n=s,f=krtya
syAt	as	pos=v,p=3,n=s,l=vidhilin
sarasa	sarasa	pos=a,comp=y
maDurA	maDura	pos=a,g=f,c=1,n=s
sAnukUlA	sAnukUla	pos=a,g=f,c=1,n=s
avatIrREH	avatf	pos=va,g=m,c=3,n=p,f=part
durgAhA	durgAha	pos=a,g=f,c=1,n=s
anyEH	anya	pos=n,g=m,c=3,n=p
iti	iti	pos=i
hi	hi	pos=i
saraRiH	saraRi	pos=n,g=f,c=1,n=s
kA	ka	pos=n,g=f,c=1,n=s
api	api	pos=i
gAmBIrya	gAmBIrya	pos=n,comp=y
BAjAm	BAj	pos=a,g=m,c=6,n=p

# id = Kokila.1.91
tve	tvad	pos=n,g=,c=7,n=s
AkASe	AkASa	pos=n,g=n,c=7,n=s
suBaga	suBaga	pos=a,g=m,c=8,n=s
tawinIm	tawinI	pos=n,g=f,c=2,n=s
lambamAne	lamb	pos=va,g=m,c=7,n=s,f=part
sa	sa	pos=i
lIlam	lIlA	pos=n,g=m,c=2,n=s
bimbam	bimba	pos=n,g=m,c=2,n=s
dfzwvA	dfS	pos=vi
payasi	payas	pos=n,g=n,c=7,n=s
maRi	maRi	pos=n,comp=y
BaNga	BaNga	pos=n,comp=y
amale	amala	pos=a,g=n,c=7,n=s
kampamAnam	kamp	pos=va,g=m,c=2,n=s,f=part
vIci	vIci	pos=n,comp=y
vega	vega	pos=n,comp=y
pracalat	pracal	pos=va,comp=y,f=part
asita	asita	pos=a,comp=y
amBojinI	amBojinI	pos=n,comp=y
gucCa	gucCa	pos=n,comp=y
budDyA	budDi	pos=n,g=f,c=3,n=s
kUjam	kUja	pos=n,g=m,c=2,n=s
kUjam	kUja	pos=n,g=m,c=2,n=s
maDuram	maDura	pos=a,g=m,c=2,n=s
ali	ali	pos=n,g=m,c=1,n=p
kokila	kokila	pos=n,g=m,c=8,n=s
vyAlaperan	vyAlap	pos=v,p=3,n=p,l=vidhilin

# id = Kokila.1.92
tIram	tIra	pos=n,g=n,c=2,n=s
tasyAH	tad	pos=n,g=f,c=6,n=s
prati	prati	pos=i
gatavato	gam	pos=va,g=m,c=6,n=s,f=part
dakziRam	dakziRa	pos=a,g=n,c=2,n=s
tad	tad	pos=n,comp=y
kzaRam	kzaRa	pos=n,g=m,c=2,n=s
te	tvad	pos=n,g=,c=6,n=s
deSaH	deSa	pos=n,g=m,c=1,n=s
sarva	sarva	pos=n,comp=y
atiSayin	atiSayin	pos=a,comp=y
viBavaH	viBava	pos=n,g=m,c=1,n=s
dfH	dfS	pos=n,comp=y
paTA	paTin	pos=n,g=,c=3,n=s
itas	itas	pos=i
praTeta	praT	pos=v,p=3,n=s,l=vidhilin
tAm	tad	pos=n,g=f,c=2,n=s
jAnIyA	jYA	pos=v,p=2,n=s,l=vidhilin
diSi	diS	pos=n,g=f,c=7,n=s
diSi	diS	pos=n,g=f,c=7,n=s
jayanta	jayanta	pos=n,comp=y
AKyayA	AKyA	pos=n,g=f,c=3,n=s
KyAyamAnAm	KyA	pos=va,g=f,c=2,n=s,f=part
pratyAdiH	pratyAdiS	pos=va,comp=y,f=part
tridiva	tridiva	pos=n,comp=y
nagara	nagara	pos=n,comp=y
prABavAm	prABava	pos=n,g=f,c=2,n=s
prApya	prAp	pos=vi
BUmim	BUmi	pos=n,g=f,c=2,n=s

# id = Kokila.1.93
bAla	bAla	pos=a,comp=y
udyAnEH	udyAna	pos=n,g=n,c=3,n=p
sa	sa	pos=i
mada	mada	pos=n,comp=y
mahilA	mahilA	pos=n,comp=y
Bukta	Buj	pos=va,comp=y,f=part
vallI	vallI	pos=n,comp=y
nikuYjEH	nikuYja	pos=n,g=n,c=3,n=p
keli	keli	pos=n,comp=y
haMsa	haMsa	pos=n,comp=y
kzuBita	kzuB	pos=va,comp=y,f=part
nagara	nagara	pos=n,comp=y
BrAnta	Bram	pos=va,comp=y,f=part
BfNgEH	BfNga	pos=n,g=n,c=3,n=p
saroBiH	saras	pos=n,g=n,c=3,n=p
ratna	ratna	pos=n,comp=y
SreRI	SreRi	pos=n,comp=y
Gawita	Gaw	pos=va,comp=y,f=part
SiKarEH	SiKara	pos=n,g=n,c=3,n=p
gopurEH	gopura	pos=n,g=n,c=3,n=p
sA	tad	pos=n,g=f,c=1,n=s
purI	purI	pos=n,g=f,c=1,n=s
te	tvad	pos=n,g=,c=6,n=s
prAyaH	prAyas	pos=i
prajYA	prajYA	pos=n,comp=y
ABaraREH	ABaraRa	pos=n,g=m,c=8,n=s
sugamA	sugama	pos=a,g=f,c=1,n=s
syAd	as	pos=v,p=3,n=s,l=vidhilin
an	an	pos=i
AveditA	Aveday	pos=va,g=f,c=1,n=s,f=part
api	api	pos=i

# id = Kokila.2.1
lakzmi	lakzmI	pos=n,comp=y
janma	janman	pos=n,comp=y
sTitim	sTiti	pos=n,g=f,c=2,n=s
anupamEH	anupama	pos=a,g=n,c=3,n=p
pUritAm	pUray	pos=va,g=f,c=2,n=s,f=part
ratna	ratna	pos=n,comp=y
jAlEH	jAla	pos=n,g=n,c=3,n=p
BUBft	BUBft	pos=n,comp=y
garBAm	garBa	pos=n,g=f,c=2,n=s
prakawita	prakaway	pos=va,comp=y,f=part
kalA	kalA	pos=n,comp=y
ISa	ISa	pos=n,comp=y
udaya	udaya	pos=n,comp=y
SlAGanIya	SlAG	pos=va,comp=y,f=krtya
vfdDim	vfdDi	pos=n,g=f,c=2,n=s
pATaH	pATas	pos=n,comp=y
rASeH	rASi	pos=n,g=m,c=6,n=s
tanum	tanu	pos=n,g=f,c=2,n=s
iva	iva	pos=i
parAm	para	pos=n,g=f,c=2,n=s
manyamAno	man	pos=va,g=m,c=1,n=s,f=part
viSAlAm	viSAla	pos=a,g=f,c=2,n=s
yAm	yad	pos=n,g=f,c=2,n=s
aDyAste	aDyAs	pos=v,p=3,n=s,l=lat
sa	tad	pos=n,g=m,c=1,n=s
Kalu	Kalu	pos=i
nigama	nigama	pos=n,comp=y
amBoja	amBoja	pos=n,comp=y
BfNgaH	BfNga	pos=n,g=m,c=1,n=s
raTANgI	raTANgI	pos=n,g=f,c=1,n=s

# id = Kokila.2.2
vaktra	vaktra	pos=n,comp=y
Opamyam	Opamya	pos=n,g=n,c=2,n=s
vahati	vah	pos=v,p=3,n=s,l=lat
vimalam	vimala	pos=a,g=n,c=2,n=s
paSya	paS	pos=v,p=2,n=s,l=lot
pArSve	pArSva	pos=n,g=n,c=7,n=s
suDAMSoH	suDAMSu	pos=n,g=m,c=6,n=s
paScAt	paScAt	pos=i
BAgam	BAga	pos=n,g=m,c=2,n=s
su	su	pos=i
muKe	muKa	pos=a,g=f,c=8,n=s
ramaREH	ramaRa	pos=n,g=m,c=3,n=p
itTam	itTam	pos=i
Aveday	Aveday	pos=va,g=f,c=1,n=p,f=part
harmye	harmya	pos=n,g=n,c=7,n=s
yasyAm	yad	pos=n,g=f,c=7,n=s
hariRa	hariRa	pos=n,comp=y
nayana	nayana	pos=n,g=f,c=1,n=p
kurvate	kf	pos=v,p=3,n=p,l=lat
'smin	idam	pos=n,g=n,c=7,n=s
kalaNkam	kalaNka	pos=n,g=m,c=2,n=s
dfzwvA	dfS	pos=vi
sa	sa	pos=i
IrzyAH	IrzyA	pos=n,g=f,c=1,n=p
iva	iva	pos=i
kuvalaya	kuvalaya	pos=n,comp=y
aDI	aDI	pos=va,comp=y,f=krtya
SoBEH	SoBa	pos=a,g=m,c=3,n=p
apANgEH	apANga	pos=n,g=m,c=3,n=p

# id = Kokila.2.3
vITyAm	vITi	pos=n,g=f,c=7,n=s
vITyAm	vITi	pos=n,g=f,c=7,n=s
vala	vala	pos=n,comp=y
ripu	ripu	pos=n,comp=y
SilA	SilA	pos=n,comp=y
BaNga	BaNga	pos=n,comp=y
badDa	banD	pos=va,comp=y,f=part
sTalAyAm	sTala	pos=n,g=f,c=7,n=s
saMmUrCadBiH	sammUrC	pos=va,g=m,c=3,n=p,f=part
kiraRa	kiraRa	pos=n,comp=y
pawalEH	pawala	pos=n,g=m,c=3,n=p
tvad	tvad	pos=n,comp=y
garut	garut	pos=n,comp=y
jAla	jAla	pos=n,comp=y
nIlEH	nIla	pos=a,g=m,c=3,n=p
yatra	yatra	pos=i
ArabDe	AraB	pos=va,g=m,c=7,n=s,f=part
dinakara	dinakara	pos=n,comp=y
karEH	kara	pos=n,g=m,c=3,n=p
api	api	pos=i
a	a	pos=i
hf	hf	pos=va,g=m,c=7,n=s,f=krtya
'nDakAre	anDakAra	pos=n,g=m,c=7,n=s
lola	lola	pos=a,comp=y
akzAnAm	akza	pos=a,g=f,c=6,n=p
Bavati	BU	pos=v,p=3,n=s,l=lat
divase	divasa	pos=n,g=m,c=7,n=s
nirviSaNko	nirviSaNka	pos=a,g=m,c=1,n=s
'BisAraH	aBisAra	pos=n,g=m,c=1,n=s

# id = Kokila.2.4
yasyAm	yad	pos=n,g=f,c=7,n=s
rAtrO	rAtri	pos=n,g=f,c=7,n=s
yuvati	yuvati	pos=n,comp=y
vadana	vadana	pos=n,comp=y
amBoja	amBoja	pos=n,comp=y
sOndarya	sOndarya	pos=n,comp=y
cOryAt	cOrya	pos=n,g=n,c=5,n=s
satyam	satya	pos=a,g=m,c=2,n=s
sODa	sODa	pos=n,comp=y
Dvaja	Dvaja	pos=n,comp=y
pawa	pawa	pos=n,comp=y
SiKA	SiKA	pos=n,comp=y
Gfzwa	Gfz	pos=va,comp=y,f=part
bimbe	bimba	pos=n,g=m,c=7,n=s
himAMSO	himAMSu	pos=n,g=m,c=7,n=s
dfzwvA	dfS	pos=vi
kfzRam	kfzRa	pos=a,g=m,c=2,n=s
kiRa	kiRa	pos=n,comp=y
maRi	maRi	pos=n,comp=y
kaRam	kaRa	pos=n,g=m,c=2,n=s
hanta	hanta	pos=i
gAQam	gAQam	pos=i
prarUQam	praruh	pos=va,g=m,c=2,n=s,f=part
mUQo	muh	pos=va,g=m,c=1,n=s,f=part
loko	loka	pos=n,g=m,c=1,n=s
vadati	vad	pos=v,p=3,n=s,l=lat
SaSako	SaSaka	pos=n,g=m,c=1,n=s
rohito	rohita	pos=a,g=m,c=1,n=s
anyat	anya	pos=n,g=n,c=1,n=s
taTA	taTA	pos=i
iti	iti	pos=i

# id = Kokila.2.5
vIci	vIci	pos=n,comp=y
kzip	kzip	pos=va,g=f,c=1,n=p,f=part
iva	iva	pos=i
suraDunI	suraDunI	pos=n,comp=y
bAla	bAla	pos=a,comp=y
SEvAla	SEvAla	pos=n,comp=y
mAlAH	mAlA	pos=n,g=f,c=1,n=p
yatra	yatra	pos=i
udIH	udIr	pos=va,g=f,c=1,n=p,f=part
marataka	marataka	pos=n,comp=y
rucaH	ruc	pos=n,g=f,c=1,n=p
candraSAlA	candraSAlA	pos=n,comp=y
taleByaH	tala	pos=n,g=n,c=5,n=p
GAsa	GAsa	pos=n,comp=y
BrAntyA	BrAnti	pos=n,g=f,c=3,n=s
gagana	gagana	pos=n,comp=y
padavI	padavI	pos=n,comp=y
dIrGa	dIrGa	pos=a,comp=y
pAnTAy	pAnTAy	pos=va,g=f,c=1,n=p,f=part
caYcat	caYc	pos=va,comp=y,f=part
proTam	proTa	pos=n,g=m,c=2,n=s
taraRi	taraRi	pos=n,comp=y
turagAH	turaga	pos=n,g=m,c=1,n=p
carv	carv	pos=vi
prAraBante	prAraB	pos=v,p=3,n=p,l=lat

# id = Kokila.2.6
yatra	yatra	pos=i
udyAne	udyAna	pos=n,g=n,c=7,n=s
malinay	malinay	pos=va,comp=y,f=part
diSA	diS	pos=n,g=f,c=3,n=s
kuYja	kuYja	pos=n,comp=y
puYje	puYja	pos=n,g=m,c=7,n=s
tarURAm	taru	pos=n,g=m,c=6,n=p
SfNge	SfNga	pos=n,g=n,c=7,n=s
lagnA	lag	pos=va,g=m,c=1,n=p,f=part
Bramara	Bramara	pos=n,comp=y
pawala	pawala	pos=n,comp=y
nirviSezAH	nirviSeza	pos=a,g=m,c=1,n=p
payodAH	payoda	pos=n,g=m,c=1,n=p
vApI	vApI	pos=n,g=f,c=7,n=p
ambu	ambu	pos=n,g=n,c=2,n=p
aDika	aDika	pos=a,comp=y
suraBi	suraBi	pos=a,g=n,c=2,n=p
utsfjanti	utsfj	pos=v,p=3,n=p,l=lat
sva	sva	pos=a,comp=y
kAle	kAla	pos=n,g=m,c=7,n=s
sopAna	sopAna	pos=n,comp=y
agra	agra	pos=n,comp=y
sPawika	sPawika	pos=n,comp=y
kiraRa	kiraRa	pos=n,comp=y
ujjfmBaRa	ujjfmBaRa	pos=n,comp=y
AmreqitAni	Amreqay	pos=va,g=n,c=2,n=p,f=part

# id = Kokila.2.7
anyAm	anya	pos=n,g=f,c=2,n=s
agre	agra	pos=n,g=n,c=7,n=s
mama	mad	pos=n,g=,c=6,n=s
maRi	maRi	pos=n,comp=y
gfhe	gfha	pos=n,g=n,c=7,n=s
BuktaH	Buj	pos=va,g=m,c=1,n=s,f=part
iti	iti	pos=i
avAdIH	vad	pos=v,p=2,n=s,l=lun
mugDe	muh	pos=va,g=f,c=8,n=s,f=part
kAnto	kAnta	pos=a,g=m,c=1,n=s
Dfta	Df	pos=va,comp=y,f=part
naKa	naKa	pos=n,comp=y
padA	pada	pos=n,g=f,c=1,n=s
Bitti	Bitti	pos=n,comp=y
lInA	lI	pos=va,g=f,c=1,n=s,f=part
kim	kim	pos=i
ezA	etad	pos=n,g=f,c=1,n=s
itTam	itTam	pos=i
yasyAm	yad	pos=n,g=f,c=7,n=s
smita	smita	pos=n,comp=y
lava	lava	pos=n,comp=y
juH	juz	pos=a,g=f,c=1,n=p
hrepayante	hrepay	pos=v,p=3,n=p,l=lat
nava	nava	pos=a,comp=y
UQAm	vah	pos=va,g=f,c=2,n=s,f=part
saKyaH	saKI	pos=n,g=f,c=1,n=p
tasyAH	tad	pos=n,g=f,c=6,n=s
tanum	tanu	pos=n,g=f,c=2,n=s
anupamAm	anupama	pos=a,g=f,c=2,n=s
bimbitAm	bimbita	pos=a,g=f,c=2,n=s
darSayantyaH	darSay	pos=va,g=f,c=1,n=p,f=part

# id = Kokila.2.8
cillI	cillI	pos=n,comp=y
valyAH	valI	pos=n,g=f,c=6,n=s
Danuzi	Danus	pos=n,g=n,c=7,n=s
Gawite	Gaway	pos=va,g=n,c=7,n=s,f=part
kzipta	kzip	pos=va,g=m,c=1,n=s,f=part
eva	eva	pos=i
ikzu	ikzu	pos=n,comp=y
kARqaH	kARqa	pos=n,g=m,c=1,n=s
netra	netra	pos=n,comp=y
upAnte	upAnta	pos=n,g=n,c=7,n=s
vahati	vah	pos=v,p=3,n=s,l=lat
Sara	Sara	pos=n,comp=y
tAm	tA	pos=n,g=f,c=2,n=s
nyastam	nyas	pos=va,g=n,c=2,n=s,f=part
eva	eva	pos=i
aravindam	aravinda	pos=n,g=n,c=2,n=s
romAvalyAm	romAvalI	pos=n,g=f,c=7,n=s
api	api	pos=i
guRa	guRa	pos=n,comp=y
daSAm	daSA	pos=n,g=f,c=2,n=s
yatra	yatra	pos=i
biMba	bimba	pos=n,comp=y
aDarAnAm	aDara	pos=n,g=m,c=6,n=p
biBrARAyAm	Bf	pos=va,g=f,c=7,n=s,f=part
madana	madana	pos=n,comp=y
viBvA	viBu	pos=a,g=m,c=3,n=s
BraMSitA	BraMSay	pos=va,g=f,c=1,n=s,f=part
eva	eva	pos=i
ali	ali	pos=n,comp=y
mAlA	mAlA	pos=n,g=f,c=1,n=s

# id = Kokila.2.9
SfNgAra	SfNgAra	pos=n,comp=y
abDi	abDi	pos=n,comp=y
plavaH	plava	pos=n,g=m,c=1,n=s
iva	iva	pos=i
gal	gal	pos=va,comp=y,f=part
veRI	veRI	pos=n,g=n,c=1,n=s
kampra	kampra	pos=a,comp=y
stanam	stana	pos=n,g=n,c=1,n=s
tat	tad	pos=n,g=n,c=1,n=s
BraMS	BraMS	pos=va,comp=y,f=part
nIvi	nIvi	pos=n,g=n,c=1,n=s
sTitam	sTA	pos=va,g=n,c=1,n=s,f=part
iti	iti	pos=i
viwA	viwa	pos=n,g=m,c=1,n=p
vIkzya	vIkz	pos=vi
saMSlizya	saMSliz	pos=vi
yatra	yatra	pos=i
mUQa	muh	pos=va,comp=y,f=part
akzAnAm	akza	pos=a,g=f,c=6,n=p
mukulay	mukulay	pos=va,comp=y,f=part
dfSAm	dfS	pos=n,g=f,c=6,n=p
mohana	mohana	pos=n,comp=y
Aqambara	Aqambara	pos=n,comp=y
ante	anta	pos=n,g=m,c=7,n=s
BUyaH	BUyas	pos=i
SrAntam	Sram	pos=va,g=m,c=2,n=s,f=part
punaH	punar	pos=i
api	api	pos=i
rata	rata	pos=n,comp=y
udyogam	udyoga	pos=n,g=m,c=2,n=s
udvelayanti	udvelay	pos=v,p=3,n=p,l=lat

# id = Kokila.2.10
yasyAm	yad	pos=n,g=f,c=7,n=s
meGA	meGa	pos=n,g=m,c=1,n=p
hari	hari	pos=a,comp=y
maRi	maRi	pos=n,comp=y
SilA	SilA	pos=n,comp=y
harmya	harmya	pos=n,comp=y
paryanta	paryanta	pos=n,comp=y
BAjaH	BAj	pos=a,g=m,c=1,n=p
na	na	pos=i
jYAyeran	jYA	pos=v,p=3,n=p,l=vidhilin
SravaRa	SravaRa	pos=n,comp=y
suBagam	suBaga	pos=a,g=n,c=2,n=s
garjitam	garjita	pos=n,g=n,c=2,n=s
ced	ced	pos=i
na	na	pos=i
dadyuH	dA	pos=v,p=3,n=p,l=vidhilin
vidyut	vidyut	pos=n,comp=y
vallI	vallI	pos=n,g=f,c=1,n=s
punaH	punar	pos=i
api	api	pos=i
nava	nava	pos=a,comp=y
ArabDa	AraB	pos=va,comp=y,f=part
saMBoga	samBoga	pos=n,comp=y
lIlA	lIlA	pos=n,comp=y
vell	vell	pos=va,comp=y,f=part
kAntA	kAntA	pos=n,comp=y
vipula	vipula	pos=a,comp=y
jaGana	jaGana	pos=n,comp=y
srasta	sraMs	pos=va,comp=y,f=part
kAYcI	kAYcI	pos=n,comp=y
samA	sama	pos=n,g=f,c=1,n=s
eva	eva	pos=i

# id = Kokila.2.11
tasyAm	tad	pos=n,g=f,c=7,n=s
lakzmIramaRa	lakzmIramaRa	pos=n,comp=y
nilayam	nilaya	pos=n,g=n,c=1,n=s
dakziRena	dakziRa	pos=a,g=m,c=3,n=s
Ikz	Ikz	pos=va,g=n,c=1,n=s,f=krtya
mad	mad	pos=n,comp=y
kAntAyAH	kAntA	pos=n,g=f,c=6,n=s
sadanam	sadana	pos=n,g=n,c=1,n=s
aBitas	aBitas	pos=i
vezwitam	vezway	pos=va,g=n,c=1,n=s,f=part
ratna	ratna	pos=n,comp=y
sAlEH	sAla	pos=n,g=m,c=3,n=p
maDye	maDya	pos=n,g=n,c=7,n=s
sODam	sODa	pos=n,g=n,c=1,n=s
kanaka	kanaka	pos=n,comp=y
Gawitam	Gaway	pos=va,g=n,c=1,n=s,f=part
biBrat	Bf	pos=va,g=n,c=1,n=s,f=part
UQa	vah	pos=va,comp=y,f=part
Cada	Cada	pos=n,comp=y
oGe	oGa	pos=n,g=m,c=7,n=s
yasmin	yad	pos=n,g=m,c=7,n=s
amBoruha	amBoruha	pos=n,g=n,c=7,n=s
iva	iva	pos=i
kan	kan	pos=va,comp=y,f=part
karRikA	karRikA	pos=n,g=n,c=7,n=s
Kelati	Kel	pos=v,p=3,n=s,l=lat
SrIH	SrI	pos=n,g=f,c=1,n=s

# id = Kokila.2.12
mAhABAgyam	mAhABAgya	pos=n,g=n,c=1,n=s
ratipati	ratipati	pos=n,comp=y
Buja	Buja	pos=n,comp=y
AqambaraH	Aqambara	pos=n,g=m,c=1,n=s
pOnaruktyAt	pOnaruktya	pos=n,g=n,c=5,n=s
kalyARa	kalyARa	pos=a,comp=y
oGaH	oGa	pos=n,g=m,c=1,n=s
sPurati	sPur	pos=v,p=3,n=s,l=lat
rasika	rasika	pos=a,comp=y
ananta	ananta	pos=a,comp=y
tA	tA	pos=n,g=f,c=1,n=s
api	api	pos=i
atra	atra	pos=i
hi	hi	pos=i
iti	iti	pos=i
ezAm	idam	pos=n,g=m,c=6,n=p
Adi	Adi	pos=n,comp=y
akzara	akzara	pos=n,comp=y
gaRam	gaRa	pos=n,g=m,c=2,n=s
upAdAya	upAdA	pos=vi
badDena	banD	pos=va,g=n,c=3,n=s,f=part
nAmnA	nAman	pos=n,g=n,c=3,n=s
mAnyam	mAnay	pos=va,g=n,c=2,n=s,f=krtya
mArakkara	mArakkara	pos=n,comp=y
nilayanam	nilayana	pos=n,g=n,c=2,n=s
yat	yat	pos=i
kavi	kavi	pos=n,comp=y
indrAH	indra	pos=n,g=m,c=1,n=p
gfRanti	gf	pos=v,p=3,n=p,l=lat

# id = Kokila.2.13
lIlA	lIlA	pos=n,comp=y
vApI	vApI	pos=n,g=f,c=1,n=s
lasati	las	pos=v,p=3,n=s,l=lat
lalitA	lal	pos=va,g=f,c=1,n=s,f=part
tatra	tatra	pos=i
sopAna	sopAna	pos=n,comp=y
mArge	mArga	pos=n,g=m,c=7,n=s
mARikya	mARikya	pos=n,comp=y
aMSu	aMSu	pos=n,comp=y
sPuraRa	sPuraRa	pos=n,comp=y
satata	satata	pos=a,comp=y
smera	smera	pos=a,comp=y
nAlIka	nAlIka	pos=n,comp=y
zaRqA	zaRqa	pos=n,g=f,c=1,n=s
yatra	yatra	pos=i
AyA	AyA	pos=va,g=f,c=6,n=s,f=part
payasi	payas	pos=n,g=n,c=7,n=s
vimale	vimala	pos=a,g=m,c=7,n=s
snAtum	snA	pos=vi
mad	mad	pos=n,comp=y
priyAyAH	priya	pos=a,g=f,c=6,n=s
manye	man	pos=v,p=1,n=s,l=lat
yAna	yAna	pos=n,comp=y
aByasana	aByasana	pos=n,comp=y
viDi	viDi	pos=n,g=m,c=4,n=s
mallikAkzA	mallikAkza	pos=n,g=m,c=1,n=p
vasanti	vas	pos=v,p=3,n=p,l=lat

# id = Kokila.2.14
tasyAH	tad	pos=n,g=f,c=6,n=s
tIre	tIra	pos=n,g=n,c=7,n=s
punaH	punar	pos=i
upavanam	upavana	pos=n,g=n,c=1,n=s
tatra	tatra	pos=i
cUto	cUta	pos=n,g=m,c=1,n=s
'sti	as	pos=v,p=3,n=s,l=lat
potas	pota	pos=n,g=m,c=1,n=s
tvad	tvad	pos=n,comp=y
jAtIyEH	jAtIya	pos=a,g=m,c=3,n=p
pika	pika	pos=n,g=m,c=8,n=s
parivftaH	parivf	pos=va,g=m,c=1,n=s,f=part
pallava	pallava	pos=n,comp=y
AsvAda	AsvAda	pos=n,comp=y
lubDEH	luB	pos=va,g=m,c=3,n=p,f=part
pArSve	pArSva	pos=n,g=n,c=7,n=s
ca	ca	pos=i
asya	idam	pos=n,g=m,c=6,n=s
stabaka	stabaka	pos=n,comp=y
namitA	namay	pos=va,g=f,c=1,n=s,f=part
mADavI	mADavI	pos=n,comp=y
mUQa	muh	pos=va,comp=y,f=part
vallI	vallI	pos=n,g=f,c=1,n=s
preyasyA	preyas	pos=a,g=f,c=6,n=s
me	mad	pos=n,g=,c=6,n=s
pariRayam	pariRaya	pos=n,g=m,c=2,n=s
aham	mad	pos=n,g=,c=1,n=s
prApitO	prApay	pos=va,g=m,c=1,n=d,f=part
sAdaram	sAdara	pos=a,g=n,c=2,n=s
yO	yad	pos=n,g=m,c=1,n=d

# id = Kokila.2.15
tasya	tad	pos=n,g=n,c=6,n=s
adUre	adUra	pos=n,g=n,c=7,n=s
marataka	marataka	pos=n,comp=y
tale	tala	pos=n,g=n,c=7,n=s
hema	heman	pos=n,comp=y
badDa	banD	pos=va,comp=y,f=part
AlavAlaH	AlavAla	pos=n,g=m,c=1,n=s
sikto	sic	pos=va,g=m,c=1,n=s,f=part
mUle	mUla	pos=n,g=n,c=7,n=s
hima	hima	pos=a,comp=y
jala	jala	pos=n,comp=y
BarEH	Bara	pos=n,g=m,c=3,n=p
campakaH	campaka	pos=n,g=m,c=1,n=s
kaScid	kaScit	pos=n,g=m,c=1,n=s
Aste	As	pos=v,p=3,n=s,l=lat
labDvA	laB	pos=vi
saKyAH	saKI	pos=n,g=f,c=6,n=s
te	tvad	pos=n,g=,c=6,n=s
sa	tad	pos=n,g=m,c=1,n=s
su	su	pos=i
kftI	kftin	pos=a,g=m,c=1,n=s
smera	smera	pos=a,comp=y
vaktra	vaktra	pos=n,comp=y
abja	abja	pos=n,comp=y
rAgam	rAga	pos=n,g=m,c=2,n=s
sUte	sU	pos=v,p=3,n=s,l=lat
tasyAH	tad	pos=n,g=f,c=6,n=s
tanu	tanu	pos=a,comp=y
latikayA	latikA	pos=n,g=f,c=3,n=s
tulya	tulya	pos=a,comp=y
varRam	varRa	pos=n,g=n,c=1,n=s
prasUnam	prasUna	pos=n,g=n,c=1,n=s

# id = Kokila.2.16
krIqA	krIqA	pos=n,comp=y
nftte	nftta	pos=n,g=n,c=7,n=s
Bavana	Bavana	pos=n,comp=y
SiKinAm	SiKin	pos=n,g=m,c=6,n=p
dUra	dUra	pos=a,comp=y
mukta	muc	pos=va,comp=y,f=part
ahi	ahi	pos=n,comp=y
saNgA	saNga	pos=n,g=f,c=1,n=s
sAndra	sAndra	pos=a,comp=y
CAyA	CAyA	pos=n,comp=y
Ahfta	Ahf	pos=va,comp=y,f=part
ravi	ravi	pos=n,comp=y
karA	kara	pos=n,g=f,c=1,n=s
tatra	tatra	pos=i
pAwIra	pAwIra	pos=n,comp=y
vAwI	vAwI	pos=n,g=f,c=1,n=s
maDye	maDya	pos=n,g=n,c=7,n=s
tasyAm	tad	pos=n,g=f,c=7,n=s
sa	tad	pos=n,g=m,c=1,n=s
Kalu	Kalu	pos=i
latikA	latikA	pos=n,comp=y
maRqapaH	maRqapa	pos=n,g=m,c=1,n=s
ratna	ratna	pos=n,comp=y
BUmiH	BUmi	pos=n,g=f,c=1,n=s
SaSvat	SaSvat	pos=i
yasmin	yad	pos=n,g=m,c=7,n=s
kim	ka	pos=n,g=n,c=2,n=s
api	api	pos=i
valati	val	pos=v,p=3,n=s,l=lat
sma	sma	pos=i
nO	mad	pos=n,g=,c=6,n=d
prema	preman	pos=n,comp=y
vallI	vallI	pos=n,g=f,c=1,n=s

# id = Kokila.2.17
snigDa	snigDa	pos=a,comp=y
skanDa	skanDa	pos=n,comp=y
sruta	sru	pos=va,comp=y,f=part
maDu	maDu	pos=a,comp=y
rasaH	rasa	pos=n,g=m,c=1,n=s
kiMca	kiMca	pos=i
tasya	tad	pos=n,g=m,c=6,n=s
upakaRWe	upakaRWa	pos=n,g=n,c=7,n=s
kUjat	kUj	pos=va,comp=y,f=part
BfNgaH	BfNga	pos=n,g=m,c=1,n=s
kuravaka	kuravaka	pos=n,comp=y
taruH	taru	pos=n,g=m,c=1,n=s
yaH	yad	pos=n,g=m,c=1,n=s
kuraNga	kuraNga	pos=n,comp=y
IkzaRAyAH	IkzaRa	pos=n,g=f,c=6,n=s
kAle	kAla	pos=n,g=m,c=7,n=s
kAle	kAla	pos=n,g=m,c=7,n=s
kari	karin	pos=n,comp=y
kara	kara	pos=n,comp=y
SiraH	Siras	pos=n,comp=y
viBramAByAm	viBrama	pos=n,g=m,c=3,n=d
BujAByAm	Buja	pos=n,g=m,c=3,n=d
ASlizwa	ASliz	pos=va,comp=y,f=part
aNgaH	aNga	pos=n,g=m,c=1,n=s
vahati	vah	pos=v,p=3,n=s,l=lat
mukula	mukula	pos=n,comp=y
CadmanA	Cadman	pos=n,g=n,c=3,n=s
roma	roman	pos=n,comp=y
BedAn	Beda	pos=n,g=m,c=2,n=p

# id = Kokila.2.18
sTAnezu	sTAna	pos=n,g=n,c=7,n=p
ezu	idam	pos=n,g=n,c=7,n=p
kvacana	kvacana	pos=i
kaTitezu	kaTay	pos=va,g=n,c=7,n=p,f=part
utsukA	utsuka	pos=a,g=f,c=1,n=s
puzpa	puzpa	pos=n,comp=y
SayyAm	SayyA	pos=n,g=f,c=2,n=s
aDyAsInA	aDyAs	pos=va,g=f,c=1,n=s,f=part
parijana	parijana	pos=n,comp=y
kftAm	kf	pos=va,g=f,c=2,n=s,f=part
sA	tad	pos=n,g=f,c=1,n=s
na	na	pos=i
ced	ced	pos=i
IkzitA	Ikz	pos=va,g=f,c=1,n=s,f=part
syAt	as	pos=v,p=3,n=s,l=vidhilin
prAsAdo	prAsAda	pos=n,g=m,c=1,n=s
'syAH	idam	pos=n,g=f,c=6,n=s
param	param	pos=i
aBimataH	aBiman	pos=va,g=m,c=1,n=s,f=part
ko	ka	pos=n,g=m,c=1,n=s
'pi	api	pos=i
mAhendra	mAhendra	pos=n,comp=y
nIlaH	nIla	pos=a,g=m,c=1,n=s
tasmin	tad	pos=n,g=m,c=7,n=s
dfSyA	dfS	pos=va,g=f,c=1,n=s,f=krtya
taqit	taqit	pos=n,g=f,c=1,n=s
iva	iva	pos=i
Gane	Gana	pos=n,g=n,c=7,n=s
cAru	cAru	pos=a,comp=y
rUpA	rUpa	pos=n,g=f,c=1,n=s
priyA	priya	pos=a,g=f,c=1,n=s
me	mad	pos=n,g=,c=6,n=s

# id = Kokila.2.19
sA	tad	pos=n,g=f,c=1,n=s
netrAnAm	netra	pos=n,g=n,c=6,n=p
amfta	amfta	pos=n,comp=y
gulikA	gulikA	pos=n,g=f,c=1,n=s
sfzwi	sfzwi	pos=n,comp=y
sAraH	sAra	pos=n,g=m,c=1,n=s
viDAtuH	viDAtf	pos=n,g=m,c=6,n=s
sOndarya	sOndarya	pos=n,comp=y
indoH	indu	pos=n,g=m,c=6,n=s
praTama	praTama	pos=a,comp=y
kalikA	kalikA	pos=n,g=f,c=1,n=s
dIpikA	dIpikA	pos=n,g=f,c=1,n=s
BUtaDAtryAH	BUtaDAtrI	pos=n,g=f,c=6,n=s
kandarpasya	kandarpa	pos=n,g=m,c=6,n=s
triBuvana	triBuvana	pos=n,comp=y
viBoH	viBu	pos=a,g=m,c=6,n=s
kAYcanI	kAYcana	pos=a,g=f,c=1,n=s
ketu	ketu	pos=n,comp=y
yazwiH	yazwi	pos=n,g=f,c=1,n=s
SfNgAra	SfNgAra	pos=n,comp=y
abDeH	abDi	pos=n,g=m,c=6,n=s
SaSaDara	SaSaDara	pos=n,comp=y
kalA	kalA	pos=n,g=f,c=1,n=s
jIvitam	jIvita	pos=n,g=n,c=1,n=s
me	mad	pos=n,g=,c=6,n=s
dvitIyam	dvitIya	pos=a,g=n,c=1,n=s

# id = Kokila.2.20
paSyan	dfS	pos=va,g=m,c=1,n=s,f=part
enAm	enad	pos=n,g=f,c=2,n=s
bahala	bahala	pos=a,comp=y
suzamA	suzamA	pos=n,comp=y
maRqalI	maRqala	pos=n,comp=y
antaH	antar	pos=i
nimagnAm	nimajj	pos=va,g=f,c=2,n=s,f=part
maDye	maDya	pos=n,g=n,c=7,n=s
anyAsAm	anya	pos=n,g=f,c=6,n=p
api	api	pos=i
cala	cala	pos=a,comp=y
dfSAm	dfS	pos=n,g=f,c=6,n=p
jYAsyase	jYA	pos=v,p=2,n=s,l=lrt
no	no	pos=i
kaTam	kaTam	pos=i
tvam	tvad	pos=n,g=,c=1,n=s
jyotsnA	jyotsnA	pos=n,comp=y
jAla	jAla	pos=n,comp=y
snapita	snapay	pos=va,comp=y,f=part
BuvanA	Buvana	pos=n,g=f,c=1,n=s
tArakARAm	tArakA	pos=n,g=f,c=6,n=p
samIpe	samIpa	pos=n,g=n,c=7,n=s
cAndrI	cAndra	pos=a,g=f,c=1,n=s
mUrtiH	mUrti	pos=n,g=f,c=1,n=s
kaTaya	kaTay	pos=v,p=2,n=s,l=lot
jagato	jagant	pos=n,g=n,c=6,n=s
jYApyate	jYApay	pos=v,p=3,n=s,l=lat
kena	kena	pos=i
rAtrO	rAtri	pos=n,g=f,c=7,n=s

# id = Kokila.2.21
sAndra	sAndra	pos=a,comp=y
AmodaH	Amoda	pos=n,g=m,c=1,n=s
timira	timira	pos=n,comp=y
nikaraH	nikara	pos=n,g=m,c=1,n=s
candramAH	candramas	pos=n,g=m,c=1,n=s
nizkalaNkaH	nizkalaNka	pos=a,g=m,c=1,n=s
SElO	SEla	pos=n,g=m,c=1,n=d
hEmO	hEma	pos=a,g=m,c=1,n=d
Bramara	Bramara	pos=n,comp=y
pawala	pawala	pos=n,comp=y
kIlitaH	kIlay	pos=va,g=m,c=1,n=s,f=part
vyoma	vyoman	pos=n,comp=y
BAgaH	BAga	pos=n,g=m,c=1,n=s
kamram	kamra	pos=a,g=n,c=1,n=s
cakram	cakra	pos=n,g=n,c=1,n=s
mfdu	mfdu	pos=a,comp=y
kari	karin	pos=n,comp=y
kara	kara	pos=n,comp=y
dvandvam	dvaMdva	pos=n,g=n,c=1,n=s
abje	abja	pos=n,g=n,c=1,n=d
sa	sa	pos=i
lIlA	lIlA	pos=n,g=n,c=1,n=d
sarvam	sarva	pos=n,g=n,c=1,n=s
ca	ca	pos=i
etat	etad	pos=n,g=n,c=1,n=s
madana	madana	pos=n,comp=y
Gawitam	Gaw	pos=va,g=n,c=1,n=s,f=part
sOmya	sOmya	pos=a,g=m,c=8,n=s
samBUya	samBU	pos=vi
sA	tad	pos=n,g=f,c=1,n=s
aBUt	BU	pos=v,p=3,n=s,l=lun

# id = Kokila.2.22
nIcIkurvanti	nIcIkf	pos=v,p=3,n=p,l=lat
alasa	alasa	pos=a,comp=y
valitAH	val	pos=va,g=m,c=1,n=p,f=part
netra	netra	pos=n,comp=y
pAtAH	pAta	pos=n,g=m,c=1,n=p
kuraNgAn	kuraNga	pos=n,g=m,c=2,n=p
vIci	vIci	pos=n,comp=y
garvam	garva	pos=n,g=m,c=2,n=s
harati	hf	pos=v,p=3,n=s,l=lat
niKilam	niKila	pos=a,g=m,c=2,n=s
viBrama	viBrama	pos=n,comp=y
AndolitA	Andolay	pos=va,g=f,c=1,n=s,f=part
BrUH	BrU	pos=n,g=f,c=1,n=s
pARI	pARi	pos=n,g=m,c=1,n=d
kalpadruma	kalpadruma	pos=n,comp=y
kisalaya	kisalaya	pos=n,comp=y
prABavam	prABava	pos=n,g=n,c=2,n=s
na	na	pos=i
kzamete	kzam	pos=v,p=3,n=d,l=lat
vARI	vARI	pos=n,g=f,c=1,n=s
tasyA	tad	pos=n,g=f,c=6,n=s
vahati	vah	pos=v,p=3,n=s,l=lat
BavatAm	Bavat	pos=a,g=m,c=6,n=p
paYcamEH	paYcama	pos=a,g=m,c=3,n=p
bAla	bAla	pos=n,comp=y
mEtrIm	mEtrI	pos=n,g=f,c=2,n=s

# id = Kokila.2.23
sA	tad	pos=n,g=f,c=1,n=s
kAntiH	kAnti	pos=n,g=f,c=1,n=s
ced	ced	pos=i
dravati	dru	pos=v,p=3,n=s,l=lat
kanakam	kanaka	pos=n,g=n,c=1,n=s
tat	tad	pos=n,g=n,c=1,n=s
muKam	muKa	pos=n,g=n,c=1,n=s
cet	ced	pos=i
ka	ka	pos=n,g=m,c=1,n=s
induH	indu	pos=n,g=m,c=1,n=s
sA	tad	pos=n,g=f,c=1,n=s
ced	ced	pos=i
biMba	bimba	pos=n,comp=y
aDara	aDara	pos=n,comp=y
maDura	maDura	pos=a,comp=y
tA	tA	pos=n,g=f,c=1,n=s
tikta	tikta	pos=a,comp=y
tAm	tA	pos=n,g=f,c=2,n=s
eti	i	pos=v,p=3,n=s,l=lat
mADvI	mADvI	pos=n,g=f,c=1,n=s
sA	tad	pos=n,g=f,c=1,n=s
vA	vA	pos=i
tasyA	tad	pos=n,g=f,c=6,n=s
yadi	yadi	pos=i
tanu	tanu	pos=n,comp=y
latA	latA	pos=n,g=f,c=1,n=s
mAlatI	mAlatI	pos=n,g=f,c=1,n=s
loha	loha	pos=n,comp=y
tulyA	tulya	pos=a,g=f,c=1,n=s
tO	tad	pos=n,g=m,c=1,n=d
ced	ced	pos=i
UrU	Uru	pos=n,g=m,c=1,n=d
kanakakadalI	kanakakadalI	pos=n,comp=y
stamBayoH	stamBa	pos=n,g=m,c=6,n=d
kvApi	kvApi	pos=i
qamBaH	qamBa	pos=n,g=m,c=1,n=s

# id = Kokila.2.24
uktezu	vac	pos=va,g=n,c=7,n=p,f=part
eva	eva	pos=i
prasajati	prasaYj	pos=v,p=3,n=s,l=lat
punaH	punar	pos=i
navya	navya	pos=a,comp=y
lAvaRya	lAvaRya	pos=n,comp=y
sArezu	sAra	pos=n,g=n,c=7,n=p
aNgezu	aNga	pos=n,g=n,c=7,n=p
asyAH	idam	pos=n,g=f,c=6,n=s
mama	mad	pos=n,g=,c=6,n=s
kaTayato	kaTay	pos=va,g=m,c=6,n=s,f=part
hanta	hanta	pos=i
vAcAm	vAc	pos=n,g=f,c=6,n=p
pravfttiH	pravftti	pos=n,g=f,c=1,n=s
tAdfH	tAdfS	pos=a,comp=y
BUte	BU	pos=va,g=n,c=7,n=s,f=part
manasi	manas	pos=n,g=n,c=7,n=s
vivaSe	vivaSa	pos=a,g=n,c=7,n=s
kim	ka	pos=n,g=n,c=2,n=s
nu	nu	pos=i
kurvIta	kf	pos=v,p=3,n=s,l=vidhilin
sA	tad	pos=n,g=f,c=1,n=s
iyam	idam	pos=n,g=f,c=1,n=s
yat	yad	pos=n,g=n,c=2,n=s
yat	yad	pos=n,g=n,c=2,n=s
cetaH	cetas	pos=n,g=n,c=1,n=s
vimfSati	vimfS	pos=v,p=3,n=s,l=lat
girAm	gir	pos=n,g=f,c=6,n=p
tat	tad	pos=n,g=n,c=1,n=s
tat	tad	pos=n,g=n,c=1,n=s
eva	eva	pos=i
aBiDA	aBiDA	pos=va,g=n,c=1,n=s,f=krtya

# id = Kokila.2.25
adya	adya	pos=i
prAyaH	prAyas	pos=i
praRayini	praRayin	pos=a,g=m,c=7,n=s
mayi	mad	pos=n,g=,c=7,n=s
prozite	pravas	pos=va,g=m,c=7,n=s,f=part
BAgya	BAgya	pos=n,comp=y
dozataH	doza	pos=n,g=m,c=5,n=s
kalpa	kalpa	pos=n,comp=y
prAyEH	prAya	pos=n,g=m,c=3,n=p
ahaha	ahaha	pos=i
divasEH	divasa	pos=n,g=m,c=3,n=p
eBiH	idam	pos=n,g=m,c=3,n=p
utkaRW	utkaRW	pos=va,g=f,c=1,n=s,f=part
saMjAyeta	saMjan	pos=v,p=3,n=s,l=vidhilin
prabala	prabala	pos=a,comp=y
viraha	viraha	pos=n,comp=y
udvejitA	udvejay	pos=va,g=f,c=1,n=s,f=part
peSala	peSala	pos=a,comp=y
aNgI	aNga	pos=a,g=f,c=1,n=s
mUrC	mUrC	pos=va,comp=y,f=part
Garma	Garma	pos=n,comp=y
jvara	jvara	pos=n,comp=y
paravaSA	paravaSa	pos=a,g=f,c=1,n=s
nIlakaRWI	nIlakaRWI	pos=n,g=f,c=1,n=s
iva	iva	pos=i
KinnA	Kid	pos=va,g=f,c=1,n=s,f=part

# id = Kokila.2.26
yatra	yatra	pos=i
apANga	apANga	pos=n,comp=y
dyuti	dyuti	pos=n,comp=y
kavacite	kavacita	pos=a,g=m,c=7,n=s
kiMcid	kaScit	pos=n,g=n,c=2,n=s
utsArya	utsAray	pos=vi
keSAn	keSa	pos=n,g=m,c=2,n=p
dattaH	dA	pos=va,g=m,c=1,n=s,f=part
premRA	preman	pos=n,g=,c=3,n=s
dinam	dina	pos=n,g=n,c=2,n=s
anu	anu	pos=i
mayA	mad	pos=n,g=,c=3,n=s
dIrGikA	dIrGikA	pos=n,comp=y
rakta	rakta	pos=a,comp=y
padmaH	padma	pos=n,g=m,c=1,n=s
tasmin	tad	pos=n,g=m,c=7,n=s
asyA	idam	pos=n,g=f,c=6,n=s
Bavati	BU	pos=v,p=3,n=s,l=lat
niyatam	niyatam	pos=i
hanta	hanta	pos=i
cintA	cintA	pos=n,comp=y
AkulAyAH	Akula	pos=a,g=f,c=6,n=s
gaRqa	gaRqa	pos=n,comp=y
nyastaH	nyas	pos=va,g=m,c=1,n=s,f=part
karakisalayaH	karakisalaya	pos=n,g=m,c=1,n=s
karRa	karRa	pos=n,comp=y
jAhe	jAha	pos=n,g=n,c=7,n=s
'vataMsaH	avataMsa	pos=n,g=m,c=1,n=s

# id = Kokila.2.27
pakzma	pakzman	pos=n,comp=y
spandaH	spanda	pos=n,g=m,c=1,n=s
samajani	saMjan	pos=v,p=3,n=s,l=lun
saKe	saKi	pos=n,g=,c=8,n=s
paSyatoH	dfS	pos=va,g=m,c=6,n=d,f=part
mAm	mad	pos=n,g=,c=2,n=s
yayoH	yad	pos=n,g=m,c=6,n=d
prANnizpatrAkfn	mad	pos=n,g=,c=7,n=s
mayi	tu	pos=i
tu	viDi	pos=n,g=m,c=3,n=s
viDinA	tAdfSa	pos=a,g=m,c=7,n=s
dUra	dUra	pos=a,comp=y
nIte	nI	pos=va,g=m,c=7,n=s,f=part
antaH	antar	pos=i
bAzpa	bAzpa	pos=n,comp=y
CuraRa	CuraRa	pos=n,comp=y
niBfte	niBfta	pos=a,g=n,c=1,n=d
sAmpratam	sAMpratam	pos=i
te	tvad	pos=n,g=,c=6,n=s
mfga	mfga	pos=n,comp=y
akzAyAH	akza	pos=a,g=f,c=6,n=s
netre	netra	pos=n,g=n,c=1,n=d
DattaH	DA	pos=v,p=3,n=d,l=lat
tuhina	tuhina	pos=n,comp=y
kaRikA	kaRikA	pos=n,comp=y
dantura	dantura	pos=a,comp=y
amBoja	amBoja	pos=n,comp=y
dEnyam	dEnya	pos=n,g=n,c=2,n=s

# id = Kokila.2.28
sAndra	sAndra	pos=a,comp=y
Amodam	Amoda	pos=n,g=n,c=2,n=s
sa	sa	pos=i
pawu	pawu	pos=a,g=n,c=2,n=s
sa	sa	pos=i
dayam	dayA	pos=n,g=n,c=2,n=s
sa	sa	pos=i
smaram	smara	pos=n,g=n,c=2,n=s
sa	sa	pos=i
anutarzam	anutarza	pos=n,g=n,c=2,n=s
saMBoga	samBoga	pos=n,comp=y
ante	anta	pos=n,g=m,c=7,n=s
muhuH	muhur	pos=i
api	api	pos=i
mayA	mad	pos=n,g=,c=3,n=s
sAdaram	sAdara	pos=a,g=n,c=2,n=s
cumbito	cumb	pos=va,g=m,c=1,n=s,f=part
yaH	yad	pos=n,g=m,c=1,n=s
narma	narman	pos=n,comp=y
AlApa	AlApa	pos=n,comp=y
smita	smita	pos=n,comp=y
lava	lava	pos=n,comp=y
suDA	suDA	pos=n,comp=y
secanEH	secana	pos=n,g=m,c=3,n=p
mucyamAnas	muc	pos=va,g=m,c=1,n=s,f=part
tAmyati	tam	pos=v,p=3,n=s,l=lat
uzRa	uzRa	pos=a,comp=y
Svasita	Svasita	pos=n,comp=y
pavanEH	pavana	pos=n,g=m,c=3,n=p
so	tad	pos=n,g=m,c=1,n=s
'ti	ati	pos=i
biMba	bimba	pos=n,comp=y
aDaraH	aDara	pos=n,g=m,c=1,n=s
'syAH	idam	pos=n,g=f,c=6,n=s

# id = Kokila.2.29
krIqA	krIqA	pos=n,comp=y
SElO	SEla	pos=n,g=m,c=1,n=d
madana	madana	pos=n,comp=y
nfpateH	nfpati	pos=n,g=m,c=6,n=s
kAnti	kAnti	pos=n,comp=y
pUrasya	pUra	pos=a,g=m,c=6,n=s
kokO	koka	pos=n,g=m,c=1,n=d
syAtAm	as	pos=v,p=3,n=d,l=vidhilin
tasyA	tad	pos=n,g=f,c=6,n=s
Druvam	Druvam	pos=i
urasijO	urasija	pos=n,g=m,c=1,n=d
kiMcid	kaScit	pos=n,g=n,c=2,n=s
ApARqu	ApARqu	pos=a,comp=y
mUlO	mUla	pos=n,g=m,c=1,n=d
mad	mad	pos=n,comp=y
viSlezaH	viSleza	pos=n,g=m,c=1,n=s
Sarad	Sarad	pos=n,comp=y
uqu	uqu	pos=n,comp=y
niBAm	niBa	pos=a,g=f,c=2,n=s
tyAjayan	tyAjay	pos=va,g=m,c=1,n=s,f=part
hAra	hAra	pos=n,comp=y
mAlAm	mAlA	pos=n,g=f,c=2,n=s
manye	man	pos=v,p=1,n=s,l=lat
BIto	BI	pos=va,g=m,c=1,n=s,f=part
vitarati	vitf	pos=v,p=3,n=s,l=lat
tayoH	tad	pos=n,g=m,c=6,n=d
aSru	aSru	pos=n,comp=y
DArABiH	DArA	pos=n,g=f,c=3,n=p
anyAm	anya	pos=n,g=f,c=2,n=s

# id = Kokila.2.30
BUzAsu	BUzA	pos=n,g=f,c=7,n=p
AsTAm	AsTA	pos=n,g=f,c=2,n=s
yat	yat	pos=i
api	api	pos=i
jahatI	hA	pos=va,g=f,c=1,n=s,f=part
tAm	tad	pos=n,g=f,c=2,n=s
vahati	vah	pos=v,p=3,n=s,l=lat
eva	eva	pos=i
kAYcIm	kAYcI	pos=n,g=f,c=2,n=s
grAham	grah	pos=vi
grAham	grah	pos=vi
pfTu	pfTu	pos=a,g=n,c=2,n=s
pfTu	pfTu	pos=a,g=n,c=2,n=s
mayA	mad	pos=n,g=,c=3,n=s
mOktikam	mOktika	pos=n,g=n,c=2,n=s
gumBitA	yad	pos=n,g=f,c=1,n=s
SroRI	SroRI	pos=n,comp=y
bimbe	bimba	pos=n,g=m,c=7,n=s
su	su	pos=i
mahati	mahat	pos=a,g=m,c=7,n=s
tayA	tad	pos=n,g=f,c=3,n=s
BUzite	BUzay	pos=va,g=m,c=7,n=s,f=part
komala	komala	pos=a,comp=y
aNgAyAH	aNga	pos=a,g=f,c=6,n=s
sAla	sAla	pos=n,comp=y
AvItAm	Avye	pos=va,g=f,c=2,n=s,f=part
sa	tad	pos=n,g=m,c=1,n=s
kila	kila	pos=i
madano	madana	pos=n,g=m,c=1,n=s
manyate	man	pos=v,p=3,n=s,l=lat
rAjaDAnIm	rAjaDAnI	pos=n,g=f,c=2,n=s

# id = Kokila.2.31
mad	mad	pos=n,comp=y
ci	ci	pos=va,comp=y,f=part
AKya	AKya	pos=a,comp=y
dvipa	dvipa	pos=n,comp=y
niyamana	niyamana	pos=n,comp=y
AlAnayoH	AlAna	pos=n,g=m,c=6,n=d
dvandvam	dvaMdva	pos=n,g=n,c=1,n=s
UrvoH	Uru	pos=n,g=m,c=6,n=d
SroRI	SroRI	pos=n,comp=y
BArAt	BAra	pos=n,g=m,c=5,n=s
alasam	alasa	pos=a,g=n,c=1,n=s
aDunA	aDunA	pos=i
jAyate	jan	pos=v,p=3,n=s,l=lat
Kinna	Kid	pos=va,comp=y,f=part
Kinnam	Kid	pos=va,g=n,c=1,n=s,f=part
ArabDAnAm	AraB	pos=va,g=n,c=6,n=p,f=part
hara	hara	pos=n,g=m,c=8,n=s
hara	hara	pos=n,g=m,c=8,n=s
mayA	mad	pos=n,g=,c=3,n=s
yatra	yatra	pos=i
saMvAhanAnAm	saMvAhana	pos=n,g=n,c=6,n=p
nityam	nityam	pos=i
jAtA	jan	pos=va,g=m,c=1,n=p,f=part
niravaDi	niravaDi	pos=a,comp=y
rasAH	rasa	pos=n,g=m,c=1,n=p
ke	ka	pos=n,g=m,c=1,n=p
'pi	api	pos=i
ke	ka	pos=n,g=m,c=1,n=p
api	api	pos=i
antarAyAH	antara	pos=a,g=f,c=6,n=s

# id = Kokila.2.32
A	A	pos=i
dvAra	dvAra	pos=n,comp=y
antam	anta	pos=n,g=m,c=2,n=s
mad	mad	pos=n,comp=y
aBigamana	aBigamana	pos=n,comp=y
ASaNkayA	ASaNkA	pos=n,g=f,c=3,n=s
caYcala	caYcala	pos=a,comp=y
akzyAH	akzi	pos=n,g=f,c=6,n=s
yAtAyAtEH	yAtAyAta	pos=n,g=n,c=3,n=p
kisalaya	kisalaya	pos=n,comp=y
niBO	niBa	pos=a,g=m,c=1,n=d
kliSyataH	kliS	pos=v,p=3,n=d,l=lat
pAda	pAda	pos=n,comp=y
padmO	padma	pos=n,g=m,c=1,n=d
miTyA	miTyA	pos=i
gotra	gotra	pos=n,comp=y
sKalanam	sKalana	pos=n,g=n,c=1,n=s
asakft	asakft	pos=i
prastutam	prastu	pos=va,g=n,c=1,n=s,f=part
hanta	hanta	pos=i
yAByAm	yad	pos=n,g=m,c=3,n=d
labDum	laB	pos=vi
pAda	pAda	pos=n,comp=y
praRatIzu	praRati	pos=n,g=f,c=7,n=p
mayA	mad	pos=n,g=,c=3,n=s
hanta	hanta	pos=i
saMtAqanAni	saMtAqana	pos=n,g=n,c=1,n=p

# id = Kokila.2.33
yadi	yadi	pos=i
api	api	pos=i
asyAH	idam	pos=n,g=f,c=6,n=s
vapuH	vapus	pos=n,comp=y
vallarIm	vallarI	pos=n,g=f,c=2,n=s
vapurvallarIm	dIp	pos=va,g=m,c=1,n=s,f=part
viSleza	viSleza	pos=n,comp=y
agniH	agni	pos=n,g=m,c=1,n=s
dvi	dvi	pos=n,comp=y
guRayati	guRay	pos=v,p=3,n=s,l=lat
viSlezAgnirdviguRayati	tad	pos=n,g=f,c=2,n=s
tAm	kiMtu	pos=i
lAvaRya	lAvaRya	pos=n,comp=y
lakzmyam	lakzmI	pos=n,g=f,c=2,n=s
taptAm	tap	pos=va,g=f,c=2,n=s,f=part
taptAm	tap	pos=va,g=f,c=2,n=s,f=part
nayati	nI	pos=v,p=3,n=s,l=lat
nitarAm	nitarAm	pos=i
tAnavam	tAnava	pos=n,g=n,c=2,n=s
jAtavedA	jAtavedas	pos=n,g=m,c=1,n=s
hEmIm	hEma	pos=a,g=f,c=2,n=s
leKAm	leKA	pos=n,g=f,c=2,n=s
api	api	pos=i
tu	tu	pos=i
janayati	janay	pos=v,p=3,n=s,l=lat
eva	eva	pos=i
varRa	varRa	pos=n,comp=y
prakarzam	prakarza	pos=n,g=m,c=2,n=s

# id = Kokila.2.34
pfTvI	pfTvI	pos=n,comp=y
reRUn	reRu	pos=n,g=m,c=2,n=p
alaka	alaka	pos=n,comp=y
nikare	nikara	pos=n,g=m,c=7,n=s
netrayoH	netra	pos=n,g=n,c=6,n=d
bAzpa	bAzpa	pos=n,comp=y
pUram	pUra	pos=n,g=m,c=2,n=s
haste	hasta	pos=n,g=m,c=7,n=s
gaRqam	gaRqa	pos=n,g=m,c=2,n=s
sita	sita	pos=a,comp=y
bisa	bisa	pos=n,comp=y
latA	latA	pos=n,comp=y
AhAra	AhAra	pos=n,comp=y
jAlam	jAla	pos=n,g=n,c=2,n=s
stana	stana	pos=n,comp=y
agre	agra	pos=n,g=n,c=7,n=s
SroRyAm	SroRI	pos=n,g=f,c=7,n=s
kzOmam	kzOma	pos=n,g=n,c=2,n=s
malina	malina	pos=a,comp=y
masfRam	masfRa	pos=a,g=n,c=2,n=s
sA	tad	pos=n,g=f,c=1,n=s
vahati	vah	pos=v,p=3,n=s,l=lat
eva	eva	pos=i
hanta	hanta	pos=i
iti	iti	pos=i
AstAm	As	pos=v,p=3,n=s,l=lot
etat	etad	pos=n,g=n,c=1,n=s
bahu	bahu	pos=a,comp=y
vilapitEH	vilapita	pos=n,g=n,c=3,n=p
mA	mA	pos=i
astu	as	pos=v,p=3,n=s,l=lot
kAla	kAla	pos=n,comp=y
atipAtaH	atipAta	pos=n,g=m,c=1,n=s

# id = Kokila.2.35
sTitvA	sTA	pos=vi
cUte	cUta	pos=n,g=m,c=7,n=s
praTama	praTama	pos=a,comp=y
kaTite	kaTay	pos=va,g=m,c=7,n=s,f=part
mUQa	muh	pos=va,comp=y,f=part
kAntA	kAntA	pos=n,comp=y
aDara	aDara	pos=n,comp=y
ABam	ABa	pos=a,g=n,c=2,n=s
dazwvA	daMS	pos=vi
svEram	svEra	pos=a,g=n,c=2,n=s
kisalayam	kisalaya	pos=n,g=n,c=2,n=s
aTa	aTa	pos=i
prekzaRIyA	prekz	pos=va,g=f,c=1,n=s,f=krtya
tvayA	tvad	pos=n,g=,c=3,n=s
sA	tad	pos=n,g=f,c=1,n=s
pfcCantI	pracC	pos=va,g=f,c=1,n=s,f=part
vA	vA	pos=i
malaya	malaya	pos=n,comp=y
vapanam	vapana	pos=n,g=n,c=2,n=s
praSrayAt	praSraya	pos=n,g=m,c=5,n=s
mad	mad	pos=n,comp=y
pravftti	pravftti	pos=n,g=m,c=2,n=s
mad	mad	pos=n,comp=y
vfttAntam	vfttAnta	pos=n,g=m,c=2,n=s
kaTaya	kaTay	pos=v,p=2,n=s,l=lot
kaWinasya	kaWina	pos=a,g=m,c=6,n=s
iti	iti	pos=i
vA	vA	pos=i
prArTayantI	prArTay	pos=va,g=f,c=1,n=s,f=part

# id = Kokila.2.36
Cintte	Cid	pos=v,p=3,n=s,l=lat
tApam	tApa	pos=n,g=m,c=2,n=s
hima	hima	pos=a,comp=y
jala	jala	pos=n,comp=y
mayI	maya	pos=a,g=f,c=1,n=s
cAndanI	cAndana	pos=a,g=f,c=1,n=s
kim	kim	pos=i
nu	nu	pos=i
carcA	carcA	pos=n,g=f,c=1,n=s
manda	manda	pos=a,comp=y
spandAH	spanda	pos=n,g=m,c=1,n=p
kimu	kimu	pos=i
suKa	suKa	pos=n,comp=y
karAH	kara	pos=a,g=m,c=1,n=p
mArutAH	mAruta	pos=n,g=m,c=1,n=p
cAmarAnAm	cAmara	pos=n,g=n,c=6,n=p
pracC	pracC	pos=va,g=f,c=6,n=p,f=part
iti	iti	pos=i
savayasAm	savayas	pos=n,g=f,c=6,n=p
sa	sa	pos=i
atireke	atireka	pos=n,g=m,c=7,n=s
'pi	api	pos=i
tApe	tApa	pos=n,g=m,c=7,n=s
smitvA	smi	pos=vi
ramyam	ramya	pos=a,g=n,c=1,n=s
sakalam	sakala	pos=a,g=n,c=1,n=s
iti	iti	pos=i
vA	vA	pos=i
cittam	citta	pos=n,g=n,c=2,n=s
ASvAsay	ASvAsay	pos=va,g=f,c=1,n=s,f=part

# id = Kokila.2.37
praspandante	praspand	pos=v,p=3,n=p,l=lat
malaya	malaya	pos=n,comp=y
pavanAH	pavana	pos=n,g=m,c=1,n=p
runDi	ruD	pos=v,p=2,n=s,l=lot
jAlam	jAla	pos=n,g=n,c=2,n=s
kavAwEH	kavAwa	pos=n,g=m,c=3,n=p
SamBoH	SamBu	pos=n,g=m,c=6,n=s
nAmnA	nAman	pos=n,g=n,c=3,n=s
Sara	Sara	pos=n,comp=y
gaRa	gaRa	pos=n,comp=y
mucam	muc	pos=a,g=m,c=2,n=s
BIzayeH	BIzay	pos=v,p=2,n=s,l=vidhilin
paYcabARam	paYcabARa	pos=n,g=m,c=2,n=s
jIvam	jIva	pos=n,g=m,c=2,n=s
jIvam	jIva	pos=n,g=m,c=2,n=s
visfja	visfj	pos=v,p=2,n=s,l=lot
caritum	car	pos=vi
candrike	candrikA	pos=n,g=f,c=8,n=d
candrikAyAm	candrikA	pos=n,g=f,c=7,n=s
itTam	itTam	pos=i
cewIm	cewI	pos=n,g=f,c=2,n=s
sa	sa	pos=i
jala	jala	pos=n,comp=y
nayanAm	nayana	pos=n,g=f,c=2,n=s
AdiH	AdiS	pos=va,g=f,c=1,n=s,f=part
muhuH	muhur	pos=i
vA	vA	pos=i

# id = Kokila.2.38
prApta	prAp	pos=va,comp=y,f=part
AlambA	Alamba	pos=n,g=f,c=1,n=s
parijana	parijana	pos=n,comp=y
karEH	kara	pos=n,g=m,c=3,n=p
prApya	prAp	pos=vi
vA	vA	pos=i
citraSAlAm	citraSAlA	pos=n,g=f,c=2,n=s
mugDA	muh	pos=va,g=f,c=1,n=s,f=part
svasyAH	sva	pos=a,g=f,c=6,n=s
caraRa	caraRa	pos=n,comp=y
patitam	pat	pos=va,g=m,c=2,n=s,f=part
vA	vA	pos=i
iti	iti	pos=i
tam	tad	pos=n,g=m,c=2,n=s
mAm	mad	pos=n,g=,c=2,n=s
nirIkzya	nirIkz	pos=vi
ehi	e	pos=v,p=2,n=s,l=lot
uttizWa	utTA	pos=v,p=2,n=s,l=lot
priya	priya	pos=a,g=m,c=8,n=s
na	na	pos=i
kupitA	kup	pos=va,g=f,c=1,n=s,f=part
asmi	as	pos=v,p=1,n=s,l=lat
iti	iti	pos=i
bAzpa	bAzpa	pos=n,comp=y
Akula	Akula	pos=a,comp=y
akzI	akza	pos=a,g=f,c=1,n=s
gAQa	gAQa	pos=a,comp=y
ASleza	ASleza	pos=n,comp=y
pracalita	pracal	pos=va,comp=y,f=part
karA	kara	pos=n,g=f,c=1,n=s
ruDyamAnA	ruD	pos=va,g=f,c=1,n=s,f=part
saKIBiH	saKI	pos=n,g=f,c=3,n=p

# id = Kokila.2.39
kopam	kopa	pos=n,g=m,c=2,n=s
caRqi	caRqa	pos=a,g=f,c=8,n=s
tyaja	tyaj	pos=v,p=2,n=s,l=lot
parijane	parijana	pos=n,g=m,c=7,n=s
dEvam	dEva	pos=n,g=n,c=1,n=s
atra	atra	pos=i
aparAdDam	aparAD	pos=va,g=n,c=1,n=s,f=part
yena	yad	pos=n,g=n,c=3,n=s
akARqe	akARqa	pos=a,g=m,c=7,n=s
samaGawi	saMGaw	pos=v,p=3,n=s,l=lun
mahAn	mahat	pos=a,g=m,c=1,n=s
nO	mad	pos=n,g=,c=6,n=d
viprayogaH	viprayoga	pos=n,g=m,c=1,n=s
itTam	itTam	pos=i
badDAYjali	badDAYjali	pos=a,g=n,c=2,n=s
kfta	kf	pos=va,comp=y,f=part
ruzam	ruzA	pos=n,g=n,c=2,n=s
BAvitAm	BAvay	pos=va,g=f,c=2,n=s,f=part
agratas	agratas	pos=i
tAm	tad	pos=n,g=f,c=2,n=s
sA	tad	pos=n,g=f,c=1,n=s
aham	mad	pos=n,g=,c=1,n=s
BUtA	BU	pos=va,g=f,c=1,n=s,f=part
priya	priya	pos=a,comp=y
cawu	cawu	pos=n,comp=y
SatEH	Sata	pos=n,g=n,c=3,n=p
udyatA	udyam	pos=va,g=f,c=1,n=s,f=part
vA	vA	pos=i
anunI	anunI	pos=vi

# id = Kokila.2.40
gaRqa	gaRqa	pos=n,comp=y
AlambEH	Alamba	pos=n,g=n,c=3,n=p
lulitam	lul	pos=va,g=n,c=2,n=s,f=part
alakEH	alaka	pos=n,g=n,c=3,n=p
DUsarEH	DUsara	pos=a,g=n,c=3,n=p
vaktra	vaktra	pos=n,comp=y
bimbam	bimba	pos=n,g=n,c=2,n=s
dfzwvA	dfS	pos=vi
SudDa	SudDa	pos=a,comp=y
sPawika	sPawika	pos=n,comp=y
Gawite	Gaway	pos=va,g=m,c=7,n=s,f=part
bimbitam	bimbita	pos=a,g=n,c=2,n=s
Bitti	Bitti	pos=n,comp=y
BAge	BAga	pos=n,g=m,c=7,n=s
antaH	antar	pos=i
geham	geha	pos=n,g=n,c=2,n=s
jalada	jalada	pos=n,comp=y
SakalEH	Sakala	pos=n,g=m,c=3,n=p
AvftaH	Avf	pos=va,g=m,c=1,n=s,f=part
rohita	rohita	pos=a,comp=y
aNkaH	aNka	pos=n,g=m,c=1,n=s
kena	ka	pos=n,g=m,c=3,n=s
AnItaH	AnI	pos=va,g=m,c=1,n=s,f=part
pura	puras	pos=i
iti	iti	pos=i
BiyA	BI	pos=n,g=f,c=3,n=s
vyAharantI	vyAhf	pos=va,g=f,c=1,n=s,f=part
saKIH	saKI	pos=n,g=f,c=2,n=p
vA	vA	pos=i

# id = Kokila.2.41
nidrAm	nidrA	pos=n,g=f,c=2,n=s
prAptA	prAp	pos=va,g=f,c=1,n=s,f=part
kaTam	kaTam	pos=i
api	api	pos=i
cirAt	cirAt	pos=i
tatra	tatra	pos=i
ca	ca	pos=i
Alokin	Alokin	pos=a,g=f,c=1,n=s
mAm	mad	pos=n,g=,c=2,n=s
SUnya	SUnya	pos=a,comp=y
ASlezam	ASleza	pos=n,g=m,c=2,n=s
viracitavatI	viracay	pos=va,g=f,c=1,n=s,f=part
hanta	hanta	pos=i
GAtAt	GAta	pos=n,g=m,c=5,n=s
kuca	kuca	pos=n,comp=y
adri	adri	pos=n,g=m,c=6,n=d
nirBindAnA	nirBid	pos=va,g=f,c=1,n=s,f=part
nija	nija	pos=a,comp=y
kara	kara	pos=n,comp=y
Dftam	Df	pos=va,g=n,c=2,n=s,f=part
kaNkaRam	kaNkaRa	pos=n,g=n,c=2,n=s
srasta	sraMs	pos=va,comp=y,f=part
Sezam	Seza	pos=n,g=n,c=2,n=s
paSyantInAm	dfS	pos=va,g=f,c=6,n=p,f=part
nayana	nayana	pos=n,comp=y
kamale	kamala	pos=n,g=n,c=2,n=d
baDnatI	banD	pos=va,g=f,c=1,n=s,f=part
vA	vA	pos=i
saKInAm	saKI	pos=n,g=f,c=6,n=p

# id = Kokila.2.42
vakti	vac	pos=v,p=3,n=s,l=lat
DvANkzaH	DvANkza	pos=n,g=m,c=1,n=s
suhfd	suhfd	pos=n,comp=y
upagamam	upagama	pos=n,g=m,c=2,n=s
dakziRe	dakziRa	pos=a,g=m,c=7,n=s
kzIravfkze	kzIravfkza	pos=n,g=m,c=7,n=s
vAmam	vAma	pos=a,g=n,c=1,n=s
netram	netra	pos=n,g=n,c=1,n=s
sPurati	sPur	pos=v,p=3,n=s,l=lat
su	su	pos=i
cirAt	cirAt	pos=i
ucCvasiti	ucCvas	pos=v,p=3,n=s,l=lat
adya	adya	pos=i
cetaH	cetas	pos=n,g=n,c=1,n=s
kiYca	kiMca	pos=i
svAnaH	svAna	pos=n,g=m,c=1,n=s
SravaRa	SravaRa	pos=n,comp=y
maDuraH	maDura	pos=a,g=m,c=1,n=s
jAyate	jan	pos=v,p=3,n=s,l=lat
kokilAnAm	kokila	pos=n,g=m,c=6,n=p
prARezu	prARa	pos=n,g=m,c=7,n=p
ASAm	ASA	pos=n,g=f,c=2,n=s
iti	iti	pos=i
kaTam	kaTam	pos=i
api	api	pos=i
BrAtaH	BrAtf	pos=n,g=m,c=8,n=s
AbanD	AbanD	pos=va,g=f,c=1,n=s,f=part
vA	vA	pos=i

# id = Kokila.2.43
muktvA	muc	pos=vi
jIvAmi	jIv	pos=v,p=1,n=s,l=lat
asu	asu	pos=n,comp=y
samam	sama	pos=n,g=m,c=2,n=s
iti	iti	pos=i
vrIqitA	vrIq	pos=va,g=f,c=1,n=s,f=part
vismitA	vismi	pos=va,g=f,c=1,n=s,f=part
vA	vA	pos=i
tad	tad	pos=n,comp=y
saNga	saNga	pos=n,comp=y
ASA	ASA	pos=n,g=f,c=1,n=s
punaH	punar	pos=i
iha	iha	pos=i
param	param	pos=i
hetuH	hetu	pos=n,g=m,c=1,n=s
iti	iti	pos=i
AsInAH	As	pos=va,g=m,c=1,n=p,f=part
vA	vA	pos=i
SocantI	Suc	pos=va,g=f,c=1,n=s,f=part
mAm	mad	pos=n,g=,c=2,n=s
dayitam	dayita	pos=a,g=m,c=2,n=s
aTavA	aTavA	pos=i
viprayoga	viprayoga	pos=n,comp=y
asahizRum	asahizRu	pos=a,g=m,c=2,n=s
strIRAm	strI	pos=n,g=f,c=6,n=p
cezwAsu	cezwA	pos=n,g=f,c=7,n=p
iti	iti	pos=i
hi	hi	pos=i
viraha	viraha	pos=n,comp=y
utTa	utTa	pos=a,g=f,c=7,n=p
diH	diS	pos=n,comp=y
mAtram	mAtra	pos=n,g=n,c=1,n=s
etat	etad	pos=n,g=n,c=1,n=s

# id = Kokila.2.44
gAQa	gAQa	pos=a,comp=y
ASleza	ASleza	pos=n,comp=y
vyatikara	vyatikara	pos=n,comp=y
rasa	rasa	pos=n,comp=y
granTana	granTana	pos=n,comp=y
du	du	pos=va,g=m,c=1,n=s,f=part
saMBoga	samBoga	pos=n,comp=y
ante	anta	pos=n,g=m,c=7,n=s
svapana	svapana	pos=n,comp=y
viDyE	viDi	pos=n,g=f,c=4,n=s
yaH	yad	pos=n,g=m,c=1,n=s
purA	purA	pos=i
DUyate	DU	pos=v,p=3,n=s,l=lat
sma	sma	pos=i
kaRWa	kaRWa	pos=n,comp=y
utsaNgAt	utsaNga	pos=n,g=m,c=5,n=s
me	mad	pos=n,g=,c=6,n=s
sa	tad	pos=n,g=m,c=1,n=s
viDinA	viDi	pos=n,g=m,c=3,n=s
vEriRA	vErin	pos=a,g=m,c=3,n=s
dUra	dUra	pos=a,comp=y
kfzwaH	kfz	pos=va,g=m,c=1,n=s,f=part
vAmo	vAma	pos=a,g=m,c=1,n=s
bAhuH	bAhu	pos=n,g=m,c=1,n=s
tve	tvad	pos=n,g=,c=7,n=s
saviDage	yA	pos=v,p=3,n=s,l=lrt
spandam	spanda	pos=n,g=m,c=2,n=s
asyAH	idam	pos=n,g=f,c=6,n=s

# id = Kokila.2.45
vaktf	vaktf	pos=n,g=m,c=6,n=s
vaktram	vaktra	pos=n,g=n,c=1,n=s
tamasi	tamas	pos=n,g=n,c=7,n=s
Bavato	BU	pos=va,g=m,c=6,n=s,f=part
na	na	pos=i
eva	eva	pos=i
dfSyeta	dfS	pos=v,p=3,n=s,l=vidhilin
rAtrAv	rAtri	pos=n,g=f,c=7,n=s
A	A	pos=i
maDyAhnam	maDyAhna	pos=n,g=m,c=2,n=s
Bavati	BU	pos=v,p=3,n=s,l=lat
niyama	niyama	pos=n,comp=y
vyAkulA	vyAkula	pos=a,g=f,c=1,n=s
vAsare	vAsara	pos=n,g=m,c=7,n=s
sA	tad	pos=n,g=f,c=1,n=s
sahya	sah	pos=va,comp=y,f=krtya
sparSe	sparSa	pos=n,g=m,c=7,n=s
sati	as	pos=va,g=m,c=7,n=s,f=part
ravi	ravi	pos=n,comp=y
kare	kara	pos=n,g=m,c=7,n=s
tAm	tad	pos=n,g=f,c=2,n=s
a	a	pos=i
sahya	sah	pos=va,comp=y,f=krtya
smara	smara	pos=n,comp=y
Artim	Arti	pos=n,g=f,c=2,n=s
mad	mad	pos=n,comp=y
saMdeSam	saMdeSa	pos=n,g=m,c=2,n=s
maRi	maRi	pos=n,comp=y
valaBikAm	valaBikA	pos=n,g=f,c=2,n=s
ASritaH	ASri	pos=va,g=m,c=1,n=s,f=part
SrAvayeTAH	SrAvay	pos=v,p=2,n=s,l=vidhilin

# id = Kokila.2.46
tyaktvA	tyaj	pos=vi
cUtAn	cUta	pos=n,g=m,c=2,n=p
api	api	pos=i
kusumitAn	kusumita	pos=a,g=m,c=2,n=p
AgataH	Agam	pos=va,g=m,c=1,n=s,f=part
mad	mad	pos=n,comp=y
samIpam	samIpa	pos=n,g=n,c=2,n=s
kim	kim	pos=i
nu	nu	pos=i
eza	etad	pos=n,g=m,c=1,n=s
syAt	as	pos=v,p=3,n=s,l=vidhilin
kam	ka	pos=n,g=m,c=2,n=s
api	api	pos=i
AKyAtu	AKyAtu	pos=n,comp=y
kAmaH	kAma	pos=n,g=m,c=1,n=s
iti	iti	pos=i
AliBiH	Ali	pos=n,g=f,c=3,n=p
Bfta	Bf	pos=va,comp=y,f=part
jala	jala	pos=n,comp=y
kaRam	kaRA	pos=n,g=m,c=2,n=s
pARinA	pARi	pos=n,g=m,c=3,n=s
Amfj	Amfj	pos=va,comp=y,f=part
netram	netra	pos=n,g=m,c=2,n=s
dfzwaH	dfS	pos=va,g=m,c=1,n=s,f=part
spazwa	paS	pos=va,comp=y,f=part
akzaram	akzara	pos=n,g=n,c=1,n=s
iti	iti	pos=i
SanEH	SanEs	pos=i
SaMsitum	SaMs	pos=vi
prakrameTAH	prakram	pos=v,p=2,n=s,l=vidhilin

# id = Kokila.2.47
a	a	pos=i
mlAnA	mlA	pos=va,g=f,c=1,n=s,f=part
te	tvad	pos=n,g=,c=6,n=s
jayati	ji	pos=v,p=3,n=s,l=lat
kam	kam	pos=va,comp=y,f=krtya
aNge	aNga	pos=a,g=f,c=8,n=s
maNgalya	maNgalya	pos=a,comp=y
BUzA	BUzA	pos=n,g=f,c=1,n=s
patyuH	pati	pos=n,g=,c=6,n=s
pArSvAt	pArSva	pos=n,g=n,c=5,n=s
suhfd	suhfd	pos=n,g=m,c=1,n=s
aham	mad	pos=n,g=,c=1,n=s
upetaH	upe	pos=va,g=m,c=1,n=s,f=part
'smi	as	pos=v,p=1,n=s,l=lat
saMdeSa	saMdeSa	pos=n,comp=y
hAraH	hAra	pos=a,g=m,c=1,n=s
jAtam	jan	pos=va,g=m,c=2,n=s,f=part
vidDi	vid	pos=v,p=2,n=s,l=lot
Sruti	Sruti	pos=n,comp=y
suKa	suKa	pos=a,comp=y
giH	gir	pos=n,g=m,c=6,n=p
kokilAnAm	kokila	pos=n,g=m,c=6,n=p
kule	kula	pos=n,g=n,c=7,n=s
mAm	mad	pos=n,g=,c=2,n=s
ye	yad	pos=n,g=m,c=1,n=p
paYca	paYcan	pos=n,comp=y
izoH	izu	pos=n,g=m,c=6,n=s
kim	ka	pos=n,g=n,c=1,n=s
api	api	pos=i
paTika	paTika	pos=n,comp=y
AkarzaRam	AkarzaRa	pos=n,g=n,c=1,n=s
zazWam	zazWa	pos=a,g=n,c=1,n=s
astram	astra	pos=n,g=n,c=1,n=s

# id = Kokila.2.48
colezu	cola	pos=n,g=m,c=7,n=p
Aste	As	pos=v,p=3,n=s,l=lat
su	su	pos=i
muKe	muKa	pos=a,g=f,c=8,n=s
kuSalI	kuSalin	pos=a,g=m,c=1,n=s
tvad	tvad	pos=n,comp=y
priyaH	priya	pos=a,g=m,c=1,n=s
pfcCati	pracC	pos=v,p=3,n=s,l=lat
tvAm	tvad	pos=n,g=,c=2,n=s
kaccit	kaccit	pos=i
kzemam	kzema	pos=n,g=n,c=2,n=s
Bajati	Baj	pos=v,p=3,n=s,l=lat
BavatI	Bavat	pos=a,g=f,c=1,n=s
iti	iti	pos=i
Atta	AdA	pos=va,comp=y,f=part
vAcam	vAc	pos=n,g=m,c=2,n=s
Bavantam	Bavat	pos=a,g=m,c=2,n=s
BUyas	BUyas	pos=i
BUyas	BUyas	pos=i
kaTaya	kaTay	pos=v,p=2,n=s,l=lot
kaTaya	kaTay	pos=v,p=2,n=s,l=lot
iti	iti	pos=i
Alap	Alap	pos=va,g=f,c=1,n=s,f=part
aSru	aSru	pos=n,comp=y
miSrEH	miSra	pos=a,g=m,c=3,n=p
prIti	prIti	pos=n,comp=y
smerEH	smera	pos=a,g=m,c=3,n=p
madira	madira	pos=a,comp=y
nayanA	nayana	pos=n,g=f,c=1,n=s
mAnayizyati	mAnay	pos=v,p=3,n=s,l=lrt
apANgEH	apANga	pos=n,g=m,c=3,n=p

# id = Kokila.2.49
evam	evam	pos=i
brUyAH	brU	pos=v,p=2,n=s,l=vidhilin
punaH	punar	pos=i
ajani	jan	pos=v,p=3,n=s,l=lun
yaH	yad	pos=n,g=m,c=1,n=s
prema	preman	pos=n,comp=y
kope	kopa	pos=n,g=m,c=7,n=s
miTo	miTas	pos=i
vAm	tvad	pos=n,g=,c=6,n=d
jAte	jan	pos=va,g=n,c=7,n=s,f=part
mOne	mOna	pos=n,g=n,c=7,n=s
capala	capala	pos=a,comp=y
capalaH	capala	pos=a,g=m,c=1,n=s
tad	tad	pos=n,comp=y
kzaRam	kzaRa	pos=n,g=m,c=2,n=s
pUrva	pUrva	pos=n,comp=y
muktO	mukti	pos=n,g=f,c=7,n=s
tAdfH	tAdfS	pos=a,g=f,c=1,n=s
preman	preman	pos=n,g=,c=6,n=s
cira	cira	pos=a,comp=y
virahinaH	virahin	pos=a,g=m,c=6,n=s
prARanATasya	prARanATa	pos=n,g=m,c=6,n=s
vARI	vARI	pos=n,g=f,c=1,n=s
sA	tad	pos=n,g=f,c=1,n=s
iyam	idam	pos=n,g=f,c=1,n=s
mattaH	mad	pos=n,g=m,c=5,n=s
SravaRa	SravaRa	pos=n,comp=y
saras	saras	pos=n,g=n,c=3,n=s
SrUyatAm	Sru	pos=v,p=3,n=s,l=lot
SravaRIya	Sru	pos=va,comp=y,f=krtya
banDA	banDa	pos=n,g=f,c=1,n=s

# id = Kokila.2.50
kalyARa	kalyARa	pos=a,comp=y
aNge	aNga	pos=a,g=f,c=8,n=s
priya	priya	pos=a,comp=y
sahacarIm	sahacarI	pos=n,g=f,c=2,n=s
tvAm	tvad	pos=n,g=,c=2,n=s
an	an	pos=i
AsAday	AsAday	pos=va,g=n,c=3,n=p,f=part
bAhyEH	bAhya	pos=a,g=n,c=3,n=p
akzaBiH	akza	pos=n,g=n,c=3,n=p
saha	saha	pos=i
param	param	pos=i
aham	mad	pos=n,g=,c=1,n=s
yAmi	yA	pos=v,p=1,n=s,l=lat
kAm	ka	pos=n,g=f,c=2,n=s
api	api	pos=i
avasTAm	avasTA	pos=n,g=f,c=2,n=s
Danyam	Danya	pos=a,g=n,c=1,n=s
cetaH	cetas	pos=n,g=n,c=1,n=s
punaH	punar	pos=i
idam	idam	pos=n,g=n,c=1,n=s
ahorAtram	ahorAtra	pos=n,g=n,c=1,n=s
anya	anya	pos=n,comp=y
an	an	pos=i
apekzam	apekzA	pos=n,g=n,c=1,n=s
tve	tvad	pos=n,g=,c=7,n=s
Amagnam	Amajj	pos=va,g=n,c=1,n=s,f=part
bata	bata	pos=i
nanu	nanu	pos=i
pfTak	pfTak	pos=i
BAgyam	BAgya	pos=n,g=n,c=1,n=s
api	api	pos=i
ekajAnAm	ekaja	pos=a,g=m,c=6,n=p

# id = Kokila.2.51
mad	mad	pos=va,comp=y,f=part
BfNgEH	BfNga	pos=n,g=m,c=3,n=p
kumuda	kumuda	pos=n,comp=y
pavanEH	pavana	pos=n,g=m,c=3,n=p
tarj	tarj	pos=va,g=m,c=6,n=s,f=part
GorEH	Gora	pos=a,g=m,c=3,n=p
AtaNka	AtaNka	pos=n,comp=y
AKye	AKyA	pos=n,g=n,c=7,n=s
sarasi	saras	pos=n,g=n,c=7,n=s
luWato	luW	pos=va,g=m,c=6,n=s,f=part
hA	hA	pos=i
niSITe	niSITa	pos=n,g=m,c=7,n=s
niSITe	niSITa	pos=n,g=m,c=7,n=s
nidrA	nidrA	pos=n,comp=y
mUke	mUka	pos=a,g=n,c=7,n=s
jagati	jagant	pos=n,g=n,c=7,n=s
rudati	rud	pos=va,g=n,c=7,n=s,f=part
SvAsa	SvAsa	pos=n,comp=y
cintA	cintA	pos=n,comp=y
juzaH	juz	pos=a,g=m,c=6,n=s
me	mad	pos=n,g=,c=6,n=s
saMkrand	saMkrand	pos=va,g=m,c=1,n=p,f=part
cawula	cawula	pos=a,comp=y
nayane	nayana	pos=n,g=n,c=2,n=d
cakravAkAH	cakravAka	pos=n,g=m,c=1,n=p
sahAyAH	sahAya	pos=n,g=m,c=1,n=p

# id = Kokila.2.52
moha	moha	pos=n,comp=y
advEtam	advEta	pos=n,g=n,c=1,n=s
viharati	vihf	pos=v,p=3,n=s,l=lat
DftiH	Dfti	pos=n,g=f,c=1,n=s
lIyate	lI	pos=v,p=3,n=s,l=lat
jAqya	jAqya	pos=n,comp=y
mIne	mIna	pos=n,g=m,c=7,n=s
BAti	BA	pos=v,p=3,n=s,l=lat
unmAdaH	unmAda	pos=n,g=m,c=1,n=s
Bramati	Bram	pos=v,p=3,n=s,l=lat
matiH	mati	pos=n,g=f,c=1,n=s
ityAdi	ityAdi	pos=a,g=n,c=2,n=s
so	tad	pos=n,g=m,c=1,n=s
'ham	mad	pos=n,g=,c=1,n=s
na	na	pos=i
vedmi	vid	pos=v,p=1,n=s,l=lat
bARam	bARa	pos=n,g=m,c=2,n=s
muYcan	muc	pos=va,g=m,c=1,n=s,f=part
parisara	parisara	pos=n,comp=y
caraH	cara	pos=a,g=m,c=1,n=s
na	na	pos=i
svapan	svap	pos=va,g=m,c=1,n=s,f=part
na	na	pos=i
api	api	pos=i
KAdan	KAd	pos=va,g=m,c=1,n=s,f=part
kftsnam	kftsna	pos=a,g=n,c=2,n=s
jAnAti	jYA	pos=v,p=3,n=s,l=lat
alasa	alasa	pos=a,comp=y
gamane	gamana	pos=n,g=n,c=7,n=s
kevalam	kevalam	pos=i
paYcabARaH	paYcabARa	pos=n,g=m,c=1,n=s

# id = Kokila.2.53
kAle	kAla	pos=n,g=m,c=7,n=s
ca	ca	pos=i
asmin	idam	pos=n,g=m,c=7,n=s
kan	kan	pos=va,comp=y,f=part
ali	ali	pos=n,comp=y
BftaH	Bft	pos=a,g=f,c=1,n=p
kamp	kamp	pos=va,comp=y,f=part
agra	agra	pos=n,comp=y
pravAlAH	pravAla	pos=n,g=f,c=1,n=p
kamrA	kamra	pos=a,g=f,c=1,n=p
vallyaH	vallI	pos=n,g=f,c=1,n=p
kim	ka	pos=n,g=n,c=2,n=s
api	api	pos=i
marutA	marut	pos=n,g=m,c=3,n=s
cumbitA	cumb	pos=va,g=f,c=1,n=p,f=part
dakziRena	dakziRa	pos=a,g=m,c=3,n=s
kiMcid	kaScit	pos=n,g=n,c=2,n=s
dazwa	daMS	pos=va,comp=y,f=part
aDara	aDara	pos=n,comp=y
kisalayAm	kisalaya	pos=n,g=f,c=2,n=s
prAk	prAk	pos=i
mayA	mad	pos=n,g=,c=3,n=s
Boga	Boga	pos=n,comp=y
kAle	kAla	pos=n,g=m,c=7,n=s
SItkurvARAm	SItkf	pos=va,g=f,c=2,n=s,f=part
Duta	DU	pos=va,comp=y,f=part
kara	kara	pos=n,comp=y
talAm	tala	pos=n,g=f,c=2,n=s
tvAm	tvad	pos=n,g=,c=2,n=s
priye	priya	pos=a,g=f,c=8,n=s
smArayanti	smAray	pos=v,p=3,n=p,l=lat

# id = Kokila.2.54
aMsa	aMsa	pos=n,comp=y
Alambin	Alambin	pos=a,comp=y
SlaTa	SlaTa	pos=a,comp=y
kaca	kaca	pos=n,comp=y
Baram	Bara	pos=n,g=m,c=2,n=s
hasta	hasta	pos=n,comp=y
rudDa	ruD	pos=va,comp=y,f=part
ambara	ambara	pos=n,comp=y
antam	anta	pos=n,g=m,c=2,n=s
prAk	prAk	pos=i
krIqA	krIqA	pos=n,comp=y
ante	anta	pos=n,g=m,c=7,n=s
tava	tvad	pos=n,g=,c=6,n=s
maRi	maRi	pos=n,comp=y
gavAkza	gavAkza	pos=n,comp=y
upakaRWezu	upakaRWa	pos=n,g=n,c=7,n=p
cAram	cAra	pos=n,g=m,c=2,n=s
smAram	smf	pos=vi
smAram	smf	pos=vi
kaTam	kaTam	pos=i
api	api	pos=i
mayA	mad	pos=n,g=,c=3,n=s
muhyatA	muh	pos=va,g=m,c=3,n=s,f=part
sahyate	sah	pos=v,p=3,n=s,l=lat
'sO	adas	pos=n,g=m,c=1,n=s
mando	manda	pos=a,g=m,c=1,n=s
vAyuH	vAyu	pos=n,g=m,c=1,n=s
su	su	pos=i
tanu	tanu	pos=a,g=n,c=2,n=s
bakula	bakula	pos=n,comp=y
udBeda	udBeda	pos=n,comp=y
sOraBya	sOraBya	pos=n,comp=y
banDuH	banDu	pos=n,g=m,c=1,n=s

# id = Kokila.2.55
tIrtvA	tf	pos=vi
rAtrim	rAtri	pos=n,g=f,c=2,n=s
viraha	viraha	pos=n,comp=y
mahatIm	mahat	pos=a,g=f,c=2,n=s
tIvra	tIvra	pos=a,comp=y
tApAm	tApa	pos=n,g=f,c=2,n=s
kaTaYcid	kaTaMcid	pos=i
dfzwvA	dfS	pos=vi
BAnoH	BAnu	pos=n,g=m,c=6,n=s
kiraRam	kiraRa	pos=n,g=m,c=2,n=s
aruRam	aruRa	pos=a,g=m,c=2,n=s
jamBa	jamBa	pos=n,comp=y
SatroH	Satru	pos=n,g=m,c=6,n=s
diH	diS	pos=n,comp=y
ante	anta	pos=n,g=m,c=7,n=s
pratyudyAntIm	pratyudyA	pos=va,g=f,c=2,n=s,f=part
tvaritam	tvaritam	pos=i
abalAm	abalA	pos=n,g=f,c=2,n=s
Slizyate	Sliz	pos=v,p=3,n=s,l=lat
BAgya	BAgya	pos=n,comp=y
sIman	sIman	pos=n,g=n,c=4,n=s
sAraNga	sAraNga	pos=n,comp=y
akzi	akza	pos=a,g=f,c=8,n=s
spfhayati	spfhay	pos=v,p=3,n=s,l=lat
mano	manas	pos=n,g=n,c=2,n=s
hanta	hanta	pos=i
cakra	cakra	pos=n,comp=y
AKya	AKya	pos=a,comp=y
yuvan	yuvan	pos=n,g=,c=4,n=s

# id = Kokila.2.56
utkaRWo	utkaRWa	pos=a,g=m,c=1,n=s
'smi	as	pos=v,p=1,n=s,l=lat
tvad	tvad	pos=n,comp=y
udita	udi	pos=va,comp=y,f=part
DiyA	DI	pos=n,g=f,c=3,n=s
mUQa	muh	pos=va,comp=y,f=part
haMsI	haMsI	pos=n,comp=y
ninAde	ninAda	pos=n,g=m,c=7,n=s
tvad	tvad	pos=n,comp=y
BUzAyAm	BUzA	pos=n,g=f,c=7,n=s
hariti	harit	pos=a,g=f,c=7,n=s
satatam	satatam	pos=i
locane	locana	pos=n,g=n,c=2,n=d
pAtayAmi	pAtay	pos=v,p=1,n=s,l=lat
tvad	tvad	pos=n,comp=y
saMspfzwe	saMspfS	pos=va,g=n,c=7,n=s,f=part
mama	mad	pos=n,g=,c=6,n=s
ca	ca	pos=i
vapuzi	vapus	pos=n,g=n,c=7,n=s
prema	preman	pos=n,g=n,c=2,n=s
baDnAmi	banD	pos=v,p=1,n=s,l=lat
kAnte	kAntA	pos=n,g=f,c=8,n=s
satyam	satya	pos=n,g=n,c=2,n=s
prARAn	prARa	pos=n,g=m,c=2,n=p
api	api	pos=i
param	param	pos=i
aham	mad	pos=n,g=,c=1,n=s
tvad	tvad	pos=n,comp=y
priyAn	priya	pos=a,g=m,c=2,n=p
DArayAmi	DAray	pos=v,p=1,n=s,l=lat

# id = Kokila.2.57
tvam	tvad	pos=n,g=,c=1,n=s
ca	ca	pos=i
aham	mad	pos=n,g=,c=1,n=s
ca	ca	pos=i
kzitim	kziti	pos=n,g=f,c=2,n=s
upagatO	upagam	pos=va,g=m,c=1,n=d,f=part
iti	iti	pos=i
a	a	pos=i
viSleza	viSleza	pos=n,comp=y
cintA	cintA	pos=n,g=f,c=1,n=s
nindAvantO	nindAvat	pos=a,g=m,c=1,n=d
smara	smara	pos=n,g=m,c=7,n=s
iti	iti	pos=i
miTo	miTas	pos=i
vAkya	vAkya	pos=n,comp=y
saMBeda	samBeda	pos=n,comp=y
sOKyam	sOKya	pos=n,g=n,c=1,n=s
spfSyete	spfS	pos=v,p=3,n=d,l=lat
nO	mad	pos=n,g=,c=6,n=d
niSi	niS	pos=n,g=f,c=7,n=s
SaSi	SaSin	pos=n,comp=y
karEH	kara	pos=n,g=m,c=3,n=p
aNgake	aNgaka	pos=n,g=n,c=7,n=s
yOgapadyAt	yOgapadya	pos=n,g=n,c=5,n=s
tena	tena	pos=i
api	api	pos=i
asti	as	pos=v,p=3,n=s,l=lat
dvirada	dvirada	pos=n,comp=y
gamane	gamana	pos=n,g=n,c=7,n=s
satyam	satya	pos=n,g=n,c=1,n=s
ASleza	ASleza	pos=n,comp=y
budDiH	budDi	pos=n,g=f,c=1,n=s

# id = Kokila.2.58
hA	hA	pos=i
hanta	hanta	pos=i
asmin	idam	pos=n,g=n,c=7,n=s
a	a	pos=i
sulaBa	sulaBa	pos=a,comp=y
miTas	miTas	pos=i
darSane	darSana	pos=n,g=n,c=7,n=s
viprayoge	viprayoga	pos=n,g=m,c=7,n=s
sA	tad	pos=n,g=f,c=1,n=s
eva	eva	pos=i
AlambaH	Alamba	pos=n,g=m,c=1,n=s
mama	mad	pos=n,g=,c=6,n=s
BagavatI	Bagavat	pos=a,g=f,c=1,n=s
BAvanA	BAvanA	pos=n,comp=y
kalpa	kalpa	pos=n,comp=y
vallI	vallI	pos=n,g=f,c=1,n=s
tvA	tvad	pos=n,g=,c=2,n=s
AsInAm	As	pos=va,g=f,c=2,n=s,f=part
asakft	asakft	pos=i
anayA	idam	pos=n,g=f,c=3,n=s
gAQam	gAQam	pos=i
AliNgya	AliNgay	pos=vi
rAgAd	rAga	pos=n,g=m,c=5,n=s
aNka	aNka	pos=n,comp=y
ArUQAm	Aruh	pos=va,g=f,c=2,n=s,f=part
alaGu	alaGu	pos=a,comp=y
jaGane	jaGana	pos=n,g=f,c=8,n=s
na	na	pos=i
ucitam	ucita	pos=a,g=n,c=1,n=s
vaktum	vac	pos=vi
anyat	anya	pos=n,g=n,c=2,n=s

# id = Kokila.2.59
jAtam	jan	pos=va,g=n,c=1,n=s,f=part
ceto	cetas	pos=n,g=n,c=1,n=s
madana	madana	pos=n,comp=y
su	su	pos=i
Bawasya	Bawa	pos=n,g=m,c=6,n=s
adya	adya	pos=i
yogyam	yogya	pos=a,g=n,c=1,n=s
Saravyam	Saravya	pos=n,g=n,c=1,n=s
na	na	pos=i
eka	eka	pos=n,comp=y
Cidram	Cidra	pos=n,g=n,c=1,n=s
niyatam	niyatam	pos=i
amutas	amutas	pos=i
suBru	suBrU	pos=n,g=f,c=8,n=s
viBraMSi	viBraMSin	pos=a,g=n,c=1,n=s
DEryam	DErya	pos=n,g=n,c=1,n=s
kAlAt	kAla	pos=n,g=m,c=5,n=s
kzIRe	kzi	pos=va,g=m,c=7,n=s,f=part
punaH	punar	pos=i
avayave	avayava	pos=n,g=m,c=7,n=s
varDate	vfD	pos=v,p=3,n=s,l=lat
kevalam	kevalam	pos=i
no	no	pos=i
tApaH	tApa	pos=n,g=m,c=1,n=s
tIvra	tIvra	pos=a,comp=y
smara	smara	pos=n,comp=y
hutaBuj	hutaBuj	pos=n,g=m,c=3,n=s
tasya	tad	pos=n,g=m,c=6,n=s
varRa	varRa	pos=n,comp=y
udgamaH	udgama	pos=n,g=m,c=1,n=s
'pi	api	pos=i

# id = Kokila.2.60
evaMprAyA	evamprAya	pos=a,g=m,c=1,n=p
na	na	pos=i
hi	hi	pos=i
na	na	pos=i
virahe	viraha	pos=n,g=m,c=7,n=s
jIvitum	jIv	pos=vi
santi	as	pos=v,p=3,n=p,l=lat
upAyAH	upAya	pos=n,g=m,c=1,n=p
satyam	satya	pos=n,g=n,c=1,n=s
tEH	tad	pos=n,g=m,c=3,n=p
tEH	tad	pos=n,g=m,c=3,n=p
kfta	kf	pos=va,comp=y,f=part
DftiH	Dfti	pos=n,g=m,c=1,n=s
aham	mad	pos=n,g=,c=1,n=s
prARimi	prAR	pos=v,p=1,n=s,l=lat
prARa	prARa	pos=n,comp=y
nATe	nATa	pos=n,g=f,c=8,n=s
niScitya	niSci	pos=vi
evam	evam	pos=i
nirupama	nirupama	pos=a,comp=y
guRe	guRa	pos=n,g=f,c=8,n=s
sAhaseByo	sAhasa	pos=n,g=n,c=5,n=p
nivfttA	nivft	pos=va,g=f,c=1,n=s,f=part
tvam	tvad	pos=n,g=,c=1,n=s
ca	ca	pos=i
snAna	snAna	pos=n,comp=y
Adizu	Adi	pos=n,g=n,c=7,n=p
savayasAm	savayas	pos=n,g=f,c=6,n=p
prArTanAm	prArTanA	pos=n,g=f,c=2,n=s
mA	mad	pos=n,g=,c=2,n=s
nizeDIH	niziD	pos=v,p=2,n=s,l=lun_unaug

# id = Kokila.2.61
tIrRa	tf	pos=va,comp=y,f=part
prAyaH	prAya	pos=n,g=m,c=1,n=s
viraha	viraha	pos=n,comp=y
jalaDiH	jalaDi	pos=n,g=m,c=1,n=s
SElakanyA	SElakanyA	pos=n,comp=y
prasAdAt	prasAda	pos=n,g=m,c=5,n=s
Sezam	Seza	pos=a,g=n,c=1,n=s
mAsa	mAsa	pos=n,comp=y
dvitayam	dvitaya	pos=n,g=n,c=1,n=s
abale	abalA	pos=n,g=f,c=8,n=s
sahyatAm	sah	pos=v,p=3,n=s,l=lot
mA	mA	pos=i
vizIda	vizad	pos=v,p=2,n=s,l=lot
DUpa	DUpa	pos=n,comp=y
udgArEH	udgAra	pos=n,g=m,c=3,n=p
suraBizu	suraBi	pos=a,g=n,c=7,n=p
tato	tatas	pos=i
BIru	BIru	pos=a,g=f,c=8,n=s
sODa	sODa	pos=n,comp=y
antarezu	antara	pos=n,g=n,c=7,n=p
krIqizyAvo	krIq	pos=v,p=1,n=d,l=lrt
nava	nava	pos=a,comp=y
jalaDara	jalaDara	pos=n,comp=y
DvAna	DvAna	pos=n,comp=y
mandrAni	mandra	pos=a,g=n,c=2,n=p
ahAni	ahar	pos=n,g=n,c=2,n=p

# id = Kokila.2.62
kaccit	kaccit	pos=i
citte	citta	pos=n,g=n,c=7,n=s
sPurati	sPur	pos=v,p=3,n=s,l=lat
capala	capala	pos=a,comp=y
apANge	apANga	pos=a,g=f,c=8,n=s
cUrRyAm	cUrRI	pos=n,g=f,c=7,n=s
kadAcit	kadAcid	pos=i
srasta	sraMs	pos=va,comp=y,f=part
uttaMsam	uttaMsa	pos=n,g=n,c=1,n=s
Davala	Davala	pos=a,comp=y
nayanam	nayana	pos=n,g=n,c=1,n=s
DOta	DAv	pos=va,comp=y,f=part
biMba	bimba	pos=n,comp=y
aDara	aDara	pos=n,comp=y
uzWam	uzWa	pos=n,g=n,c=1,n=s
snAna	snAna	pos=n,comp=y
ante	anta	pos=n,g=m,c=7,n=s
te	tvad	pos=n,g=,c=6,n=s
muKam	muKa	pos=n,g=n,c=1,n=s
upa	upa	pos=i
saKi	saKI	pos=n,g=f,c=8,n=s
prekzamARe	prekz	pos=va,g=m,c=7,n=s,f=part
mayi	mad	pos=n,g=,c=7,n=s
drAk	drAk	pos=i
vakzaH	vakzas	pos=n,comp=y
daGne	daGna	pos=a,g=n,c=7,n=s
payasi	payas	pos=n,g=n,c=7,n=s
punaH	punar	pos=i
api	api	pos=i
nO	mad	pos=n,g=,c=6,n=d
majjanam	majjana	pos=n,g=n,c=1,n=s
tat	tad	pos=n,g=n,c=1,n=s

# id = Kokila.2.63
ASlizyantam	ASliz	pos=va,g=m,c=2,n=s,f=part
viwapa	viwapa	pos=n,comp=y
BujayA	Buja	pos=n,g=f,c=3,n=s
tatra	tatra	pos=i
vallIH	vallI	pos=n,g=f,c=2,n=p
anekAH	aneka	pos=a,g=f,c=2,n=p
krIqA	krIqA	pos=n,comp=y
ArAme	ArAma	pos=n,g=m,c=7,n=s
kam	ka	pos=n,g=m,c=2,n=s
api	api	pos=i
taruRam	taruRa	pos=a,g=m,c=2,n=s
vIkzya	vIkz	pos=vi
mAkanda	mAkanda	pos=n,comp=y
vfkzam	vfkza	pos=n,g=m,c=2,n=s
sAcI	sAcI	pos=n,comp=y
kftya	kft	pos=vi
sPurat	sPur	pos=va,comp=y,f=part
aDarayA	aDara	pos=n,g=f,c=3,n=s
caRqi	caRqa	pos=a,g=f,c=8,n=s
vaktram	vaktra	pos=n,g=n,c=2,n=s
BavatyA	Bavat	pos=a,g=f,c=3,n=s
su	su	pos=i
BrU	BrU	pos=n,comp=y
BaNgaH	BaNga	pos=n,g=m,c=1,n=s
sa	sa	pos=i
jala	jala	pos=n,comp=y
kaRikaH	kaRikA	pos=n,g=m,c=1,n=s
prezito	prezay	pos=va,g=m,c=1,n=s,f=part
mayi	mad	pos=n,g=,c=7,n=s
apANgaH	apANga	pos=n,g=m,c=1,n=s

# id = Kokila.2.64
pratyAKyAtaH	pratyAKyA	pos=va,g=m,c=1,n=s,f=part
praRayini	praRayin	pos=a,g=f,c=8,n=s
ruzA	ruz	pos=n,g=f,c=3,n=s
bimbito	bimbita	pos=a,g=m,c=1,n=s
'ham	mad	pos=n,g=,c=1,n=s
stane	stana	pos=n,g=m,c=7,n=s
te	tvad	pos=n,g=,c=6,n=s
sEranDrI	sEranDrI	pos=n,g=f,c=1,n=s
ajYA	ajYa	pos=a,g=f,c=1,n=s
sTagay	sTagay	pos=vi
aBUt	BU	pos=v,p=3,n=s,l=lun
candanena	candana	pos=n,g=n,c=3,n=s
pravfttA	pravft	pos=va,g=f,c=1,n=s,f=part
mA	mA	pos=i
pAwIram	pAwIra	pos=n,g=m,c=2,n=s
pulakini	pulakin	pos=a,g=m,c=7,n=s
punaH	punar	pos=i
ca	ca	pos=i
atra	atra	pos=i
limpa	lip	pos=v,p=2,n=s,l=lot
iti	iti	pos=i
SaMsaty	SaMs	pos=va,g=n,c=7,n=s,f=part
AlI	Ali	pos=n,comp=y
vfnde	vfnda	pos=n,g=n,c=7,n=s
smita	smita	pos=n,comp=y
juH	juz	pos=a,g=n,c=7,n=s
kftA	kf	pos=va,g=f,c=1,n=s,f=part
dfH	dfS	pos=n,g=f,c=1,n=s
tvayA	tvad	pos=n,g=,c=3,n=s
vrIqa	vrIqa	pos=n,comp=y
garBA	garBa	pos=n,g=f,c=1,n=s

# id = Kokila.2.65
uccinvatyAH	ucci	pos=va,g=f,c=6,n=s,f=part
kisalaya	kisalaya	pos=n,comp=y
rucA	ruc	pos=n,g=f,c=3,n=s
pARinA	pARi	pos=n,g=m,c=3,n=s
udyAna	udyAna	pos=n,comp=y
puzpam	puzpa	pos=n,g=n,c=2,n=s
sAkam	sAkam	pos=i
BfNgEH	BfNga	pos=n,g=m,c=3,n=p
te	tvad	pos=n,g=,c=6,n=s
mayi	mad	pos=n,g=,c=7,n=s
muKa	muKa	pos=n,comp=y
amBoja	amBoja	pos=n,comp=y
sOraBya	sOraBya	pos=n,comp=y
lubDe	luB	pos=va,g=m,c=7,n=s,f=part
reRu	reRu	pos=n,comp=y
tras	tras	pos=va,g=f,c=1,n=p,f=part
iva	iva	pos=i
sumanasAm	sumanas	pos=n,g=f,c=6,n=p
dakziRAH	dakziRa	pos=a,g=f,c=1,n=p
keli	keli	pos=n,comp=y
saKyaH	saKI	pos=n,g=f,c=1,n=p
kaMcid	kaScit	pos=n,g=m,c=2,n=s
kAlam	kAla	pos=n,g=m,c=2,n=s
karakisalayEH	karakisalaya	pos=n,g=m,c=3,n=p
apyaDuH	apiDA	pos=v,p=3,n=p,l=lun
locanAni	locana	pos=n,g=n,c=2,n=p

# id = Kokila.2.66
iti	iti	pos=i
etasmAt	etad	pos=n,g=n,c=5,n=s
me	mad	pos=n,g=,c=6,n=s
kuSalin	kuSalin	pos=a,comp=y
tAm	tA	pos=n,g=f,c=2,n=s
vidDi	vid	pos=v,p=2,n=s,l=lot
aBijYAna	aBijYAna	pos=n,comp=y
dAnAt	dAna	pos=n,g=n,c=5,n=s
BUyas	BUyas	pos=i
ca	ca	pos=i
ekam	eka	pos=n,g=m,c=2,n=s
SfRu	Sru	pos=v,p=2,n=s,l=lot
sahacarIm	sahacarI	pos=n,g=f,c=2,n=s
Duta	DU	pos=va,comp=y,f=part
na	na	pos=i
eka	eka	pos=n,comp=y
anunItim	anunIti	pos=n,g=f,c=2,n=s
keli	keli	pos=n,comp=y
haMse	haMsa	pos=n,g=m,c=7,n=s
smara	smara	pos=n,comp=y
juH	juz	pos=a,g=m,c=7,n=s
haWAt	haWa	pos=n,g=m,c=5,n=s
cumb	cumb	pos=va,g=m,c=7,n=s,f=part
Izat	Izat	pos=i
stan	stan	pos=va,g=f,c=2,n=s,f=part
tvam	tvad	pos=n,g=,c=1,n=s
tu	tu	pos=i
smftvA	smf	pos=vi
kim	ka	pos=n,g=n,c=2,n=s
api	api	pos=i
bahala	bahala	pos=a,comp=y
vrIqam	vrIqA	pos=n,g=m,c=2,n=s
AlokaTAH	Alok	pos=v,p=2,n=s,l=lan
mAm	mad	pos=n,g=,c=2,n=s

# id = Kokila.2.67
rAgo	rAga	pos=n,g=m,c=1,n=s
nAma	nAma	pos=i
truwati	truw	pos=v,p=3,n=s,l=lat
virahena	viraha	pos=n,g=m,c=3,n=s
iti	iti	pos=i
loka	loka	pos=n,comp=y
pravAdaH	pravAda	pos=n,g=m,c=1,n=s
tvad	tvad	pos=n,comp=y
sambadDaH	sambanD	pos=va,g=m,c=1,n=s,f=part
mama	mad	pos=n,g=,c=6,n=s
SataguRaH	SataguRa	pos=a,g=m,c=1,n=s
saMgamAt	saMgama	pos=n,g=m,c=5,n=s
viprayoge	viprayoga	pos=n,g=m,c=7,n=s
so	tad	pos=n,g=m,c=1,n=s
'yam	idam	pos=n,g=m,c=1,n=s
Bedo	Beda	pos=n,g=m,c=1,n=s
vizaya	vizaya	pos=n,comp=y
BidayA	BidA	pos=n,g=f,c=3,n=s
saNgame	saMgama	pos=n,g=m,c=7,n=s
tvam	tvad	pos=n,g=,c=1,n=s
kila	kila	pos=i
ekA	eka	pos=n,g=f,c=1,n=s
viSleze	viSleza	pos=n,g=m,c=7,n=s
tu	tu	pos=i
triBuvanam	triBuvana	pos=n,g=n,c=1,n=s
idam	idam	pos=n,g=n,c=1,n=s
jAyate	jan	pos=v,p=3,n=s,l=lat
tvad	tvad	pos=n,comp=y
mayam	maya	pos=a,g=n,c=1,n=s
hi	hi	pos=i

# id = Kokila.2.68
etat	etad	pos=n,g=n,c=1,n=s
kftyam	kftya	pos=n,g=n,c=1,n=s
priya	priya	pos=a,comp=y
saKEH	saKa	pos=n,g=m,c=8,n=s
mama	mad	pos=n,g=,c=6,n=s
BrAtuH	BrAtf	pos=n,g=m,c=6,n=s
Artasya	Arta	pos=a,g=m,c=6,n=s
kftvA	kf	pos=vi
nAsIraH	as	pos=v,p=2,n=s,l=vidhilin
syA	jagant	pos=n,g=n,c=7,n=s
karuRA	karuRA	pos=n,comp=y
SAlinAm	SAlin	pos=a,g=m,c=6,n=p
karuRASAlinAm	saMviBAga	pos=n,g=m,c=7,n=s
SaMsanti	SaMs	pos=v,p=3,n=p,l=lat
tvAm	tvad	pos=n,g=,c=2,n=s
nanu	nanu	pos=i
paraBftam	paraBfta	pos=n,g=m,c=2,n=s
SESave	SESava	pos=n,g=n,c=7,n=s
yat	yat	pos=i
BftaH	Bf	pos=va,g=m,c=1,n=s,f=part
'nyEH	anya	pos=n,g=m,c=3,n=p
pattrin	pattrin	pos=n,comp=y
vrAta	vrAta	pos=n,comp=y
ABaraREH	ABaraRa	pos=n,g=m,c=8,n=s
BaraRena	BaraRa	pos=n,g=n,c=3,n=s
adya	adya	pos=i
sa	tad	pos=n,g=m,c=1,n=s
tvam	tvad	pos=n,g=,c=1,n=s
parezAm	para	pos=n,g=m,c=6,n=p

# id = Kokila.2.69
evam	evam	pos=i
tasyA	tad	pos=n,g=f,c=6,n=s
viraha	viraha	pos=n,comp=y
viDuram	viDura	pos=a,g=n,c=2,n=s
jIvitam	jIvita	pos=n,g=n,c=2,n=s
sTApayitvA	sTApay	pos=vi
gacCa	gam	pos=v,p=2,n=s,l=lot
sva	sva	pos=a,comp=y
icCA	icCA	pos=n,comp=y
viharaREH	viharaRa	pos=n,g=m,c=8,n=s
yaTA	yaTA	pos=i
prArTitam	prArTay	pos=va,g=m,c=2,n=s,f=part
diH	diS	pos=n,comp=y
viBAgam	viBAga	pos=n,g=m,c=2,n=s
man	man	pos=va,comp=y,f=krtya
SrIH	SrI	pos=n,g=f,c=1,n=s
syAt	as	pos=v,p=3,n=s,l=vidhilin
madana	madana	pos=n,comp=y
nfpateH	nfpati	pos=n,g=m,c=6,n=s
kokilA	kokilA	pos=n,g=f,c=1,n=s
te	tvad	pos=n,g=,c=6,n=s
'nukUlA	anukUla	pos=a,g=f,c=1,n=s
BUyAt	BU	pos=v,p=3,n=s,l=ashirlin
mA	mA	pos=i
evam	evam	pos=i
sakft	sakft	pos=i
api	api	pos=i
tayA	tad	pos=n,g=f,c=3,n=s
viprayoga	viprayoga	pos=n,comp=y
prasaNgaH	prasaNga	pos=n,g=m,c=1,n=s

