# id = Megh.1.1
kaScit	kaScit	pos=n,g=m,c=1,n=s
kAntA	kAntA	pos=n,comp=y
viraha	viraha	pos=n,comp=y
guruRA	guru	pos=a,g=m,c=3,n=s
sva	sva	pos=a,comp=y
aDikArAt	aDikAra	pos=n,g=m,c=5,n=s
pramattaH	pramad	pos=va,g=m,c=1,n=s,f=part
SApena	SApa	pos=n,g=m,c=3,n=s
astaMgamita	astaMgamay	pos=va,comp=y,f=part
mahimA	mahiman	pos=n,g=m,c=1,n=s
varza	varza	pos=n,comp=y
BogyeRa	Buj	pos=va,g=m,c=3,n=s,f=krtya
BartuH	Bartf	pos=n,g=m,c=6,n=s
yakzaH	yakza	pos=n,g=m,c=1,n=s
cakre	kf	pos=v,p=3,n=s,l=lit
janakatanayA	janakatanayA	pos=n,comp=y
snAna	snAna	pos=n,comp=y
puRya	puRya	pos=a,comp=y
udakezu	udaka	pos=n,g=m,c=7,n=p
snigDa	snigDa	pos=a,comp=y
CAyA	CAyA	pos=n,comp=y
taruzu	taru	pos=n,g=m,c=7,n=p
vasatim	vasati	pos=n,g=f,c=2,n=s
rAmagiri	rAmagiri	pos=n,comp=y
ASramezu	ASrama	pos=n,g=m,c=7,n=p

# id = Megh.1.2
tasmin	tad	pos=n,g=m,c=7,n=s
adrO	adri	pos=n,g=m,c=7,n=s
katicid	katicid	pos=i
abalA	abalA	pos=n,comp=y
viprayuktaH	viprayuj	pos=va,g=m,c=1,n=s,f=part
sa	tad	pos=n,g=m,c=1,n=s
kAmI	kAmin	pos=n,g=m,c=1,n=s
nItvA	nI	pos=vi
mAsAn	mAsa	pos=n,g=m,c=2,n=p
kanaka	kanaka	pos=n,comp=y
valaya	valaya	pos=n,comp=y
BraMSa	BraMSa	pos=n,comp=y
rikta	ric	pos=va,comp=y,f=part
prakozWaH	prakozWa	pos=n,g=m,c=1,n=s
AzAQasya	AzAQa	pos=n,g=m,c=6,n=s
praTama	praTama	pos=a,comp=y
divase	divasa	pos=n,g=m,c=7,n=s
meGam	meGa	pos=n,g=m,c=2,n=s
ASlizwa	ASliz	pos=va,comp=y,f=part
sAnum	sAnu	pos=n,g=m,c=2,n=s
vapra	vapra	pos=n,comp=y
krIqA	krIqA	pos=n,comp=y
pariRata	pariRam	pos=va,comp=y,f=part
gaja	gaja	pos=n,comp=y
prekzaRIyam	prekz	pos=va,g=m,c=2,n=s,f=krtya
dadarSa	dfS	pos=v,p=3,n=s,l=lit

# id = Megh.1.3
tasya	tad	pos=n,g=m,c=6,n=s
sTitvA	sTA	pos=vi
kaTam	kaTam	pos=i
api	api	pos=i
puraH	puras	pos=i
kOtuka	kOtuka	pos=n,comp=y
ADAna	ADAna	pos=n,comp=y
hetoH	hetu	pos=n,g=m,c=5,n=s
antaH	antar	pos=i
bAzpaH	bAzpa	pos=n,g=m,c=1,n=s
ciram	ciram	pos=i
anucaro	anucara	pos=n,g=m,c=1,n=s
rAjarAjasya	rAjarAja	pos=n,g=m,c=6,n=s
daDyO	DyA	pos=v,p=3,n=s,l=lit
meGa	meGa	pos=n,comp=y
Aloke	Aloka	pos=n,g=m,c=7,n=s
Bavati	BU	pos=v,p=3,n=s,l=lat
suKino	suKin	pos=a,g=m,c=6,n=s
api	api	pos=i
anyaTAvftti	anyaTAvftti	pos=a,g=n,c=1,n=s
cetaH	cetas	pos=n,g=n,c=1,n=s
kaRWa	kaRWa	pos=n,comp=y
ASleza	ASleza	pos=n,comp=y
praRayini	praRayin	pos=a,g=m,c=7,n=s
jane	jana	pos=n,g=m,c=7,n=s
kim	ka	pos=n,g=n,c=1,n=s
punaH	punar	pos=i
dUra	dUra	pos=a,comp=y
saMsTe	saMsTa	pos=a,g=m,c=7,n=s

# id = Megh.1.4
pratyAsanne	pratyAsad	pos=va,g=n,c=7,n=s,f=part
naBasi	naBas	pos=n,g=n,c=7,n=s
dayitA	dayitA	pos=n,comp=y
jIvita	jIvita	pos=n,comp=y
Alambana	Alambana	pos=n,comp=y
arTI	arTin	pos=a,g=m,c=1,n=s
jImUtena	jImUta	pos=n,g=m,c=3,n=s
sva	sva	pos=a,comp=y
kuSala	kuSala	pos=n,comp=y
mayIm	maya	pos=a,g=f,c=2,n=s
hArayizyan	hAray	pos=va,g=m,c=1,n=s,f=part
pravfttim	pravftti	pos=n,g=f,c=2,n=s
sa	tad	pos=n,g=m,c=1,n=s
pratyagrEH	pratyagra	pos=a,g=n,c=3,n=p
kuwaja	kuwaja	pos=n,comp=y
kusumEH	kusuma	pos=n,g=n,c=3,n=p
kalpita	kalpay	pos=va,comp=y,f=part
arGAya	arGa	pos=n,g=m,c=4,n=s
tasmE	tad	pos=n,g=m,c=4,n=s
prItaH	prI	pos=va,g=m,c=1,n=s,f=part
prIti	prIti	pos=n,g=f,comp=y
pramuKa	pramuKa	pos=a,comp=y
vacanam	vacana	pos=n,g=n,c=2,n=s
svAgatam	svAgata	pos=n,g=m,c=2,n=s
vyAjahAra	vyAhf	pos=v,p=3,n=s,l=lit

# id = Megh.1.5
DUma	DUma	pos=n,comp=y
jyotiH	jyotis	pos=n,comp=y
salila	salila	pos=n,comp=y
marutAm	marut	pos=n,g=m,c=6,n=p
saMnipAtaH	saMnipAta	pos=n,g=m,c=1,n=s
kva	kva	pos=i
meGaH	meGa	pos=n,g=m,c=1,n=s
saMdeSa	saMdeSa	pos=n,comp=y
arTAH	arTa	pos=n,g=m,c=1,n=p
kva	kva	pos=i
pawu	pawu	pos=a,comp=y
karaREH	karaRa	pos=n,g=m,c=3,n=p
prARiBiH	prARin	pos=n,g=m,c=3,n=p
prApaRIyAH	prAp	pos=va,g=m,c=1,n=p,f=krtya
iti	iti	pos=i
OtsukyAt	Otsukya	pos=n,g=n,c=5,n=s
aparigaRayan	aparigaRayat	pos=a,g=m,c=1,n=s
guhyakaH	guhyaka	pos=n,g=m,c=1,n=s
tam	tad	pos=n,g=m,c=2,n=s
yayAce	yAc	pos=v,p=3,n=s,l=lit
kAma	kAma	pos=n,comp=y
ArtAH	Arta	pos=a,g=m,c=1,n=p
hi	hi	pos=i
prakfti	prakfti	pos=n,comp=y
kfpaRAH	kfpaRa	pos=a,g=m,c=1,n=p
cetana	cetana	pos=a,comp=y
acetanezu	acetana	pos=a,g=m,c=7,n=p

# id = Megh.1.6
jAtam	jan	pos=va,g=m,c=2,n=s,f=part
vaMSe	vaMSa	pos=n,g=m,c=7,n=s
Buvana	Buvana	pos=n,comp=y
vidite	vid	pos=va,g=m,c=7,n=s,f=part
puzkarAvartakAnAm	puzkarAvartaka	pos=n,g=m,c=6,n=p
jAnAmi	jYA	pos=v,p=1,n=s,l=lat
tvAm	tvad	pos=n,g=,c=2,n=s
prakftipuruzam	prakftipuruza	pos=n,g=m,c=2,n=s
kAmarUpam	kAmarUpa	pos=a,g=m,c=2,n=s
maGonaH	maGavan	pos=n,g=,c=6,n=s
tena	tad	pos=n,g=m,c=3,n=s
arTitvam	arTitva	pos=n,g=n,c=1,n=s
tvayi	tvad	pos=n,g=,c=7,n=s
viDi	viDi	pos=n,comp=y
vaSAt	vaSa	pos=n,g=m,c=5,n=s
dUra	dUra	pos=a,comp=y
banDuH	banDu	pos=n,g=m,c=1,n=s
gataH	gam	pos=va,g=m,c=1,n=s,f=part
'ham	mad	pos=n,g=,c=1,n=s
yAcYA	yAcYA	pos=n,g=f,c=1,n=s
moGA	moGa	pos=a,g=f,c=1,n=s
varam	vara	pos=a,g=n,c=2,n=s
aDiguRe	aDiguRa	pos=a,g=m,c=7,n=s
na	na	pos=i
aDame	aDama	pos=a,g=m,c=7,n=s
labDa	laB	pos=va,comp=y,f=part
kAmA	kAma	pos=n,g=f,c=1,n=s

# id = Megh.1.7
saMtaptAnAm	saMtap	pos=va,g=m,c=6,n=p,f=part
tvam	tvad	pos=n,g=,c=1,n=s
asi	as	pos=v,p=2,n=s,l=lat
SaraRam	SaraRa	pos=n,g=n,c=1,n=s
tat	tad	pos=n,g=n,c=2,n=s
payoda	payoda	pos=n,g=m,c=8,n=s
priyAyAH	priyA	pos=n,g=f,c=6,n=s
saMdeSam	saMdeSa	pos=n,g=m,c=2,n=s
me	mad	pos=n,g=,c=6,n=s
hara	hf	pos=v,p=2,n=s,l=lot
Danapati	Danapati	pos=n,comp=y
kroDa	kroDa	pos=n,comp=y
viSlezitasya	viSlezay	pos=va,g=m,c=6,n=s,f=part
gantavyA	gam	pos=va,g=f,c=1,n=s,f=krtya
te	tvad	pos=n,g=,c=6,n=s
vasatiH	vasati	pos=n,g=f,c=1,n=s
alakA	alakA	pos=n,g=f,c=1,n=s
nAma	nAma	pos=i
yakza	yakza	pos=n,comp=y
ISvarARAm	ISvara	pos=n,g=m,c=6,n=p
bAhya	bAhya	pos=a,comp=y
udyAna	udyAna	pos=n,comp=y
sTita	sTA	pos=va,comp=y,f=part
hara	hara	pos=n,comp=y
SiraH	Siras	pos=n,comp=y
candrikA	candrikA	pos=n,comp=y
DOta	DOta	pos=a,comp=y
harmyA	harmya	pos=n,g=f,c=1,n=s

# id = Megh.1.8
tvAm	tvad	pos=n,g=,c=2,n=s
ArUQam	Aruh	pos=va,g=m,c=2,n=s,f=part
pavana	pavana	pos=n,comp=y
padavIm	padavI	pos=n,g=f,c=2,n=s
udgfhIta	udgrah	pos=va,comp=y,f=part
alaka	alaka	pos=n,comp=y
antAH	anta	pos=n,g=f,c=1,n=p
prekzizyante	prekz	pos=v,p=3,n=p,l=lrt
paTika	paTika	pos=n,comp=y
vanitAH	vanitA	pos=n,g=f,c=1,n=p
pratyayAt	pratyaya	pos=n,g=m,c=5,n=s
ASvasantyaH	ASvas	pos=va,g=f,c=1,n=p,f=part
kaH	ka	pos=n,g=m,c=1,n=s
saMnadDe	saMnah	pos=va,g=m,c=7,n=s,f=part
viraha	viraha	pos=n,comp=y
viDurAm	viDura	pos=a,g=f,c=2,n=s
tvayi	tvad	pos=n,g=,c=7,n=s
upekzeta	upekz	pos=v,p=3,n=s,l=vidhilin
jAyAm	jAyA	pos=n,g=f,c=2,n=s
na	na	pos=i
syAt	as	pos=v,p=3,n=s,l=vidhilin
anyaH	anya	pos=n,g=m,c=1,n=s
api	api	pos=i
aham	mad	pos=n,g=,c=1,n=s
iva	iva	pos=i
jano	jana	pos=n,g=m,c=1,n=s
yaH	yad	pos=n,g=m,c=1,n=s
para	para	pos=n,comp=y
aDIna	aDIna	pos=a,comp=y
vfttiH	vftti	pos=n,g=m,c=1,n=s

# id = Megh.1.9
tvAm	tvad	pos=n,g=,c=2,n=s
ca	ca	pos=i
avaSyam	avaSyam	pos=i
divasa	divasa	pos=n,comp=y
gaRanA	gaRanA	pos=n,comp=y
tatparAm	tatpara	pos=a,g=f,c=2,n=s
ekapatnIm	ekapatnI	pos=n,g=f,c=2,n=s
avyApannAm	avyApanna	pos=a,g=f,c=2,n=s
avihata	avihata	pos=a,comp=y
gatiH	gati	pos=n,g=m,c=1,n=s
drakzyasi	dfS	pos=v,p=2,n=s,l=lrt
BrAtf	BrAtf	pos=n,comp=y
jAyAm	jAyA	pos=n,g=f,c=2,n=s
ASAbanDaH	ASAbanDa	pos=n,g=m,c=1,n=s
kusuma	kusuma	pos=n,comp=y
sadfSam	sadfSa	pos=a,g=n,c=1,n=s
prAyaSo	prAyaSas	pos=i
hi	hi	pos=i
aNganAnAm	aNganA	pos=n,g=f,c=6,n=p
sadyaH	sadyas	pos=i
pAti	pA	pos=v,p=3,n=s,l=lat
praRayi	praRayin	pos=a,g=n,c=2,n=s
hfdayam	hfdaya	pos=n,g=n,c=2,n=s
viprayoge	viprayoga	pos=n,g=m,c=7,n=s
ruRadDi	ruD	pos=v,p=3,n=s,l=lat

# id = Megh.1.10
mandam	manda	pos=a,g=n,c=2,n=s
mandam	manda	pos=a,g=n,c=2,n=s
nudati	nud	pos=v,p=3,n=s,l=lat
pavanaH	pavana	pos=n,g=m,c=1,n=s
ca	ca	pos=i
anukUlaH	anukUla	pos=a,g=m,c=1,n=s
yaTA	yaTA	pos=i
tvAm	tvad	pos=n,g=,c=2,n=s
vAmaH	vAma	pos=a,g=m,c=1,n=s
ca	ca	pos=i
ayam	idam	pos=n,g=m,c=1,n=s
nadati	nad	pos=v,p=3,n=s,l=lat
maDuram	maDura	pos=a,g=n,c=2,n=s
cAtakaH	cAtaka	pos=n,g=m,c=1,n=s
te	tvad	pos=n,g=,c=6,n=s
saganDaH	saganDa	pos=a,g=m,c=1,n=s
garBADAna	garBADAna	pos=n,comp=y
kzaRa	kzaRa	pos=n,comp=y
paricayAt	paricaya	pos=n,g=m,c=5,n=s
nUnam	nUnam	pos=i
AbadDa	AbanD	pos=va,comp=y,f=part
mAlAH	mAlA	pos=n,g=f,c=1,n=p
sevizyante	sev	pos=v,p=3,n=p,l=lrt
nayana	nayana	pos=n,comp=y
suBagam	suBaga	pos=a,g=m,c=2,n=s
Ke	Ka	pos=n,g=n,c=7,n=s
Bavantam	Bavat	pos=a,g=m,c=2,n=s
balAkAH	balAkA	pos=n,g=f,c=1,n=p

# id = Megh.1.11
kartum	kf	pos=vi
yat	yad	pos=n,g=n,c=1,n=s
ca	ca	pos=i
praBavati	praBU	pos=v,p=3,n=s,l=lat
mahIm	mahI	pos=n,g=f,c=2,n=s
ucCilInDrAm	ucCilInDra	pos=a,g=f,c=2,n=s
avanDyAm	avanDya	pos=a,g=f,c=2,n=s
tat	tad	pos=n,g=n,c=2,n=s
SrutvA	Sru	pos=vi
te	tad	pos=n,g=m,c=1,n=p
SravaRa	SravaRa	pos=n,comp=y
suBagam	suBaga	pos=a,g=n,c=2,n=s
garjitam	garjita	pos=n,g=n,c=2,n=s
mAnasa	mAnasa	pos=n,comp=y
utkAH	utka	pos=a,g=m,c=1,n=p
A	A	pos=i
kElAsAt	kElAsa	pos=n,g=m,c=5,n=s
bisa	bisa	pos=n,comp=y
kisalaya	kisalaya	pos=n,comp=y
Ceda	Ceda	pos=n,comp=y
pATeyavantaH	pATeyavat	pos=a,g=m,c=1,n=p
sampatsyante	sampad	pos=v,p=3,n=p,l=lrt
naBasi	naBas	pos=n,g=n,c=7,n=s
Bavato	Bavat	pos=a,g=m,c=6,n=s
rAjahaMsAH	rAjahaMsa	pos=n,g=m,c=1,n=p
sahAyAH	sahAya	pos=n,g=m,c=1,n=p

# id = Megh.1.12
ApfcCasva	ApracC	pos=v,p=2,n=s,l=lot
priya	priya	pos=a,comp=y
saKam	saKa	pos=n,g=m,c=2,n=s
amum	adas	pos=n,g=m,c=2,n=s
tuNgam	tuNga	pos=n,g=m,c=2,n=s
AliNgya	AliNgay	pos=vi
SElam	SEla	pos=n,g=m,c=2,n=s
vandyEH	vand	pos=va,g=n,c=3,n=p,f=krtya
puMsAm	puMs	pos=n,g=m,c=6,n=p
raGupati	raGupati	pos=n,comp=y
padEH	pada	pos=n,g=n,c=3,n=p
aNkitam	aNkay	pos=va,g=m,c=2,n=s,f=part
meKalAsu	meKalA	pos=n,g=f,c=7,n=p
kAle	kAla	pos=n,g=m,c=7,n=s
kAle	kAla	pos=n,g=m,c=7,n=s
Bavati	BU	pos=v,p=3,n=s,l=lat
Bavato	Bavat	pos=a,g=m,c=6,n=s
yasya	yad	pos=n,g=m,c=6,n=s
saMyogam	saMyoga	pos=n,g=m,c=2,n=s
etya	e	pos=vi
sneha	sneha	pos=n,comp=y
vyaktiH	vyakti	pos=n,g=f,c=1,n=s
cira	cira	pos=a,comp=y
viraha	viraha	pos=n,comp=y
jam	ja	pos=a,g=m,c=2,n=s
muYcato	muc	pos=va,g=m,c=6,n=s,f=part
bAzpam	bAzpa	pos=n,g=m,c=2,n=s
uzRam	uzRa	pos=a,g=m,c=2,n=s

# id = Megh.1.13
mArgam	mArga	pos=n,g=m,c=2,n=s
tAvat	tAvat	pos=i
SfRu	Sru	pos=v,p=2,n=s,l=lot
kaTayatas	kaTay	pos=va,g=m,c=6,n=s,f=part
tvad	tvad	pos=n,comp=y
prayARa	prayARa	pos=n,comp=y
anurUpam	anurUpa	pos=a,g=m,c=2,n=s
saMdeSam	saMdeSa	pos=n,g=m,c=2,n=s
me	mad	pos=n,g=,c=6,n=s
tadanu	tadanu	pos=i
jalada	jalada	pos=n,g=m,c=8,n=s
Srozyasi	Sru	pos=v,p=2,n=s,l=lrt
Srotra	Srotra	pos=n,comp=y
peyam	peya	pos=n,g=n,c=2,n=s
KinnaH	Kid	pos=va,g=m,c=1,n=s,f=part
KinnaH	Kid	pos=va,g=m,c=1,n=s,f=part
SiKarizu	SiKarin	pos=n,g=m,c=7,n=p
padam	pada	pos=n,g=n,c=2,n=s
nyasya	nyas	pos=vi
gantAsi	gam	pos=v,p=2,n=s,l=lrt
yatra	yatra	pos=i
kzIRaH	kzi	pos=va,g=m,c=1,n=s,f=part
kzIRaH	kzi	pos=va,g=m,c=1,n=s,f=part
parilaGu	parilaGu	pos=a,g=n,c=2,n=s
payaH	payas	pos=n,g=n,c=2,n=s
srotasAm	srotas	pos=n,g=n,c=6,n=p
ca	ca	pos=i
upaBujya	upaBuj	pos=vi

# id = Megh.1.14
adreH	adri	pos=n,g=m,c=6,n=s
SfNgam	SfNga	pos=n,g=n,c=2,n=s
harati	hf	pos=v,p=3,n=s,l=lat
pavanaH	pavana	pos=n,g=m,c=1,n=s
kim	ka	pos=n,g=n,c=2,n=s
svid	svid	pos=i
iti	iti	pos=i
unmuKIBiH	unmuKa	pos=a,g=f,c=3,n=p
dfzwa	dfS	pos=va,comp=y,f=part
utsAhaH	utsAha	pos=n,g=m,c=1,n=s
cakita	cak	pos=va,comp=y,f=part
cakitam	cak	pos=va,g=n,c=2,n=s,f=part
mUQa	muh	pos=va,comp=y,f=part
sidDa	sidDa	pos=n,comp=y
aNganABiH	aNganA	pos=n,g=f,c=3,n=p
sTAnAd	sTAna	pos=n,g=n,c=5,n=s
asmAt	idam	pos=n,g=n,c=5,n=s
sarasa	sarasa	pos=n,comp=y
niculAt	nicula	pos=n,g=n,c=5,n=s
utpata	utpat	pos=v,p=2,n=s,l=lot
udaNmuKaH	udaNmuKa	pos=a,g=m,c=1,n=s
Kam	Ka	pos=n,g=n,c=2,n=s
diNnAgAnAm	diNnAga	pos=n,g=m,c=6,n=p
paTi	paTin	pos=n,g=m,c=7,n=s
pariharan	parihf	pos=va,g=m,c=1,n=s,f=part
sTUla	sTUla	pos=a,comp=y
hasta	hasta	pos=n,comp=y
avalepAn	avalepa	pos=n,g=m,c=2,n=p

# id = Megh.1.15
ratna	ratna	pos=n,comp=y
CAyA	CAyA	pos=n,comp=y
vyatikare	vyatikara	pos=n,g=m,c=7,n=s
iva	iva	pos=i
prekzyam	prekz	pos=va,g=n,c=1,n=s,f=krtya
etat	etad	pos=n,g=n,c=1,n=s
purastAt	purastAt	pos=i
valmIkAgrAt	valmIkAgra	pos=n,g=n,c=5,n=s
praBavati	praBU	pos=v,p=3,n=s,l=lat
DanuH	Danus	pos=n,comp=y
KaRqam	KaRqa	pos=n,g=n,c=1,n=s
AKaRqalasya	AKaRqala	pos=n,g=m,c=6,n=s
yena	yad	pos=n,g=n,c=3,n=s
SyAmam	SyAma	pos=a,g=n,c=1,n=s
vapuH	vapus	pos=n,g=n,c=1,n=s
atitarAm	atitarAm	pos=i
kAntim	kAnti	pos=n,g=f,c=2,n=s
Apatsyate	Apad	pos=v,p=3,n=s,l=lrt
te	tvad	pos=n,g=,c=6,n=s
barhena	barha	pos=n,g=m,c=3,n=s
iva	iva	pos=i
sPurita	sPur	pos=va,comp=y,f=part
ruciRA	ruci	pos=n,g=m,c=3,n=s
gopa	gopa	pos=n,comp=y
vezasya	veza	pos=n,g=m,c=6,n=s
vizRoH	vizRu	pos=n,g=m,c=6,n=s

# id = Megh.1.16
tve	tvad	pos=n,g=,c=7,n=s
Ayattam	Ayat	pos=va,g=n,c=1,n=s,f=part
kfzi	kfzi	pos=n,comp=y
Palam	Pala	pos=n,g=n,c=1,n=s
iti	iti	pos=i
BrU	BrU	pos=n,comp=y
vikArAn	vikAra	pos=n,g=m,c=2,n=p
aBijYEH	aBijYa	pos=a,g=n,c=3,n=p
prIti	prIti	pos=n,comp=y
snigDEH	snigDa	pos=a,g=n,c=3,n=p
janapada	janapada	pos=n,comp=y
vaDU	vaDU	pos=n,comp=y
locanEH	locana	pos=n,g=n,c=3,n=p
pIyamAnaH	pA	pos=va,g=m,c=1,n=s,f=part
sadyaH	sadyas	pos=i
sIra	sIra	pos=n,comp=y
utkazaRa	utkazaRa	pos=n,comp=y
suraBi	suraBi	pos=a,g=n,c=2,n=s
kzetram	kzetra	pos=n,g=n,c=2,n=s
Aruhya	Aruh	pos=vi
mAlam	mAla	pos=n,g=m,c=2,n=s
kiMcit	kaScit	pos=n,g=n,c=2,n=s
paScAd	paScAt	pos=i
vraja	vraj	pos=v,p=2,n=s,l=lot
laGu	laGu	pos=a,comp=y
gatiH	gati	pos=n,g=m,c=1,n=s
BUya	BUyas	pos=i
eva	eva	pos=i
uttareRa	uttareRa	pos=i

# id = Megh.1.17
tvAm	tvad	pos=n,g=,c=2,n=s
AsAra	AsAra	pos=n,comp=y
praSamita	praSamay	pos=va,comp=y,f=part
vana	vana	pos=n,comp=y
upaplavam	upaplava	pos=n,g=m,c=2,n=s
sADu	sADu	pos=a,g=n,c=2,n=s
mUrDnA	mUrDan	pos=n,g=m,c=3,n=s
vakzyaty	vac	pos=v,p=3,n=s,l=lrt
aDva	aDvan	pos=n,comp=y
Srama	Srama	pos=n,comp=y
parigatam	parigam	pos=va,g=m,c=2,n=s,f=part
sAnumAn	sAnumat	pos=a,g=m,c=1,n=s
AmrakUwaH	AmrakUwa	pos=n,g=m,c=1,n=s
na	na	pos=i
kzudro	kzudra	pos=a,g=m,c=1,n=s
api	api	pos=i
praTama	praTama	pos=a,comp=y
sukfta	sukfta	pos=n,comp=y
apekzayA	apekzA	pos=n,g=f,c=3,n=s
saMSrayAya	saMSraya	pos=n,g=m,c=4,n=s
prApte	prAp	pos=va,g=m,c=7,n=s,f=part
mitre	mitra	pos=n,g=m,c=7,n=s
Bavati	BU	pos=v,p=3,n=s,l=lat
vimuKaH	vimuKa	pos=a,g=m,c=1,n=s
kim	ka	pos=n,g=n,c=2,n=s
punaH	punar	pos=i
yas	yad	pos=n,g=m,c=1,n=s
taTA	taTA	pos=i
uccEs	uccEs	pos=i

# id = Megh.1.18
Canna	Cad	pos=va,comp=y,f=part
upAntaH	upAnta	pos=n,g=m,c=1,n=s
pariRata	pariRam	pos=va,comp=y,f=part
Pala	Pala	pos=n,comp=y
dyotiBiH	dyotin	pos=a,g=m,c=3,n=p
kAnana	kAnana	pos=n,comp=y
AmrEH	Amra	pos=n,g=m,c=3,n=p
tvayi	tvad	pos=n,g=,c=7,n=s
ArUQe	Aruh	pos=va,g=m,c=7,n=s,f=part
SiKaram	SiKara	pos=n,g=m,c=2,n=s
acalaH	acala	pos=n,g=m,c=1,n=s
snigDa	snigDa	pos=a,comp=y
veRI	veRI	pos=n,comp=y
savarRe	savarRa	pos=a,g=m,c=7,n=s
nUnam	nUnam	pos=i
yAsyaty	yA	pos=v,p=3,n=s,l=lrt
amara	amara	pos=n,comp=y
miTuna	miTuna	pos=n,comp=y
prekzaRIyam	prekz	pos=va,g=f,c=2,n=s,f=krtya
avasTAm	avasTA	pos=n,g=f,c=2,n=s
maDye	maDya	pos=n,g=n,c=7,n=s
SyAmaH	SyAma	pos=a,g=m,c=1,n=s
stana	stana	pos=n,g=m,c=1,n=s
iva	iva	pos=i
BuvaH	BU	pos=n,g=f,c=6,n=s
Seza	Seza	pos=n,comp=y
vistAra	vistAra	pos=n,comp=y
pARquH	pARqu	pos=a,g=m,c=1,n=s

# id = Megh.1.19
sTitvA	sTA	pos=vi
tasmin	tad	pos=n,g=n,c=7,n=s
vanacara	vanacara	pos=n,comp=y
vaDU	vaDU	pos=n,comp=y
Bukta	Buj	pos=va,comp=y,f=part
kuYje	kuYja	pos=n,g=n,c=7,n=s
muhUrtam	muhUrta	pos=n,g=n,c=2,n=s
toya	toya	pos=n,comp=y
utsarga	utsarga	pos=n,comp=y
drutatara	drutatara	pos=a,comp=y
gatiH	gati	pos=n,g=m,c=1,n=s
tad	tad	pos=n,comp=y
param	para	pos=n,g=n,c=2,n=s
vartma	vartman	pos=n,g=n,c=2,n=s
tIrRaH	tf	pos=va,g=m,c=1,n=s,f=part
revAm	revA	pos=n,g=f,c=2,n=s
drakzyasi	dfS	pos=v,p=2,n=s,l=lrt
upala	upala	pos=n,comp=y
vizame	vizama	pos=a,g=m,c=7,n=s
vinDya	vinDya	pos=n,comp=y
pAde	pAda	pos=n,g=m,c=7,n=s
viSIrRAm	viSf	pos=va,g=f,c=2,n=s,f=part
BakticCedEH	BakticCeda	pos=n,g=m,c=3,n=p
iva	iva	pos=i
viracitAm	viracay	pos=va,g=f,c=2,n=s,f=part
BUtim	BUti	pos=n,g=f,c=2,n=s
aNge	aNga	pos=n,g=n,c=7,n=s
gajasya	gaja	pos=n,g=m,c=6,n=s

# id = Megh.1.20
tasyAs	tad	pos=n,g=f,c=6,n=s
tiktEH	tikta	pos=a,g=m,c=3,n=p
vana	vana	pos=n,comp=y
gaja	gaja	pos=n,comp=y
madEH	mada	pos=n,g=m,c=3,n=p
vAsitam	vAsay	pos=va,g=n,c=2,n=s,f=part
vAnta	vam	pos=va,comp=y,f=part
vfzwiH	vfzwi	pos=n,g=m,c=1,n=s
jambU	jambu	pos=n,comp=y
kuYja	kuYja	pos=n,comp=y
pratihata	pratihan	pos=va,comp=y,f=part
rayam	raya	pos=n,g=n,c=2,n=s
toyam	toya	pos=n,g=n,c=2,n=s
AdAya	AdA	pos=vi
gacCeH	gam	pos=v,p=2,n=s,l=vidhilin
antaHsAram	antaHsAra	pos=a,g=m,c=2,n=s
Gana	Gana	pos=n,g=m,c=8,n=s
tulayitum	tulay	pos=vi
na	na	pos=i
anilaH	anila	pos=n,g=m,c=1,n=s
Sakzyati	Sak	pos=v,p=3,n=s,l=lrt
tvAm	tvad	pos=n,g=,c=2,n=s
riktaH	ric	pos=va,g=m,c=1,n=s,f=part
sarvo	sarva	pos=n,g=m,c=1,n=s
Bavati	BU	pos=v,p=3,n=s,l=lat
hi	hi	pos=i
laGuH	laGu	pos=a,g=f,c=1,n=s
pUrRa	pf	pos=va,comp=y,f=part
tA	tA	pos=n,g=f,c=1,n=s
gOravAya	gOrava	pos=n,g=n,c=4,n=s

# id = Megh.1.21
nIpam	nIpa	pos=n,g=m,c=2,n=s
dfzwvA	dfS	pos=vi
harita	harita	pos=a,comp=y
kapiSam	kapiSa	pos=a,g=m,c=2,n=s
kesarEH	kesara	pos=n,g=n,c=3,n=p
arDa	arDa	pos=n,comp=y
rUQEH	ruh	pos=va,g=n,c=3,n=p,f=part
AvirBUta	AvirBU	pos=va,comp=y,f=part
praTama	praTama	pos=a,comp=y
mukulAH	mukula	pos=n,g=f,c=2,n=p
kandalIH	kandalI	pos=n,g=f,c=2,n=p
ca	ca	pos=i
anukacCam	anukacCam	pos=i
jagDvA	jakz	pos=vi
araRyezu	araRya	pos=n,g=n,c=7,n=p
aDika	aDika	pos=a,comp=y
suraBim	suraBi	pos=a,g=m,c=2,n=s
ganDam	ganDa	pos=n,g=m,c=2,n=s
AGrAya	AGrA	pos=vi
ca	ca	pos=i
urvyAH	urvI	pos=n,g=f,c=6,n=s
sAraNgAs	sAraNga	pos=a,g=m,c=1,n=p
te	tad	pos=n,g=m,c=1,n=p
jala	jala	pos=n,comp=y
lava	lava	pos=n,comp=y
mucaH	muc	pos=a,g=m,c=1,n=p
sUcayizyanti	sUcay	pos=v,p=3,n=p,l=lrt
mArgam	mArga	pos=n,g=m,c=2,n=s

# id = Megh.1.22
amBaH	amBas	pos=n,comp=y
bindu	bindu	pos=n,comp=y
grahaRa	grahaRa	pos=n,comp=y
caturAn	catura	pos=a,g=m,c=2,n=p
cAtakAn	cAtaka	pos=n,g=m,c=2,n=p
vIkzamARAH	vIkz	pos=va,g=m,c=1,n=p,f=part
SreRI	SreRI	pos=n,comp=y
BUtAH	BU	pos=va,g=m,c=1,n=p,f=part
parigaRanayA	parigaRana	pos=n,g=f,c=3,n=s
nirdiSanto	nirdiS	pos=va,g=m,c=1,n=p,f=part
balAkAH	balAka	pos=n,g=m,c=1,n=p
tvAm	tvad	pos=n,g=,c=2,n=s
AsAdya	AsAday	pos=vi
stanita	stanita	pos=n,comp=y
samaye	samaya	pos=n,g=m,c=7,n=s
mAnayizyanti	mAnay	pos=v,p=3,n=p,l=lrt
sidDAH	sidDa	pos=n,g=m,c=1,n=p
sa	sa	pos=i
utkampAni	utkampa	pos=n,g=n,c=1,n=p
priya	priya	pos=a,comp=y
sahacarI	sahacarI	pos=n,comp=y
saMBrama	samBrama	pos=n,comp=y
AliNgitAni	AliNgay	pos=va,g=n,c=1,n=p,f=part

# id = Megh.1.23
utpaSyAmi	utpaS	pos=v,p=1,n=s,l=lat
drutam	dru	pos=va,g=n,c=2,n=s,f=part
api	api	pos=i
saKe	saKi	pos=n,g=,c=8,n=s
mad	mad	pos=n,comp=y
priya	priya	pos=a,comp=y
arTam	arTa	pos=n,g=m,c=2,n=s
yiyAsoH	yiyAsu	pos=a,g=m,c=6,n=s
kAlakzepam	kAlakzepa	pos=n,g=m,c=2,n=s
kakuBa	kakuBa	pos=n,comp=y
suraBO	suraBi	pos=a,g=m,c=7,n=s
parvate	parvata	pos=n,g=m,c=7,n=s
parvate	parvata	pos=n,g=m,c=7,n=s
te	tvad	pos=n,g=,c=6,n=s
Sukla	Sukla	pos=a,comp=y
apANgEH	apANga	pos=n,g=m,c=3,n=p
sajala	sajala	pos=a,comp=y
nayanEH	nayana	pos=n,g=m,c=3,n=p
svAgatIkftya	svAgatIkf	pos=vi
kekAH	kekA	pos=n,g=f,c=2,n=p
pratudya	pratud	pos=vi
atas	atas	pos=i
kaTam	kaTam	pos=i
api	api	pos=i
BavAn	Bavat	pos=a,g=m,c=1,n=s
gantum	gam	pos=vi
ASu	ASu	pos=a,g=n,c=2,n=s
vyavasyet	vyavasA	pos=v,p=3,n=s,l=vidhilin

# id = Megh.1.24
pARqu	pARqu	pos=a,comp=y
CAyA	CAyA	pos=n,comp=y
upavana	upavana	pos=n,comp=y
vftayaH	vfti	pos=n,g=m,c=1,n=p
ketakEH	ketaka	pos=n,g=m,c=3,n=p
sUcI	sUci	pos=n,comp=y
BinnEH	Bid	pos=va,g=m,c=3,n=p,f=part
nIqa	nIqa	pos=n,comp=y
AramBEH	AramBa	pos=n,g=m,c=3,n=p
gfha	gfha	pos=n,comp=y
baliBujAm	baliBuj	pos=n,g=m,c=6,n=p
Akula	Akula	pos=a,comp=y
grAma	grAma	pos=n,comp=y
cEtyAH	cEtya	pos=n,g=m,c=1,n=p
tvayy	tvad	pos=n,g=,c=7,n=s
Asanne	Asad	pos=va,g=m,c=7,n=s,f=part
pariRata	pariRam	pos=va,comp=y,f=part
Pala	Pala	pos=n,comp=y
SyAma	SyAma	pos=a,comp=y
jambU	jambu	pos=n,comp=y
vanAntAH	vanAnta	pos=n,g=m,c=1,n=p
sampatsyante	sampad	pos=v,p=3,n=p,l=lrt
katipaya	katipaya	pos=a,comp=y
dina	dina	pos=n,comp=y
sTAyin	sTAyin	pos=a,comp=y
haMsAH	haMsa	pos=n,g=m,c=1,n=p
daSArRAH	daSArRa	pos=n,g=m,c=1,n=p

# id = Megh.1.25
tezAm	tad	pos=n,g=m,c=6,n=p
dikzu	diS	pos=n,g=f,c=7,n=p
praTita	praT	pos=va,comp=y,f=part
vidiSA	vidiSA	pos=n,comp=y
lakzaRAm	lakzaRa	pos=n,g=f,c=2,n=s
rAjaDAnIm	rAjaDAnI	pos=n,g=f,c=2,n=s
gatvA	gam	pos=vi
sadyaH	sadyas	pos=i
Palam	Pala	pos=n,g=n,c=2,n=s
avikalam	avikala	pos=a,g=n,c=2,n=s
kAmuka	kAmuka	pos=a,comp=y
tvasya	tva	pos=n,g=n,c=6,n=s
labDA	laB	pos=v,p=3,n=s,l=lrt
tIra	tIra	pos=n,comp=y
upAnta	upAnta	pos=n,comp=y
stanita	stanita	pos=n,comp=y
suBagam	suBaga	pos=a,g=n,c=2,n=s
pAsyasi	pA	pos=v,p=2,n=s,l=lrt
svAdu	svAdu	pos=a,g=n,c=2,n=s
yasmAt	yasmAt	pos=i
sa	sa	pos=i
BrU	BrU	pos=n,comp=y
BaNgam	BaNga	pos=n,g=n,c=2,n=s
muKam	muKa	pos=n,g=n,c=2,n=s
iva	iva	pos=i
payo	payas	pos=n,g=n,c=2,n=s
vetravatyAH	vetravatI	pos=n,g=f,c=6,n=s
cala	cala	pos=a,comp=y
Urmi	Urmi	pos=n,g=n,c=2,n=s

# id = Megh.1.26
nIcErAKyam	nIcErAKya	pos=a,g=m,c=2,n=s
girim	giri	pos=n,g=m,c=2,n=s
aDivases	aDivas	pos=v,p=2,n=s,l=vidhilin
tatra	tatra	pos=i
viSrAma	viSrAma	pos=n,comp=y
hetoH	hetu	pos=n,g=m,c=5,n=s
tvad	tvad	pos=n,comp=y
saMparkAt	samparka	pos=n,g=m,c=5,n=s
pulakitam	pulakita	pos=a,g=m,c=2,n=s
iva	iva	pos=i
prOQa	prOQa	pos=a,comp=y
puzpEH	puzpa	pos=n,g=m,c=3,n=p
kadambEH	kadamba	pos=n,g=m,c=3,n=p
yaH	yad	pos=n,g=m,c=1,n=s
puRya	puRya	pos=a,comp=y
strI	strI	pos=n,comp=y
rati	rati	pos=n,comp=y
parimala	parimala	pos=n,comp=y
udgAriBiH	udgArin	pos=a,g=n,c=3,n=p
nAgarARAm	nAgara	pos=n,g=m,c=6,n=p
uddAmAni	uddAma	pos=a,g=n,c=2,n=p
praTayati	praTay	pos=v,p=3,n=s,l=lat
SilA	SilA	pos=n,comp=y
veSmaBiH	veSman	pos=n,g=n,c=3,n=p
yOvanAni	yOvana	pos=n,g=n,c=2,n=p

# id = Megh.1.27
viSrAntaH	viSram	pos=va,g=m,c=1,n=s,f=part
san	as	pos=va,g=m,c=1,n=s,f=part
vraja	vraj	pos=v,p=2,n=s,l=lot
vana	vana	pos=n,comp=y
nadI	nadI	pos=n,comp=y
tIra	tIra	pos=n,comp=y
jAnAm	ja	pos=a,g=n,c=6,n=p
niziYcan	nizic	pos=va,g=m,c=1,n=s,f=part
udyAnAnAm	udyAna	pos=n,g=n,c=6,n=p
nava	nava	pos=a,comp=y
jala	jala	pos=n,comp=y
kaREH	kaRa	pos=n,g=m,c=3,n=p
yUTikA	yUTikA	pos=n,comp=y
jAlakAni	jAlaka	pos=n,g=n,c=2,n=p
gaRqa	gaRqa	pos=n,comp=y
sveda	sveda	pos=n,comp=y
apanayana	apanayana	pos=n,comp=y
rujA	rujA	pos=n,comp=y
klAnta	klam	pos=va,comp=y,f=part
karRa	karRa	pos=n,comp=y
utpalAnAm	utpala	pos=n,g=n,c=6,n=p
CAyA	CAyA	pos=n,comp=y
dAnAt	dAna	pos=n,g=n,c=5,n=s
kzaRa	kzaRa	pos=n,comp=y
paricitaH	parici	pos=va,g=m,c=1,n=s,f=part
puzpalAvI	puzpalAvI	pos=n,comp=y
muKAnAm	muKa	pos=n,g=n,c=6,n=p

# id = Megh.1.28
vakraH	vakra	pos=a,g=m,c=1,n=s
panTA	paTin	pos=n,g=,c=1,n=s
yat	yat	pos=i
api	api	pos=i
BavataH	Bavat	pos=a,g=m,c=6,n=s
prasTitasya	prasTA	pos=va,g=m,c=6,n=s,f=part
uttara	uttara	pos=a,comp=y
ASAm	ASA	pos=n,g=f,c=2,n=s
sODa	sODa	pos=n,comp=y
utsaNga	utsaNga	pos=n,comp=y
praRaya	praRaya	pos=n,comp=y
vimuKaH	vimuKa	pos=a,g=m,c=1,n=s
mA	mA	pos=i
sma	sma	pos=i
BUH	BU	pos=v,p=2,n=s,l=lun_unaug
ujjayinyAH	ujjayinI	pos=n,g=f,c=6,n=s
vidyut	vidyut	pos=n,comp=y
dAma	dAman	pos=n,comp=y
sPurita	sPur	pos=va,comp=y,f=part
cakitEH	cak	pos=va,g=n,c=3,n=p,f=part
tatra	tatra	pos=i
pOra	pOra	pos=n,comp=y
aNganAnAm	aNganA	pos=n,g=f,c=6,n=p
lola	lola	pos=a,comp=y
apANgEH	apANga	pos=n,g=n,c=3,n=p
yadi	yadi	pos=i
na	na	pos=i
ramase	ram	pos=v,p=2,n=s,l=lat
locanEH	locana	pos=n,g=n,c=3,n=p
vaYcito	vaYcay	pos=va,g=m,c=1,n=s,f=part
'si	as	pos=v,p=2,n=s,l=lat

# id = Megh.1.29
vIci	vIci	pos=n,comp=y
kzoBa	kzoBa	pos=n,comp=y
stanita	stanita	pos=n,comp=y
vihaga	vihaga	pos=n,comp=y
SreRI	SreRi	pos=n,comp=y
kAYcI	kAYcI	pos=n,comp=y
guRAyAH	guRa	pos=n,g=f,c=6,n=s
saMsarpantyAH	saMsfp	pos=va,g=f,c=6,n=s,f=part
sKalita	sKal	pos=va,comp=y,f=part
suBagam	suBaga	pos=a,g=n,c=2,n=s
darSita	darSay	pos=va,comp=y,f=part
Avartana	Avartana	pos=n,comp=y
ABaH	ABa	pos=a,g=m,c=1,n=s
nirvinDyAyAH	nirvinDyA	pos=n,g=f,c=6,n=s
paTi	paTin	pos=n,g=m,c=7,n=s
Bava	BU	pos=v,p=2,n=s,l=lot
rasa	rasa	pos=n,comp=y
aByantaraH	aByantara	pos=a,g=m,c=1,n=s
saMnipatya	saMnipat	pos=vi
strIRAm	strI	pos=n,g=f,c=6,n=p
Adyam	Adya	pos=a,g=n,c=1,n=s
praRaya	praRaya	pos=n,comp=y
vacanam	vacana	pos=n,g=n,c=1,n=s
viBramo	viBrama	pos=n,g=m,c=1,n=s
hi	hi	pos=i
priyezu	priya	pos=a,g=m,c=7,n=p

# id = Megh.1.30
veRI	veRI	pos=n,comp=y
BUta	BU	pos=va,comp=y,f=part
pratanu	pratanu	pos=a,comp=y
salilA	salila	pos=n,g=f,c=1,n=s
tAm	tad	pos=n,g=f,c=2,n=s
atItasya	atI	pos=va,g=m,c=6,n=s,f=part
sinDuH	sinDu	pos=n,g=f,c=1,n=s
pARqu	pARqu	pos=a,comp=y
CAyA	CAyA	pos=n,g=f,c=1,n=s
tawa	tawa	pos=n,comp=y
ruha	ruha	pos=a,comp=y
taru	taru	pos=n,comp=y
BraMSiBiH	BraMSin	pos=a,g=n,c=3,n=p
jIrRa	jf	pos=va,comp=y,f=part
parREH	parRa	pos=n,g=n,c=3,n=p
sOBAgyam	sOBAgya	pos=n,g=n,c=2,n=s
te	tvad	pos=n,g=,c=6,n=s
suBaga	suBaga	pos=a,g=m,c=8,n=s
viraha	viraha	pos=n,comp=y
avasTayA	avasTA	pos=n,g=f,c=3,n=s
vyaYjayantI	vyaYjay	pos=va,g=f,c=1,n=s,f=part
kArSyam	kArSya	pos=n,g=n,c=2,n=s
yena	yad	pos=n,g=m,c=3,n=s
tyajati	tyaj	pos=v,p=3,n=s,l=lat
viDinA	viDi	pos=n,g=m,c=3,n=s
sa	tad	pos=n,g=m,c=1,n=s
tvayA	tvad	pos=n,g=,c=3,n=s
eva	eva	pos=i
upapAdyaH	upapAday	pos=va,g=m,c=1,n=s,f=krtya

# id = Megh.1.31
prApya	prAp	pos=vi
avanti	avanti	pos=n,g=m,c=2,n=p
udayana	udayana	pos=n,comp=y
kaTA	kaTA	pos=n,comp=y
kovida	kovida	pos=a,comp=y
grAma	grAma	pos=n,comp=y
vfdDAn	vfdDa	pos=a,g=m,c=2,n=p
pUrva	pUrva	pos=n,comp=y
uddizwAm	uddiS	pos=va,g=f,c=2,n=s,f=part
upasara	upasf	pos=v,p=2,n=s,l=lot
purIm	purI	pos=n,g=f,c=2,n=s
SrI	SrI	pos=n,comp=y
viSAlAm	viSAla	pos=a,g=f,c=2,n=s
viSAlAm	viSAlA	pos=n,g=f,c=2,n=s
svalpIBUte	svalpIBU	pos=va,g=n,c=7,n=s,f=part
su	su	pos=i
carita	carita	pos=n,comp=y
Pale	Pala	pos=n,g=n,c=7,n=s
svargiRAm	svargin	pos=a,g=m,c=6,n=p
gAm	go	pos=n,g=,c=2,n=s
gatAnAm	gam	pos=va,g=m,c=6,n=p,f=part
SezEH	Seza	pos=n,g=n,c=3,n=p
puRyEH	puRya	pos=a,g=n,c=3,n=p
hftam	hf	pos=va,g=n,c=1,n=s,f=part
iva	iva	pos=i
divaH	div	pos=n,g=,c=5,n=s
kAntimat	kAntimat	pos=a,g=n,c=1,n=s
KaRqam	KaRqa	pos=n,g=n,c=1,n=s
ekam	eka	pos=n,g=n,c=1,n=s

# id = Megh.1.32
dIrGIkurvan	dIrGIkf	pos=va,g=m,c=1,n=s,f=part
pawu	pawu	pos=a,g=n,c=2,n=s
mada	mada	pos=n,comp=y
kalam	kala	pos=a,g=n,c=2,n=s
kUjitam	kUjita	pos=n,g=n,c=2,n=s
sArasAnAm	sArasa	pos=n,g=m,c=6,n=p
pratyUzezu	pratyUza	pos=n,g=m,c=7,n=p
sPuwita	sPuw	pos=va,comp=y,f=part
kamala	kamala	pos=n,comp=y
Amoda	Amoda	pos=n,comp=y
mEtrI	mEtrI	pos=n,comp=y
kazAyaH	kazAya	pos=a,g=m,c=1,n=s
yatra	yatra	pos=i
strIRAm	strI	pos=n,g=f,c=6,n=p
harati	hf	pos=v,p=3,n=s,l=lat
surata	surata	pos=n,comp=y
glAnim	glAni	pos=n,g=f,c=2,n=s
aNga	aNga	pos=n,comp=y
anukUlaH	anukUla	pos=a,g=m,c=1,n=s
SiprA	SiprA	pos=n,comp=y
vAtaH	vAta	pos=n,g=m,c=1,n=s
priyatama	priyatama	pos=a,g=m,c=1,n=s
iva	iva	pos=i
prArTanA	prArTanA	pos=n,comp=y
cAwu	cAwu	pos=n,comp=y
kAraH	kAra	pos=a,g=m,c=1,n=s

# id = Megh.1.33
hArAMs	hAra	pos=n,g=m,c=2,n=p
tArAMs	tAra	pos=n,g=m,c=2,n=p
tarala	tarala	pos=a,comp=y
guwikA	guwikA	pos=n,g=m,c=2,n=p
kowiSaH	kowiSas	pos=i
SaNKa	SaNKa	pos=n,comp=y
SuktIH	Sukti	pos=n,g=f,c=2,n=p
Sazpa	Sazpa	pos=n,comp=y
SyAmAn	SyAma	pos=a,g=m,c=2,n=p
marakata	marakata	pos=n,comp=y
maRIn	maRi	pos=n,g=m,c=2,n=p
unmayUKa	unmayUKa	pos=a,comp=y
prarohAn	praroha	pos=n,g=m,c=2,n=p
dfzwvA	dfS	pos=vi
yasyAm	yad	pos=n,g=f,c=7,n=s
vipaRi	vipaRi	pos=n,comp=y
racitAn	racay	pos=va,g=m,c=2,n=p,f=part
vidrumARAm	vidruma	pos=n,g=m,c=6,n=p
ca	ca	pos=i
BaNgAn	BaNga	pos=n,g=m,c=2,n=p
saMlakzyante	saMlakzay	pos=v,p=3,n=p,l=lat
salilaniDayas	salilaniDi	pos=n,g=m,c=1,n=p
toya	toya	pos=n,comp=y
mAtra	mAtra	pos=n,comp=y
avaSezAH	avaSeza	pos=n,g=m,c=1,n=p

# id = Megh.1.34
pradyotasya	pradyota	pos=n,g=m,c=6,n=s
priya	priya	pos=a,comp=y
duhitaram	duhitf	pos=n,g=f,c=2,n=s
vatsa	vatsa	pos=n,comp=y
rAjaH	rAja	pos=n,g=m,c=1,n=s
'tra	atra	pos=i
jahre	hf	pos=v,p=3,n=s,l=lit
hEmam	hEma	pos=a,g=n,c=1,n=s
tAla	tAla	pos=n,comp=y
druma	druma	pos=n,comp=y
vanam	vana	pos=n,g=n,c=1,n=s
aBUd	BU	pos=v,p=3,n=s,l=lun
atra	atra	pos=i
tasya	tad	pos=n,g=m,c=6,n=s
eva	eva	pos=i
rAjYaH	rAjan	pos=n,g=m,c=6,n=s
atra	atra	pos=i
udBrAntaH	udBram	pos=va,g=m,c=1,n=s,f=part
kila	kila	pos=i
nalagiriH	nalagiri	pos=n,g=m,c=1,n=s
stamBam	stamBa	pos=n,g=m,c=2,n=s
utpAwya	utpAway	pos=vi
darpAd	darpa	pos=n,g=m,c=5,n=s
ity	iti	pos=i
AgantUn	Agantu	pos=a,g=m,c=2,n=p
ramayati	ramay	pos=v,p=3,n=s,l=lat
jano	jana	pos=n,g=m,c=1,n=s
yatra	yatra	pos=i
banDUn	banDu	pos=n,g=m,c=2,n=p
aBijYaH	aBijYa	pos=a,g=m,c=1,n=s

# id = Megh.1.35
jAla	jAla	pos=n,comp=y
udgIrREH	udgf	pos=va,g=m,c=3,n=p,f=part
upacita	upaci	pos=va,comp=y,f=part
vapuH	vapus	pos=n,g=m,c=1,n=s
keSa	keSa	pos=n,comp=y
saMskAra	saMskAra	pos=n,comp=y
DUpEH	DUpa	pos=n,g=m,c=3,n=p
banDu	banDu	pos=n,comp=y
prItyA	prIti	pos=n,g=f,c=3,n=s
Bavana	Bavana	pos=n,comp=y
SiKiBiH	SiKin	pos=n,g=m,c=3,n=p
datta	dA	pos=va,comp=y,f=part
nftya	nftya	pos=n,comp=y
upahAraH	upahAra	pos=n,g=m,c=1,n=s
harmyezu	harmya	pos=n,g=n,c=7,n=p
asyAH	idam	pos=n,g=f,c=6,n=s
kusuma	kusuma	pos=n,comp=y
suraBizv	suraBi	pos=a,g=n,c=7,n=p
aDva	aDvan	pos=n,comp=y
Kedam	Keda	pos=n,g=m,c=2,n=s
nayeTA	nI	pos=v,p=2,n=s,l=vidhilin
lakzmIm	lakzmI	pos=n,g=f,c=2,n=s
paSyan	paS	pos=va,g=m,c=1,n=s,f=part
lalita	lalita	pos=a,comp=y
vanitA	vanitA	pos=n,comp=y
pAda	pAda	pos=n,comp=y
rAga	rAga	pos=n,comp=y
aNkitezu	aNkay	pos=va,g=n,c=7,n=p,f=part

# id = Megh.1.36
BartuH	Bartf	pos=n,g=m,c=6,n=s
kaRWa	kaRWa	pos=n,comp=y
CaviH	Cavi	pos=n,g=f,c=1,n=s
iti	iti	pos=i
gaREH	gaRa	pos=n,g=m,c=3,n=p
sAdaram	sAdara	pos=a,g=n,c=2,n=s
vIkzyamARaH	vIkz	pos=va,g=m,c=1,n=s,f=part
puRyam	puRya	pos=a,g=n,c=2,n=s
yAyAH	yA	pos=v,p=2,n=s,l=vidhilin
triBuvana	triBuvana	pos=n,comp=y
guroH	guru	pos=n,g=m,c=6,n=s
DAma	DAman	pos=n,g=n,c=2,n=s
caRqISvarasya	caRqISvara	pos=n,g=m,c=6,n=s
Duta	DU	pos=va,comp=y,f=part
udyAnam	udyAna	pos=n,g=n,c=2,n=s
kuvalaya	kuvalaya	pos=n,comp=y
rajaH	rajas	pos=n,comp=y
ganDiBiH	ganDi	pos=a,g=m,c=3,n=p
ganDavatyAs	ganDavatI	pos=n,g=f,c=6,n=s
toya	toya	pos=n,comp=y
krIqA	krIqA	pos=n,comp=y
niramta	niram	pos=va,comp=y,f=part
yuvati	yuvati	pos=n,comp=y
snAna	snAna	pos=n,comp=y
tiktEH	tikta	pos=a,g=m,c=3,n=p
marudBiH	marut	pos=n,g=,c=3,n=p

# id = Megh.1.37
api	api	pos=i
anyasmin	anya	pos=n,g=m,c=7,n=s
jalaDarEH	jalaDara	pos=n,g=m,c=8,n=s
mahA	mahat	pos=a,comp=y
kAlam	kAla	pos=n,g=m,c=2,n=s
AsAdya	AsAday	pos=vi
kAle	kAla	pos=n,g=m,c=7,n=s
sTAtavyam	sTA	pos=va,g=n,c=1,n=s,f=krtya
te	tvad	pos=n,g=,c=6,n=s
nayanavizayam	nayanavizaya	pos=n,g=m,c=2,n=s
yAvad	yAvat	pos=i
atyeti	atI	pos=v,p=3,n=s,l=lat
BAnuH	BAnu	pos=n,g=m,c=1,n=s
kurvan	kf	pos=va,g=m,c=1,n=s,f=part
saMDyAbali	saMDyAbali	pos=n,comp=y
pawahatAm	pawahatA	pos=n,g=f,c=2,n=s
SUlinaH	SUlin	pos=n,g=m,c=6,n=s
SlAGanIyAm	SlAG	pos=va,g=f,c=2,n=s,f=krtya
AmandrARAm	Amandra	pos=a,g=m,c=6,n=p
Palam	Pala	pos=n,g=n,c=2,n=s
avikalam	avikala	pos=a,g=n,c=2,n=s
lapsyase	laB	pos=v,p=2,n=s,l=lrt
garjitAnAm	garj	pos=va,g=m,c=6,n=p,f=part

# id = Megh.1.38
pAda	pAda	pos=n,comp=y
nyAsEH	nyAsa	pos=n,g=m,c=3,n=p
kvaRita	kvaR	pos=va,comp=y,f=part
raSanAH	raSanA	pos=n,g=f,c=1,n=p
tatra	tatra	pos=i
lIlA	lIlA	pos=n,comp=y
avaDUtEH	avaDU	pos=va,g=n,c=3,n=p,f=part
ratna	ratna	pos=n,comp=y
CAyA	CAyA	pos=n,comp=y
Kacita	Kac	pos=va,comp=y,f=part
vali	vali	pos=n,g=n,c=3,n=p
cAmarEH	cAmara	pos=n,g=n,c=3,n=p
klAnta	klam	pos=va,comp=y,f=part
hastAH	hasta	pos=n,g=f,c=1,n=p
veSyAs	veSyA	pos=n,g=f,c=1,n=p
tvatto	tvad	pos=n,g=m,c=5,n=s
naKa	naKa	pos=n,comp=y
pada	pada	pos=n,comp=y
suKAn	suKa	pos=a,g=m,c=2,n=p
prApya	prAp	pos=vi
varza	varza	pos=n,comp=y
agra	agra	pos=n,comp=y
bindUn	bindu	pos=n,g=m,c=2,n=p
Amokzyante	Amuc	pos=v,p=3,n=p,l=lrt
tvayi	tvad	pos=n,g=,c=7,n=s
maDukara	maDukara	pos=n,comp=y
SreRI	SreRi	pos=n,comp=y
dIrGAn	dIrGa	pos=a,g=m,c=2,n=p
kawAkzAn	kawAkza	pos=n,g=m,c=2,n=p

# id = Megh.1.39
paScAd	paScAt	pos=i
uccEs	uccEs	pos=i
Buja	Buja	pos=n,comp=y
taru	taru	pos=n,comp=y
vanam	vana	pos=n,g=n,c=2,n=s
maRqalena	maRqala	pos=n,g=m,c=3,n=s
aBilInaH	aBilI	pos=va,g=m,c=1,n=s,f=part
sAMDyam	sAMDya	pos=a,g=n,c=2,n=s
tejaH	tejas	pos=n,g=n,c=2,n=s
pratinava	pratinava	pos=a,comp=y
japA	japA	pos=n,comp=y
puzpa	puzpa	pos=n,comp=y
raktam	rakta	pos=a,g=n,c=2,n=s
daDAnaH	DA	pos=va,g=m,c=1,n=s,f=part
nftta	nftta	pos=n,comp=y
AramBe	AramBa	pos=n,g=m,c=7,n=s
hara	hf	pos=v,p=2,n=s,l=lot
paSupateH	paSupati	pos=n,g=m,c=6,n=s
Ardra	Ardra	pos=a,comp=y
nAga	nAga	pos=n,comp=y
ajina	ajina	pos=n,comp=y
icCAm	icCA	pos=n,g=f,c=2,n=s
SAnta	Sam	pos=va,comp=y,f=part
udvega	udvega	pos=n,comp=y
stimita	stimita	pos=a,comp=y
nayanam	nayana	pos=n,g=n,c=2,n=s
dfzwa	dfS	pos=va,comp=y,f=part
BaktiH	Bakti	pos=n,g=m,c=1,n=s
BavAnyA	BavAnI	pos=n,g=f,c=3,n=s

# id = Megh.1.40
gacCantInAm	gam	pos=va,g=f,c=6,n=p,f=part
ramaRa	ramaRa	pos=n,comp=y
vasatim	vasati	pos=n,g=f,c=2,n=s
yozitAm	yozit	pos=n,g=f,c=6,n=p
tatra	tatra	pos=i
naktam	nakta	pos=n,g=n,c=2,n=s
rudDa	ruD	pos=va,comp=y,f=part
Aloke	Aloka	pos=n,g=m,c=7,n=s
narapati	narapati	pos=n,comp=y
paTe	paTa	pos=n,g=m,c=7,n=s
sUcI	sUci	pos=n,comp=y
BedyEH	Bid	pos=va,g=n,c=3,n=p,f=krtya
tamoBiH	tamas	pos=n,g=n,c=3,n=p
sOdAmanyA	sOdAmanI	pos=n,g=f,c=3,n=s
kanaka	kanaka	pos=n,comp=y
nikaza	nikaza	pos=n,comp=y
snigDayA	snigDa	pos=a,g=f,c=3,n=s
darSaya	darSay	pos=v,p=2,n=s,l=lot
urvIm	urvI	pos=n,g=f,c=2,n=s
toya	toya	pos=n,comp=y
utsarga	utsarga	pos=n,comp=y
stanita	stanita	pos=n,comp=y
muKaraH	muKara	pos=a,g=m,c=1,n=s
mA	mA	pos=i
ca	ca	pos=i
BUH	BU	pos=v,p=2,n=s,l=lun_unaug
viklava	viklava	pos=a,g=f,c=1,n=p
tAH	tad	pos=n,g=f,c=1,n=p

# id = Megh.1.41
tAm	tad	pos=n,g=f,c=2,n=s
kasyAMcid	kaScit	pos=n,g=f,c=7,n=s
Bavana	Bavana	pos=n,comp=y
valaBO	valaBi	pos=n,g=f,c=7,n=s
supta	svap	pos=va,comp=y,f=part
pArAvatAyAm	pArAvata	pos=n,g=f,c=7,n=s
nItvA	nI	pos=vi
rAtrim	rAtri	pos=n,g=f,c=2,n=s
cira	cira	pos=a,comp=y
vilasanAt	vilasana	pos=n,g=n,c=5,n=s
Kinna	Kid	pos=va,comp=y,f=part
vidyut	vidyut	pos=n,comp=y
kalatraH	kalatra	pos=n,g=m,c=1,n=s
dfzwe	dfS	pos=va,g=m,c=7,n=s,f=part
sUrye	sUrya	pos=n,g=m,c=7,n=s
punaH	punar	pos=i
api	api	pos=i
BavAn	Bavat	pos=a,g=m,c=1,n=s
vAhayet	vAhay	pos=v,p=3,n=s,l=vidhilin
aDva	aDvan	pos=n,comp=y
Sezam	Seza	pos=n,g=m,c=2,n=s
mandAyante	mandAy	pos=v,p=3,n=p,l=lat
na	na	pos=i
Kalu	Kalu	pos=i
suhfdAm	suhfd	pos=n,g=m,c=6,n=p
aByupetA	aByupe	pos=va,g=f,c=1,n=s,f=part
arTa	arTa	pos=n,comp=y
kftyAH	kftya	pos=n,g=m,c=1,n=p

# id = Megh.1.42
tasmin	tad	pos=n,g=m,c=7,n=s
kAle	kAla	pos=n,g=m,c=7,n=s
nayana	nayana	pos=n,comp=y
salilam	salila	pos=n,g=n,c=1,n=s
yozitAm	yozit	pos=n,g=f,c=6,n=p
KaRqitAnAm	KaRqay	pos=va,g=f,c=6,n=p,f=part
SAntim	SAnti	pos=n,g=f,c=2,n=s
neyam	nI	pos=va,g=n,c=1,n=s,f=krtya
praRayiBiH	praRayin	pos=a,g=m,c=3,n=p
ato	atas	pos=i
vartma	vartman	pos=n,g=n,c=2,n=s
BAnos	BAnu	pos=n,g=m,c=6,n=s
tyaja	tyaj	pos=v,p=2,n=s,l=lot
ASu	ASu	pos=i
prAleya	prAleya	pos=n,comp=y
astram	astra	pos=n,g=n,c=2,n=s
kamala	kamala	pos=n,comp=y
vadanAt	vadana	pos=n,g=n,c=5,n=s
so	tad	pos=n,g=m,c=1,n=s
'pi	api	pos=i
hartum	hf	pos=vi
nalinyAH	nalinI	pos=n,g=f,c=6,n=s
pratyAvfttaH	pratyAvft	pos=va,g=m,c=1,n=s,f=part
tve	tvad	pos=n,g=,c=7,n=s
kararuDi	kararuD	pos=a,g=m,c=7,n=s
syAd	as	pos=v,p=3,n=s,l=vidhilin
analpa	analpa	pos=a,comp=y
aByasUyaH	aByasUyA	pos=n,g=m,c=1,n=s

# id = Megh.1.43
gamBIrAyAH	gamBIra	pos=a,g=f,c=6,n=s
payasi	payas	pos=n,g=n,c=7,n=s
saritaH	sarit	pos=n,g=f,c=6,n=s
cetasi	cetas	pos=n,g=n,c=7,n=s
iva	iva	pos=i
prasanne	prasad	pos=va,g=n,c=7,n=s,f=part
CAyA	CAyA	pos=n,comp=y
AtmA	Atman	pos=n,g=m,c=1,n=s
api	api	pos=i
prakfti	prakfti	pos=n,comp=y
suBagaH	suBaga	pos=a,g=m,c=1,n=s
lapsyate	laB	pos=v,p=3,n=s,l=lrt
te	tvad	pos=n,g=,c=6,n=s
praveSam	praveSa	pos=n,g=m,c=2,n=s
tasmAd	tasmAt	pos=i
asyAH	idam	pos=n,g=f,c=6,n=s
kumuda	kumuda	pos=n,comp=y
viSadAni	viSada	pos=a,g=n,c=2,n=p
arhasi	arh	pos=v,p=2,n=s,l=lat
tvam	tvad	pos=n,g=,c=1,n=s
na	na	pos=i
DEryAn	DErya	pos=n,g=n,c=5,n=s
moGIkartum	moGIkf	pos=vi

# id = Megh.1.44
tasyAH	tad	pos=n,g=f,c=6,n=s
kiMcit	kaScit	pos=n,g=n,c=2,n=s
kara	kara	pos=n,comp=y
Dftam	Df	pos=va,g=n,c=2,n=s,f=part
iva	iva	pos=i
prApta	prAp	pos=va,comp=y,f=part
vAnIra	vAnIra	pos=n,comp=y
SAKam	SAKA	pos=n,g=n,c=2,n=s
hftvA	hf	pos=vi
nIlam	nIla	pos=a,g=n,c=2,n=s
salila	salila	pos=n,comp=y
vasanam	vasana	pos=n,g=n,c=2,n=s
mukta	muc	pos=va,comp=y,f=part
roDas	roDas	pos=n,comp=y
nitambam	nitamba	pos=n,g=n,c=2,n=s
prasTAnam	prasTAna	pos=n,g=n,c=1,n=s
te	tvad	pos=n,g=,c=6,n=s
kaTam	kaTam	pos=i
api	api	pos=i
saKe	saKi	pos=n,g=,c=8,n=s
lambamAnasya	lamb	pos=va,g=m,c=6,n=s,f=part
BAvi	BAvin	pos=a,g=n,c=1,n=s
jYAta	jYA	pos=va,comp=y,f=part
AsvAdaH	AsvAda	pos=n,g=m,c=1,n=s
vivfta	vivf	pos=va,comp=y,f=part
jaGanAm	jaGana	pos=n,g=f,c=2,n=s
ko	ka	pos=n,g=m,c=1,n=s
vihAtum	vihA	pos=vi
samarTaH	samarTa	pos=a,g=m,c=1,n=s

# id = Megh.1.45
tvad	tvad	pos=n,comp=y
nizyanda	nisyanda	pos=n,comp=y
ucCvasita	ucCvas	pos=va,comp=y,f=part
vasuDA	vasuDA	pos=n,comp=y
ganDa	ganDa	pos=n,comp=y
saMparka	samparka	pos=n,comp=y
ramyaH	ramya	pos=a,g=m,c=1,n=s
srotoranDra	srotoranDra	pos=n,comp=y
Dvanita	Dvanita	pos=n,comp=y
suBagam	suBaga	pos=a,g=n,c=2,n=s
dantiBiH	dantin	pos=n,g=m,c=3,n=p
pIyamAnaH	pA	pos=va,g=m,c=1,n=s,f=part
nIcEH	nIcEs	pos=i
vAsyaty	vA	pos=v,p=3,n=s,l=lrt
upajigamizoH	upajigamizu	pos=a,g=m,c=6,n=s
deva	deva	pos=n,comp=y
pUrvam	pUrva	pos=n,g=m,c=2,n=s
girim	giri	pos=n,g=m,c=2,n=s
te	tvad	pos=n,g=,c=6,n=s
SIto	SIta	pos=a,g=m,c=1,n=s
vAyuH	vAyu	pos=n,g=m,c=1,n=s
pariRamayitA	pariRamayitf	pos=a,g=m,c=1,n=s
kAnana	kAnana	pos=n,comp=y
udumbarAnAm	udumbara	pos=n,g=m,c=6,n=p

# id = Megh.1.46
tatra	tatra	pos=i
skandam	skanda	pos=n,g=m,c=2,n=s
niyamita	niyam	pos=va,comp=y,f=part
vasati	vasati	pos=n,g=m,c=2,n=s
puzpa	puzpa	pos=n,comp=y
meGIkf	meGIkf	pos=va,comp=y,f=part
AtmA	Atman	pos=n,g=m,c=1,n=s
puzpa	puzpa	pos=n,comp=y
AsArEH	AsAra	pos=n,g=m,c=3,n=p
snapayatu	snapay	pos=v,p=3,n=s,l=lot
BavAn	Bavat	pos=a,g=m,c=1,n=s
vyomagaNgA	vyomagaNgA	pos=n,comp=y
jala	jala	pos=n,comp=y
ArdrEH	Ardra	pos=a,g=m,c=3,n=p
rakzA	rakzA	pos=n,comp=y
hetoH	hetu	pos=n,g=m,c=5,n=s
navaSaSiBftA	navaSaSiBft	pos=n,g=m,c=3,n=s
vAsavInAm	vAsava	pos=a,g=f,c=6,n=p
camUnAm	camU	pos=n,g=f,c=6,n=p
ati	ati	pos=i
Adityam	Aditya	pos=n,g=m,c=2,n=s
hutavaha	hutavaha	pos=n,comp=y
muKe	muKa	pos=n,g=n,c=7,n=s
saMBftam	samBf	pos=va,g=n,c=1,n=s,f=part
tat	tad	pos=n,g=n,c=1,n=s
hi	hi	pos=i
tejaH	tejas	pos=n,g=n,c=1,n=s

# id = Megh.1.47
jyotiH	jyotis	pos=n,comp=y
leKA	leKA	pos=n,comp=y
valayin	valayin	pos=a,g=n,c=1,n=s
galitam	gal	pos=va,g=n,c=1,n=s,f=part
yasya	yad	pos=n,g=m,c=6,n=s
barham	barha	pos=n,g=n,c=1,n=s
BavAnI	BavAnI	pos=n,g=f,c=1,n=s
putra	putra	pos=n,comp=y
premRA	preman	pos=n,g=,c=3,n=s
kuvalaya	kuvalaya	pos=n,comp=y
dala	dala	pos=n,comp=y
prApin	prApin	pos=a,g=n,c=2,n=s
karRe	karRa	pos=n,g=m,c=7,n=s
karoti	kf	pos=v,p=3,n=s,l=lat
DOta	DAv	pos=va,comp=y,f=part
apANgam	apANga	pos=n,g=m,c=2,n=s
hara	hara	pos=n,comp=y
SaSi	SaSin	pos=n,comp=y
rucA	ruc	pos=n,g=f,c=3,n=s
pAvakes	pAvaki	pos=n,g=m,c=6,n=s
tam	tad	pos=n,g=m,c=2,n=s
mayUram	mayUra	pos=n,g=m,c=2,n=s
paScAd	paScAt	pos=i
adri	adri	pos=n,comp=y
grahaRa	grahaRa	pos=n,comp=y
guruBiH	guru	pos=a,g=n,c=3,n=p
garjitEH	garjita	pos=n,g=n,c=3,n=p
nartayeTAH	nartay	pos=v,p=2,n=s,l=vidhilin

# id = Megh.1.48
ArADya	ArADay	pos=vi
enam	enad	pos=n,g=m,c=2,n=s
SaravaRa	SaravaRa	pos=n,comp=y
Bavam	Bava	pos=n,g=m,c=2,n=s
devam	deva	pos=n,g=m,c=2,n=s
ullaNGita	ullaNGay	pos=va,comp=y,f=part
aDvA	aDvan	pos=n,g=m,c=1,n=s
sidDa	siD	pos=va,comp=y,f=part
dvaMdvEH	dvaMdva	pos=n,g=m,c=3,n=p
jala	jala	pos=n,comp=y
kaRa	kaRa	pos=n,comp=y
BayAt	Baya	pos=n,g=n,c=5,n=s
vIRiBiH	vIRin	pos=a,g=m,c=3,n=p
mukta	muc	pos=va,comp=y,f=part
mArgaH	mArga	pos=n,g=m,c=1,n=s
vyAlambeTAH	vyAlamb	pos=v,p=2,n=s,l=vidhilin
suraBitanayA	suraBitanayA	pos=n,comp=y
AlamBa	AlamBa	pos=n,comp=y
jAm	ja	pos=a,g=f,c=2,n=s
mAnayizyan	mAnay	pos=va,g=m,c=1,n=s,f=part
srotaH	srotas	pos=n,comp=y
mUrteH	mUrti	pos=n,g=f,c=6,n=s
Buvi	BU	pos=n,g=f,c=7,n=s
pariRatAm	pariRam	pos=va,g=f,c=2,n=s,f=part
rantidevasya	rantideva	pos=n,g=m,c=6,n=s
kIrtim	kIrti	pos=n,g=f,c=2,n=s

# id = Megh.1.49
tvayy	tvad	pos=n,g=,c=7,n=s
AdAtum	AdA	pos=vi
jalam	jala	pos=n,g=n,c=2,n=s
avanate	avanam	pos=va,g=m,c=7,n=s,f=part
SArNgiRo	SArNgin	pos=n,g=m,c=6,n=s
varRa	varRa	pos=n,comp=y
cOre	cOra	pos=n,g=m,c=7,n=s
tasyAH	tad	pos=n,g=f,c=6,n=s
sinDoH	sinDu	pos=n,g=m,c=6,n=s
pfTum	pfTu	pos=a,g=m,c=2,n=s
api	api	pos=i
tanum	tanu	pos=a,g=m,c=2,n=s
dUra	dUra	pos=a,comp=y
BAvAt	BAva	pos=n,g=m,c=5,n=s
pravAham	pravAha	pos=n,g=m,c=2,n=s
prekzizyante	prekz	pos=v,p=3,n=p,l=lrt
gagana	gagana	pos=n,comp=y
gatayaH	gati	pos=n,g=m,c=1,n=p
nUnam	nUnam	pos=i
Avarjya	Avarjay	pos=vi
dfzwiH	dfzwi	pos=n,g=f,c=1,n=s
ekam	eka	pos=n,g=m,c=2,n=s
muktA	muktA	pos=n,comp=y
guRam	guRa	pos=n,g=m,c=2,n=s
iva	iva	pos=i
BuvaH	BU	pos=n,g=f,c=6,n=s
sTUla	sTUla	pos=a,comp=y
maDya	maDya	pos=n,comp=y
indranIlam	indranIla	pos=n,g=m,c=2,n=s

# id = Megh.1.50
tAm	tad	pos=n,g=f,c=2,n=s
uttIrya	uttf	pos=vi
vraja	vraj	pos=v,p=2,n=s,l=lot
parici	parici	pos=va,comp=y,f=part
BrU	BrU	pos=n,comp=y
latA	latA	pos=n,comp=y
viBramAnAm	viBrama	pos=n,g=f,c=6,n=p
pakzma	pakzman	pos=n,comp=y
utkzepAt	utkzepa	pos=n,g=m,c=5,n=s
upari	upari	pos=i
vilasat	vilas	pos=va,comp=y,f=part
kfzRa	kfzRa	pos=a,comp=y
SAra	SAra	pos=a,comp=y
praBAnAm	praBA	pos=n,g=f,c=6,n=p
kunda	kunda	pos=n,comp=y
kzepa	kzepa	pos=n,comp=y
anuga	anuga	pos=a,comp=y
maDukara	maDukara	pos=n,comp=y
SrI	SrI	pos=n,comp=y
muH	muz	pos=n,g=f,c=6,n=p
Atma	Atman	pos=n,comp=y
bimbam	bimba	pos=n,g=n,c=2,n=s
pAtrIkurvan	pAtrIkf	pos=va,g=m,c=1,n=s,f=part
daSa	daSan	pos=n,comp=y
puravaDU	puravaDU	pos=n,comp=y
netra	netra	pos=n,comp=y
kOtUhalAnAm	kOtUhala	pos=n,g=f,c=6,n=p

# id = Megh.1.51
brahmAvartam	brahmAvarta	pos=n,g=m,c=2,n=s
janapadam	janapada	pos=n,g=m,c=2,n=s
aTa	aTa	pos=i
CAyayA	CAyA	pos=n,g=f,c=3,n=s
gAhamAnaH	gAh	pos=va,g=m,c=1,n=s,f=part
kzetram	kzetra	pos=n,g=n,c=2,n=s
kzatra	kzatra	pos=n,comp=y
praDana	praDana	pos=n,comp=y
piSunam	piSuna	pos=a,g=n,c=2,n=s
kOravam	kOrava	pos=a,g=n,c=2,n=s
tad	tad	pos=n,g=n,c=2,n=s
BajeTAH	Baj	pos=v,p=2,n=s,l=vidhilin
rAjanyAnAm	rAjanya	pos=n,g=m,c=6,n=p
Sita	SA	pos=va,comp=y,f=part
Sara	Sara	pos=n,comp=y
SatEH	Sata	pos=n,g=n,c=3,n=p
yatra	yatra	pos=i
gARqIvaDanvA	gARqIvaDanvan	pos=n,g=m,c=1,n=s
DAra	DArA	pos=n,comp=y
pAtEH	pAta	pos=n,g=m,c=3,n=p
tvam	tvad	pos=n,g=,c=1,n=s
iva	iva	pos=i
kamalAny	kamala	pos=n,g=n,c=2,n=p
aByavarzan	aBivfz	pos=v,p=3,n=p,l=lan
muKAni	muKa	pos=n,g=n,c=2,n=p

# id = Megh.1.52
hitvA	hA	pos=vi
hAlAm	hAlA	pos=n,g=f,c=2,n=s
aBimata	aBiman	pos=va,comp=y,f=part
rasAm	rasa	pos=n,g=f,c=2,n=s
revatI	revatI	pos=n,comp=y
locana	locana	pos=n,comp=y
aNkAm	aNka	pos=n,g=f,c=2,n=s
banDu	banDu	pos=n,comp=y
prItyA	prIti	pos=n,g=f,c=3,n=s
samara	samara	pos=n,comp=y
vimuKaH	vimuKa	pos=a,g=m,c=1,n=s
lANgalI	lANgalin	pos=n,g=m,c=1,n=s
yAH	yad	pos=n,g=f,c=2,n=p
sizeve	sev	pos=v,p=3,n=s,l=lit
kftvA	kf	pos=vi
tAsAm	tad	pos=n,g=f,c=6,n=p
aDigamam	aDigama	pos=n,g=m,c=2,n=s
apAm	ap	pos=n,g=n,c=6,n=p
sOmya	sOmya	pos=a,g=m,c=8,n=s
sArasvatInAm	sArasvata	pos=a,g=f,c=6,n=p
antaH	antar	pos=i
SudDas	SuD	pos=va,g=m,c=1,n=s,f=part
tvam	tva	pos=n,g=n,c=1,n=s
api	api	pos=i
BavitA	BU	pos=v,p=3,n=s,l=lrt
varRa	varRa	pos=n,comp=y
mAtreRa	mAtra	pos=n,g=n,c=3,n=s
kfzRaH	kfzRa	pos=a,g=m,c=1,n=s

# id = Megh.1.53
tasmAd	tad	pos=n,g=n,c=5,n=s
gacCeH	gam	pos=v,p=2,n=s,l=vidhilin
anu	anu	pos=i
kanaKalam	kanaKala	pos=n,g=n,c=2,n=s
SElarAja	SElarAja	pos=n,comp=y
avatIrRAm	avatf	pos=va,g=f,c=2,n=s,f=part
jahnoH	jahnu	pos=n,g=m,c=6,n=s
kanyAm	kanyA	pos=n,g=f,c=2,n=s
sagara	sagara	pos=n,comp=y
tanaya	tanaya	pos=n,comp=y
svarga	svarga	pos=n,comp=y
sopAna	sopAna	pos=n,comp=y
paNktim	paNkti	pos=n,g=f,c=2,n=s
gOrI	gOrI	pos=n,comp=y
vaktra	vaktra	pos=n,comp=y
BrukuwI	Brukuwi	pos=n,comp=y
racanAm	racanA	pos=n,g=f,c=2,n=s
yA	yad	pos=n,g=f,c=1,n=s
vihasya	vihas	pos=vi
iva	iva	pos=i
PenEH	Pena	pos=n,g=m,c=3,n=p
SamBoH	SamBu	pos=n,g=m,c=6,n=s
keSa	keSa	pos=n,comp=y
grahaRam	grahaRa	pos=n,g=n,c=2,n=s
akarod	kf	pos=v,p=3,n=s,l=lan
indu	indu	pos=n,comp=y
lagna	lag	pos=va,comp=y,f=part
Urmi	Urmi	pos=n,comp=y
hastA	hasta	pos=n,g=f,c=1,n=s

# id = Megh.1.54
tasyAH	tad	pos=n,g=f,c=6,n=s
pAtum	pA	pos=vi
sura	sura	pos=n,comp=y
gajaH	gaja	pos=n,g=m,c=1,n=s
iva	iva	pos=i
vyomni	vyoman	pos=n,g=m,c=7,n=s
paSca	paSca	pos=a,comp=y
arDa	arDa	pos=n,comp=y
lambI	lambin	pos=a,g=m,c=1,n=s
tvam	tvad	pos=n,g=,c=1,n=s
ced	ced	pos=i
acCa	acCa	pos=a,comp=y
sPawika	sPawika	pos=n,comp=y
viSadam	viSada	pos=a,g=n,c=2,n=s
tarkayes	tarkay	pos=v,p=2,n=s,l=vidhilin
tiryag	tiryaYc	pos=a,g=n,c=2,n=s
amBaH	amBas	pos=n,g=n,c=2,n=s
saMsarpantyA	saMsfp	pos=va,g=f,c=3,n=s,f=part
sapadi	sapadi	pos=i
BavataH	Bavat	pos=a,g=m,c=6,n=s
srotasi	srotas	pos=n,g=n,c=7,n=s
CAyayA	CAyA	pos=n,g=f,c=3,n=s
asO	adas	pos=n,g=f,c=1,n=s
syAd	as	pos=v,p=3,n=s,l=vidhilin
asTAna	asTAna	pos=n,comp=y
upagata	upagam	pos=va,comp=y,f=part
yamunA	yamunA	pos=n,comp=y
saMgamA	saMgama	pos=n,g=f,c=1,n=s
iva	iva	pos=i
aBirAmA	aBirAma	pos=a,g=f,c=1,n=s

# id = Megh.1.55
AsInAnAm	As	pos=va,g=m,c=6,n=p,f=part
suraBita	suraBay	pos=va,comp=y,f=part
Silam	SilA	pos=n,g=m,c=2,n=s
nABi	nABi	pos=n,comp=y
ganDEH	ganDa	pos=n,g=m,c=3,n=p
mfgARAm	mfga	pos=n,g=m,c=6,n=p
tasyAH	tad	pos=n,g=f,c=6,n=s
eva	eva	pos=i
praBavam	praBava	pos=n,g=m,c=2,n=s
acalam	acala	pos=n,g=m,c=2,n=s
prApya	prAp	pos=vi
gOram	gOra	pos=a,g=m,c=2,n=s
tuzArEH	tuzAra	pos=n,g=m,c=3,n=p
vakzyasy	vac	pos=v,p=2,n=s,l=lrt
aDva	aDvan	pos=n,comp=y
Srama	Srama	pos=n,comp=y
vinayena	vinaya	pos=n,g=m,c=3,n=s
tasya	tad	pos=n,g=m,c=6,n=s
SfNge	SfNga	pos=n,g=n,c=7,n=s
nizaRRaH	nizad	pos=va,g=m,c=1,n=s,f=part
SoBAm	SoBA	pos=n,g=f,c=2,n=s
SuBrAm	SuBra	pos=a,g=f,c=2,n=s
trinayana	trinayana	pos=n,comp=y
vfza	vfza	pos=n,comp=y
utKAta	utKan	pos=va,comp=y,f=part
paNka	paNka	pos=n,comp=y
upameyam	upamA	pos=va,g=m,c=2,n=s,f=krtya

# id = Megh.1.56
tam	tad	pos=n,g=m,c=2,n=s
ced	ced	pos=i
vAyO	vAyu	pos=n,g=m,c=7,n=s
sarati	sf	pos=va,g=m,c=7,n=s,f=part
sarala	sarala	pos=n,comp=y
skanDa	skanDa	pos=n,comp=y
saMGawwa	saMGawwa	pos=n,comp=y
janmA	janman	pos=n,g=m,c=1,n=s
bADeta	bAD	pos=v,p=3,n=s,l=vidhilin
ulkA	ulkA	pos=n,comp=y
kzapita	kzapay	pos=va,comp=y,f=part
camarI	camarI	pos=n,comp=y
bAla	bAla	pos=n,comp=y
BAraH	BAra	pos=n,g=m,c=1,n=s
dava	dava	pos=n,comp=y
agniH	agni	pos=n,g=m,c=1,n=s
arhasy	arh	pos=v,p=2,n=s,l=lat
enam	enad	pos=n,g=m,c=2,n=s
Samayitum	Samay	pos=vi
alam	alam	pos=i
vAri	vAri	pos=n,comp=y
DArA	DArA	pos=n,comp=y
sahasrEH	sahasra	pos=n,g=n,c=3,n=p
Apanna	Apad	pos=va,comp=y,f=part
Arti	Arti	pos=n,comp=y
praSamana	praSamana	pos=n,comp=y
Pala	Pala	pos=n,g=f,c=1,n=p
saMpado	sampad	pos=n,g=f,c=1,n=p
hy	hi	pos=i
uttamAnAm	uttama	pos=a,g=m,c=6,n=p

# id = Megh.1.57
ye	yad	pos=n,g=m,c=1,n=p
saMramBa	saMramBa	pos=n,comp=y
utpatana	utpatana	pos=n,comp=y
raBasAH	raBasa	pos=a,g=m,c=1,n=p
sva	sva	pos=a,comp=y
aNga	aNga	pos=n,comp=y
BaNgAya	BaNga	pos=n,g=m,c=4,n=s
tasmin	tad	pos=n,g=m,c=7,n=s
mukta	muc	pos=va,comp=y,f=part
aDvAnam	aDvan	pos=n,g=m,c=2,n=s
sapadi	sapadi	pos=i
SaraBA	SaraBa	pos=n,g=m,c=1,n=p
laNGayeyuH	laNGay	pos=v,p=3,n=p,l=vidhilin
Bavantam	Bavat	pos=a,g=m,c=2,n=s
tAn	tad	pos=n,g=m,c=2,n=p
kurvITAs	kf	pos=v,p=2,n=s,l=vidhilin
tumula	tumula	pos=a,comp=y
karaka	karaka	pos=n,comp=y
Avfzwi	Avfzwi	pos=n,comp=y
pAta	pAta	pos=n,comp=y
avakIrRAn	avakf	pos=va,g=m,c=2,n=p,f=part
ke	ka	pos=n,g=m,c=1,n=p
vA	vA	pos=i
na	na	pos=i
syuH	as	pos=v,p=3,n=p,l=vidhilin
pariBava	pariBava	pos=n,comp=y
padam	pada	pos=n,g=n,c=2,n=s
nizPala	nizPala	pos=a,comp=y
AramBa	AramBa	pos=n,comp=y
yatnAH	yatna	pos=n,g=m,c=1,n=p

# id = Megh.1.58
tatra	tatra	pos=i
vyaktam	vyakta	pos=a,g=n,c=2,n=s
dfzadi	dfzad	pos=n,g=f,c=7,n=s
caraRa	caraRa	pos=n,comp=y
nyAsam	nyAsa	pos=n,g=m,c=2,n=s
arDa	arDa	pos=a,comp=y
indu	indu	pos=n,comp=y
mOli	mOli	pos=n,g=m,c=6,n=s
SaSvat	SaSvat	pos=i
sidDEH	sidDa	pos=n,g=m,c=3,n=p
upacita	upaci	pos=va,comp=y,f=part
balim	bali	pos=n,g=m,c=2,n=s
Bakti	Bakti	pos=n,comp=y
namraH	namra	pos=a,g=m,c=1,n=s
parIyAH	parI	pos=v,p=2,n=s,l=vidhilin
yasmin	yad	pos=n,g=m,c=7,n=s
dfzwe	dfS	pos=va,g=m,c=7,n=s,f=part
karaRa	karaRa	pos=n,comp=y
vigamAt	vigama	pos=n,g=m,c=5,n=s
UrDvam	UrDvam	pos=i
udDUta	udDU	pos=va,comp=y,f=part
pApAH	pApa	pos=n,g=m,c=1,n=p
kalpizyante	kï¾±p	pos=v,p=3,n=p,l=lrt
sTira	sTira	pos=a,comp=y
gaRa	gaRa	pos=n,comp=y
pada	pada	pos=n,comp=y
prAptaye	prApti	pos=n,g=f,c=4,n=s
SraddaDAnAH	SradDA	pos=va,g=m,c=1,n=p,f=part

# id = Megh.1.59
SabdAyante	SabdAy	pos=v,p=3,n=p,l=lat
maDuram	maDura	pos=a,g=n,c=2,n=s
anilEH	anila	pos=n,g=m,c=3,n=p
kIcakAH	kIcaka	pos=n,g=m,c=1,n=p
pUryamARAH	pf	pos=va,g=m,c=1,n=p,f=part
saMraktABis	saMraYj	pos=va,g=f,c=3,n=p,f=part
tripura	tripura	pos=n,comp=y
vijayaH	vijaya	pos=n,g=m,c=1,n=s
gIyate	gA	pos=v,p=3,n=s,l=lat
kiMnarIBiH	kiMnarI	pos=n,g=f,c=3,n=p
nirhrAdas	nirhrAda	pos=n,g=m,c=1,n=s
te	tvad	pos=n,g=,c=6,n=s
muraja	muraja	pos=n,g=m,c=1,n=s
iva	iva	pos=i
cet	ced	pos=i
kandarezu	kandara	pos=n,g=m,c=7,n=p
DvaniH	Dvani	pos=n,g=m,c=1,n=s
syAt	as	pos=v,p=3,n=s,l=vidhilin
saMgIta	saMgIta	pos=n,comp=y
arTaH	arTa	pos=n,g=m,c=1,n=s
nanu	nanu	pos=i
paSupates	paSupati	pos=n,g=m,c=6,n=s
tatra	tatra	pos=i
BAvI	BAvin	pos=a,g=m,c=1,n=s
samagraH	samagra	pos=a,g=m,c=1,n=s

# id = Megh.1.60
prAleyAdreH	prAleyAdri	pos=n,g=m,c=6,n=s
upatawam	upatawam	pos=i
atikramya	atikram	pos=vi
tAMs	tad	pos=n,g=m,c=2,n=p
tAn	tad	pos=n,g=m,c=2,n=p
viSezAn	viSeza	pos=n,g=m,c=2,n=p
haMsadvAram	haMsadvAra	pos=n,g=n,c=2,n=s
Bfgupati	Bfgupati	pos=n,comp=y
yaSaH	yaSas	pos=n,comp=y
vartman	vartman	pos=n,g=n,c=1,n=s
yat	yad	pos=n,g=n,c=1,n=s
krOYcaranDram	krOYcaranDra	pos=n,g=n,c=1,n=s
tena	tad	pos=n,g=n,c=3,n=s
udIcIm	udaYc	pos=a,g=f,c=2,n=s
diSam	diS	pos=n,g=f,c=2,n=s
anusares	anusf	pos=v,p=2,n=s,l=vidhilin
tiryag	tiryaYc	pos=a,g=n,c=2,n=s
AyAma	AyAma	pos=n,comp=y
SoBI	SoBin	pos=a,g=m,c=1,n=s
SyAmaH	SyAma	pos=a,g=m,c=1,n=s
pAdo	pAda	pos=n,g=m,c=1,n=s
bali	bali	pos=n,comp=y
niyamana	niyamana	pos=n,comp=y
aByudyatasya	aByudyam	pos=va,g=m,c=6,n=s,f=part
iva	iva	pos=i
vizRoH	vizRu	pos=n,g=m,c=6,n=s

# id = Megh.1.61
gatvA	gam	pos=vi
ca	ca	pos=i
UrDvam	UrDvam	pos=i
daSamuKa	daSamuKa	pos=n,comp=y
Buja	Buja	pos=n,comp=y
ucCvAsay	ucCvAsay	pos=va,comp=y,f=part
prasTa	prasTa	pos=n,comp=y
saMDi	saMDi	pos=n,g=m,c=6,n=s
kElAsasya	kElAsa	pos=n,g=m,c=6,n=s
tridaSa	tridaSa	pos=n,comp=y
vanitA	vanitA	pos=n,comp=y
darpaRasya	darpaRa	pos=n,g=m,c=6,n=s
atiTiH	atiTi	pos=n,g=m,c=1,n=s
syAH	as	pos=v,p=2,n=s,l=vidhilin
SfNga	SfNga	pos=n,comp=y
ucCrAyEH	ucCrAya	pos=n,g=m,c=3,n=p
kumuda	kumuda	pos=n,comp=y
viSadEH	viSada	pos=a,g=m,c=3,n=p
yo	yad	pos=n,g=m,c=1,n=s
vitatya	vitan	pos=vi
sTitaH	sTA	pos=va,g=m,c=1,n=s,f=part
Kam	Ka	pos=n,g=n,c=2,n=s
rASIBUtaH	rASIBUta	pos=a,g=m,c=1,n=s
pratidinam	pratidinam	pos=i
iva	iva	pos=i
tryambakasya	tryambaka	pos=n,g=m,c=6,n=s
awwahAsaH	awwahAsa	pos=n,g=m,c=1,n=s

# id = Megh.1.62
utpaSyAmi	utpaS	pos=v,p=1,n=s,l=lat
tvayi	tvad	pos=n,g=,c=7,n=s
tawa	tawa	pos=n,comp=y
gate	gam	pos=va,g=m,c=7,n=s,f=part
snigDa	snigDa	pos=a,comp=y
BinnAYjana	BinnAYjana	pos=n,comp=y
ABe	ABa	pos=a,g=m,c=7,n=s
sadyaH	sadyas	pos=i
kftta	kft	pos=va,comp=y,f=part
dvirada	dvirada	pos=n,comp=y
daSana	daSana	pos=n,comp=y
Ceda	Ceda	pos=n,comp=y
gOrasya	gOra	pos=a,g=m,c=6,n=s
tasya	tad	pos=n,g=m,c=6,n=s
SoBAm	SoBA	pos=n,g=f,c=2,n=s
adreH	adri	pos=n,g=m,c=6,n=s
stimita	stimita	pos=a,comp=y
nayana	nayana	pos=n,comp=y
prekzaRIyAm	prekz	pos=va,g=f,c=2,n=s,f=krtya
BavitrIm	Bavitf	pos=a,g=f,c=2,n=s
aMsa	aMsa	pos=n,comp=y
nyaste	nyas	pos=va,g=n,c=7,n=s,f=part
sati	as	pos=va,g=n,c=7,n=s,f=part
halaBfto	halaBft	pos=n,g=m,c=6,n=s
mecake	mecaka	pos=a,g=n,c=7,n=s
vAsasi	vAsas	pos=n,g=n,c=7,n=s
iva	iva	pos=i

# id = Megh.1.63
hitvA	hA	pos=vi
tasmin	tad	pos=n,g=m,c=7,n=s
Bujaga	Bujaga	pos=n,comp=y
valayam	valaya	pos=n,g=m,c=2,n=s
SamBunA	SamBu	pos=n,g=m,c=3,n=s
datta	dA	pos=va,comp=y,f=part
hastA	hasta	pos=n,g=f,c=1,n=s
krIqA	krIqA	pos=n,comp=y
SEle	SEla	pos=n,g=m,c=7,n=s
yadi	yadi	pos=i
ca	ca	pos=i
vicaret	vicar	pos=v,p=3,n=s,l=vidhilin
pAda	pAda	pos=n,comp=y
cArena	cAra	pos=n,g=m,c=3,n=s
gOrI	gOrI	pos=n,g=f,c=1,n=s
BaNgI	BaNgI	pos=n,comp=y
BaktyA	Bakti	pos=n,g=f,c=3,n=s
viracita	viracay	pos=va,comp=y,f=part
vapuH	vapus	pos=n,g=m,c=1,n=s
stamBita	stamBay	pos=va,comp=y,f=part
antaH	antar	pos=i
jala	jala	pos=n,comp=y
oGaH	oGa	pos=n,g=m,c=1,n=s
sopAna	sopAna	pos=n,comp=y
tvam	tva	pos=n,g=n,c=2,n=s
kuru	kf	pos=v,p=2,n=s,l=lot
maRi	maRi	pos=n,comp=y
tawa	tawa	pos=n,comp=y
ArohaRAya	ArohaRa	pos=n,g=n,c=4,n=s
agra	agra	pos=n,comp=y
yAyI	yAyin	pos=a,g=m,c=1,n=s

# id = Megh.1.64
tatra	tatra	pos=i
avaSyam	avaSyam	pos=i
valaya	valaya	pos=n,comp=y
kuliSa	kuliSa	pos=n,comp=y
udGawwana	udGawwana	pos=n,comp=y
udgIrRa	udgf	pos=va,comp=y,f=part
toyam	toya	pos=n,g=m,c=2,n=s
nezyanti	nI	pos=v,p=3,n=p,l=lrt
tvAm	tvad	pos=n,g=,c=2,n=s
sura	sura	pos=n,comp=y
yuvatayaH	yuvati	pos=n,g=f,c=1,n=p
yantra	yantra	pos=n,comp=y
DArAgfha	DArAgfha	pos=n,comp=y
tvam	tva	pos=n,g=n,c=2,n=s
tAByo	tad	pos=n,g=f,c=5,n=p
mokzas	mokza	pos=n,g=m,c=1,n=s
tava	tvad	pos=n,g=,c=6,n=s
yadi	yadi	pos=i
saKe	saKi	pos=n,g=,c=8,n=s
Garma	Garma	pos=n,comp=y
labDasya	laB	pos=va,g=m,c=6,n=s,f=part
na	na	pos=i
syAt	as	pos=v,p=3,n=s,l=vidhilin
krIqA	krIqA	pos=n,comp=y
lolAH	lola	pos=a,g=f,c=2,n=p
SravaRa	SravaRa	pos=n,comp=y
paruzEH	paruza	pos=a,g=n,c=3,n=p
garjitEH	garjita	pos=n,g=n,c=3,n=p
BAyayes	BAyay	pos=v,p=2,n=s,l=vidhilin
tAH	tad	pos=n,g=f,c=2,n=p

# id = Megh.1.65
hema	heman	pos=n,comp=y
amBoja	amBoja	pos=n,comp=y
prasavi	prasavin	pos=a,g=n,c=2,n=s
salilam	salila	pos=n,g=n,c=2,n=s
mAnasasya	mAnasa	pos=n,g=n,c=6,n=s
AdadAnaH	AdA	pos=va,g=m,c=1,n=s,f=part
kurvan	kf	pos=va,g=m,c=1,n=s,f=part
kAmam	kAma	pos=n,g=m,c=2,n=s
kzaRa	kzaRa	pos=n,comp=y
muKa	muKa	pos=n,comp=y
pawa	pawa	pos=n,comp=y
prItim	prIti	pos=n,g=f,c=2,n=s
ErAvatasya	ErAvata	pos=n,g=m,c=6,n=s
Dunvan	DU	pos=va,g=m,c=1,n=s,f=part
kalpadruma	kalpadruma	pos=n,comp=y
kisalayAni	kisalaya	pos=n,g=n,c=2,n=p
aMSukAni	aMSuka	pos=n,g=n,c=2,n=p
iva	iva	pos=i
vAtEH	vAta	pos=n,g=m,c=3,n=p
nAnA	nAnA	pos=i
cezwA	cezwA	pos=n,g=m,c=3,n=p
jalada	jalada	pos=n,comp=y
lalitEH	lal	pos=va,g=m,c=3,n=p,f=part
nirviSes	nirviS	pos=v,p=2,n=s,l=vidhilin
tam	tad	pos=n,g=m,c=2,n=s
nagendram	nagendra	pos=n,g=m,c=2,n=s

# id = Megh.1.66
tasya	tad	pos=n,g=m,c=6,n=s
utsaNge	utsaNga	pos=n,g=m,c=7,n=s
praRayina	praRayin	pos=a,g=m,c=6,n=s
iva	iva	pos=i
srasta	sraMs	pos=va,comp=y,f=part
gaNgA	gaNgA	pos=n,comp=y
dukUlAm	dukUla	pos=n,g=f,c=2,n=s
na	na	pos=i
tvam	tvad	pos=n,g=,c=1,n=s
dfzwvA	dfS	pos=vi
na	na	pos=i
punaH	punar	pos=i
alakAm	alakA	pos=n,g=f,c=2,n=s
jYAsyase	jYA	pos=v,p=2,n=s,l=lrt
kAma	kAma	pos=n,comp=y
cArin	cArin	pos=a,g=m,c=8,n=s
yA	yad	pos=n,g=f,c=1,n=s
vaH	tvad	pos=n,g=,c=6,n=p
kAle	kAla	pos=n,g=m,c=7,n=s
vahati	vah	pos=v,p=3,n=s,l=lat
salila	salila	pos=n,comp=y
udgAram	udgAra	pos=n,g=m,c=2,n=s
uccEH	uccEs	pos=i
vimAnA	vimAna	pos=a,g=f,c=1,n=s
muktA	muktA	pos=n,comp=y
jAla	jAla	pos=n,comp=y
graTitam	granT	pos=va,g=m,c=2,n=s,f=part
alakam	alaka	pos=n,g=m,c=2,n=s
kAminI	kAminI	pos=n,g=f,c=1,n=s
iva	iva	pos=i
aBra	aBra	pos=n,comp=y
vfndam	vfnda	pos=n,g=n,c=2,n=s

# id = Megh.2.1
vidyutvantam	vidyutvat	pos=a,g=m,c=2,n=s
lalita	lalita	pos=a,comp=y
vanitAH	vanitA	pos=n,g=f,c=2,n=p
sa	sa	pos=i
indracApam	indracApa	pos=n,g=m,c=2,n=s
sa	sa	pos=i
citrAH	citra	pos=a,g=m,c=1,n=p
saMgItAya	saMgIta	pos=n,g=n,c=4,n=s
prahata	prahan	pos=va,comp=y,f=part
murajAH	muraja	pos=n,g=m,c=1,n=p
snigDa	snigDa	pos=a,comp=y
gamBIra	gamBIra	pos=a,comp=y
Gozam	Goza	pos=n,g=m,c=2,n=s
antaH	antar	pos=i
toyam	toya	pos=n,g=m,c=2,n=s
maRi	maRi	pos=n,comp=y
maya	maya	pos=a,comp=y
BuvaH	BU	pos=n,g=f,c=1,n=p
tuNgam	tuNga	pos=a,g=m,c=2,n=s
aBraMliha	aBraMliha	pos=a,comp=y
agrAH	agra	pos=n,g=m,c=1,n=p
prAsAdAs	prAsAda	pos=n,g=m,c=1,n=p
tvAm	tvad	pos=n,g=,c=2,n=s
tulayitum	tulay	pos=vi
alam	alam	pos=i
yatra	yatra	pos=i
tEs	tad	pos=n,g=m,c=3,n=p
tEH	tad	pos=n,g=m,c=3,n=p
viSezEH	viSeza	pos=n,g=m,c=3,n=p

# id = Megh.2.2
haste	hasta	pos=n,g=m,c=7,n=s
lIlA	lIlA	pos=n,comp=y
kamalam	kamala	pos=n,g=m,c=2,n=s
alake	alaka	pos=n,g=n,c=7,n=s
bAla	bAla	pos=a,comp=y
kunda	kunda	pos=n,comp=y
anuvidDam	anuvyaD	pos=va,g=m,c=2,n=s,f=part
nItA	nI	pos=va,g=f,c=1,n=s,f=part
loDra	loDra	pos=n,comp=y
prasava	prasava	pos=n,comp=y
rajasA	rajas	pos=n,g=n,c=3,n=s
pARqu	pARqu	pos=a,comp=y
tAm	tA	pos=n,g=f,c=2,n=s
Anane	Anana	pos=n,g=n,c=7,n=s
SrIH	SrI	pos=n,g=f,c=1,n=s
cUqA	cUqA	pos=n,comp=y
pASe	pASa	pos=n,g=m,c=7,n=s
nava	navan	pos=n,comp=y
kuravakam	kuravaka	pos=n,g=m,c=2,n=s
cAru	cAru	pos=a,g=n,c=2,n=s
karRe	karRa	pos=n,g=m,c=7,n=s
SirIzam	SirIza	pos=n,g=m,c=2,n=s
sImante	sImanta	pos=n,g=m,c=7,n=s
ca	ca	pos=i
tvad	tvad	pos=n,comp=y
upagama	upagama	pos=n,comp=y
jam	ja	pos=a,g=m,c=2,n=s
yatra	yatra	pos=i
nIpam	nIpa	pos=n,g=m,c=2,n=s
vaDUnAm	vaDU	pos=n,g=f,c=6,n=p

# id = Megh.2.3
yatra	yatra	pos=i
unmatta	unmad	pos=va,comp=y,f=part
Bramara	Bramara	pos=n,comp=y
muKarAH	muKara	pos=a,g=m,c=1,n=p
pAdapA	pAdapa	pos=n,g=m,c=1,n=p
nitya	nitya	pos=a,comp=y
puzpAH	puzpa	pos=n,g=m,c=1,n=p
haMsa	haMsa	pos=n,comp=y
SreRI	SreRi	pos=n,comp=y
racita	racay	pos=va,comp=y,f=part
raSanAH	raSanA	pos=n,g=f,c=1,n=p
nitya	nitya	pos=a,comp=y
padmAH	padma	pos=n,g=f,c=1,n=p
nalinyaH	nalinI	pos=n,g=f,c=1,n=p
kekA	kekA	pos=n,comp=y
utkaRWAH	utkaRWa	pos=a,g=m,c=1,n=p
Buvana	Buvana	pos=n,comp=y
SiKinaH	SiKin	pos=n,g=m,c=1,n=p
nitya	nitya	pos=a,comp=y
BAsvat	BAsvat	pos=a,comp=y
kalApAH	kalApa	pos=n,g=m,c=1,n=p
nitya	nitya	pos=a,comp=y
jyotsnA	jyotsnA	pos=n,g=m,c=1,n=p
prahita	prahi	pos=va,comp=y,f=part
tamaH	tamas	pos=n,comp=y
vftti	vftti	pos=n,comp=y
ramyAH	ramya	pos=a,g=m,c=1,n=p
pradozAH	pradoza	pos=n,g=m,c=1,n=p

# id = Megh.2.4
Ananda	Ananda	pos=n,comp=y
utTam	utTa	pos=a,g=n,c=1,n=s
nayana	nayana	pos=n,comp=y
salilam	salila	pos=n,g=n,c=1,n=s
yatra	yatra	pos=i
na	na	pos=i
anyEH	anya	pos=n,g=n,c=3,n=p
nimittEH	nimitta	pos=n,g=n,c=3,n=p
na	na	pos=i
anyaH	anya	pos=n,g=m,c=1,n=s
tApam	tApa	pos=n,g=m,c=2,n=s
kusuma	kusuma	pos=n,comp=y
Sara	Sara	pos=n,comp=y
jAt	ja	pos=a,g=m,c=5,n=s
izwa	iz	pos=va,comp=y,f=part
saMyoga	saMyoga	pos=n,comp=y
sADay	sADay	pos=va,g=m,c=5,n=s,f=krtya
na	na	pos=i
api	api	pos=i
anyasmAt	anya	pos=n,g=m,c=5,n=s
praRaya	praRaya	pos=n,comp=y
kalahAt	kalaha	pos=n,g=m,c=5,n=s
viprayoga	viprayoga	pos=n,comp=y
upapattiH	upapatti	pos=n,g=f,c=1,n=s
vitteSAnAm	vitteSa	pos=n,g=m,c=6,n=p
na	na	pos=i
ca	ca	pos=i
Kalu	Kalu	pos=i
vayo	vayas	pos=n,g=n,c=1,n=s
yOvanAd	yOvana	pos=n,g=n,c=5,n=s
anyad	anya	pos=n,g=n,c=1,n=s
asti	as	pos=v,p=3,n=s,l=lat

# id = Megh.2.5
yasyAm	yad	pos=n,g=f,c=7,n=s
yakzAH	yakza	pos=n,g=m,c=1,n=p
sita	sita	pos=a,comp=y
maRi	maRi	pos=n,comp=y
mayAni	maya	pos=a,g=n,c=2,n=p
etya	e	pos=vi
harmya	harmya	pos=n,comp=y
sTalAni	sTala	pos=n,g=n,c=2,n=p
jyotiH	jyotis	pos=n,comp=y
CAyA	CAyA	pos=n,comp=y
kusuma	kusuma	pos=n,comp=y
racitAni	racay	pos=va,g=n,c=2,n=p,f=part
uttama	uttama	pos=a,comp=y
strI	strI	pos=n,comp=y
sahAyAH	sahAya	pos=n,g=m,c=1,n=p
Asevante	Asev	pos=v,p=3,n=p,l=lat
maDu	maDu	pos=a,g=n,c=2,n=s
rati	rati	pos=n,comp=y
Palam	Pala	pos=n,g=n,c=2,n=s
kalpavfkza	kalpavfkza	pos=n,comp=y
prasUtam	prasU	pos=va,g=n,c=2,n=s,f=part
tvad	tvad	pos=n,comp=y
gamBIra	gamBIra	pos=a,comp=y
Dvani	Dvani	pos=n,g=m,c=7,n=p
SanakEH	SanakEs	pos=i
puzkarezv	puzkara	pos=n,g=n,c=7,n=p
Ahatezu	Ahan	pos=va,g=n,c=7,n=p,f=part

# id = Megh.2.6
mandAkinyAH	mandAkinI	pos=n,g=f,c=6,n=s
salila	salila	pos=n,comp=y
SiSirEH	SiSira	pos=a,g=m,c=3,n=p
sevyamAnA	sev	pos=va,g=f,c=1,n=p,f=part
marudBiH	marut	pos=n,g=,c=3,n=p
mandArARAm	mandAra	pos=n,g=m,c=6,n=p
anu	anu	pos=i
tawa	tawa	pos=n,comp=y
ruhAm	ruha	pos=a,g=f,c=2,n=s
CAyayA	CAyA	pos=n,g=f,c=3,n=s
vArita	vAray	pos=va,comp=y,f=part
uzRa	uzRa	pos=n,g=f,c=1,n=p
anvezwavyEH	anviz	pos=va,g=m,c=3,n=p,f=krtya
kanaka	kanaka	pos=n,comp=y
sikatA	sikatA	pos=n,comp=y
muzwi	muzwi	pos=n,comp=y
nikzepa	nikzepa	pos=n,comp=y
gUQEH	guh	pos=va,g=m,c=3,n=p,f=part
saMkrIqante	saMkrIq	pos=v,p=3,n=p,l=lat
maRiBiH	maRi	pos=n,g=m,c=3,n=p
amara	amara	pos=n,comp=y
prArTitayA	prArTay	pos=va,g=f,c=3,n=s,f=part
yatra	yatra	pos=i
kanyAH	kanyA	pos=n,g=f,c=1,n=p

# id = Megh.2.7
nIvi	nIvi	pos=n,comp=y
banDa	banDa	pos=n,comp=y
ucCvAsay	ucCvAsay	pos=va,comp=y,f=part
SiTilam	SiTila	pos=a,g=n,c=2,n=s
yatra	yatra	pos=i
biMba	bimba	pos=n,comp=y
aDarAnAm	aDara	pos=n,g=m,c=6,n=p
kzOmam	kzOma	pos=n,g=n,c=2,n=s
rAgAt	rAga	pos=n,g=m,c=5,n=s
aniBfta	aniBfta	pos=a,comp=y
karezu	kara	pos=n,g=m,c=7,n=p
Akzipatsu	Akzip	pos=va,g=m,c=7,n=p,f=part
priyezu	priya	pos=a,g=m,c=7,n=p
arcis	arcis	pos=n,comp=y
tuNgAn	tuNga	pos=a,g=m,c=2,n=p
aBimuKam	aBimuKa	pos=a,g=m,c=2,n=s
api	api	pos=i
prApya	prAp	pos=vi
ratna	ratna	pos=n,comp=y
pradIpAn	pradIpa	pos=n,g=m,c=2,n=p
hrI	hrI	pos=n,comp=y
mUQAnAm	muh	pos=va,g=m,c=6,n=p,f=part
Bavati	BU	pos=v,p=3,n=s,l=lat
viPala	viPala	pos=a,comp=y
preraRA	preraRa	pos=n,g=f,c=1,n=s
cUrRa	cUrRa	pos=n,comp=y
muzwiH	muzwi	pos=n,g=f,c=1,n=s

# id = Megh.2.8
netrA	netf	pos=n,g=m,c=3,n=s
nItAH	nI	pos=va,g=m,c=1,n=p,f=part
satatagatinA	satatagati	pos=n,g=m,c=3,n=s
yat	yat	pos=i
vimAna	vimAna	pos=n,comp=y
agra	agra	pos=n,comp=y
BUmIH	BUmi	pos=n,g=f,c=2,n=p
AleKyAnAm	AleKya	pos=n,g=n,c=6,n=p
salila	salila	pos=n,comp=y
kaRikA	kaRikA	pos=n,comp=y
dozam	doza	pos=n,g=m,c=2,n=s
utpAdya	utpAday	pos=vi
sadyaH	sadyas	pos=i
SaNkA	SaNkA	pos=n,comp=y
spfzwAH	spfS	pos=va,g=m,c=1,n=p,f=part
iva	iva	pos=i
jalamucas	jalamuc	pos=n,g=m,c=1,n=p
tvAdfSA	tvAdfSa	pos=a,g=m,c=1,n=p
jAla	jAla	pos=n,comp=y
mArgEH	mArga	pos=n,g=m,c=3,n=p
DUma	DUma	pos=n,comp=y
udgAra	udgAra	pos=n,comp=y
anukfti	anukfti	pos=n,comp=y
nipuRAH	nipuRa	pos=a,g=m,c=1,n=p
jarjarA	jarjara	pos=a,g=m,c=1,n=p
nizpatanti	nizpat	pos=v,p=3,n=p,l=lat

# id = Megh.2.9
yatra	yatra	pos=i
strIRAm	strI	pos=n,g=f,c=6,n=p
priyatama	priyatama	pos=a,comp=y
Buja	Buja	pos=n,comp=y
ucCvAsay	ucCvAsay	pos=va,comp=y,f=part
AliNgitAnAm	AliNgay	pos=va,g=f,c=6,n=p,f=part
aNga	aNga	pos=n,comp=y
glAnim	glAni	pos=n,g=f,c=2,n=s
surata	surata	pos=n,comp=y
janitAm	janay	pos=va,g=f,c=2,n=s,f=part
tantu	tantu	pos=n,comp=y
jAla	jAla	pos=n,comp=y
avalambAH	avalamba	pos=n,g=m,c=1,n=p
tvad	tvad	pos=n,comp=y
saMroDa	saMroDa	pos=n,comp=y
apagama	apagama	pos=n,comp=y
viSadEH	viSada	pos=a,g=m,c=3,n=p
candra	candra	pos=n,comp=y
pAdEH	pAda	pos=n,g=m,c=3,n=p
niSITe	niSITa	pos=n,g=m,c=7,n=s
vyAlumpanti	vyAlup	pos=v,p=3,n=p,l=lat
sPuwa	sPuwa	pos=a,comp=y
jala	jala	pos=n,comp=y
lava	lava	pos=n,comp=y
syandin	syandin	pos=a,g=m,c=1,n=p
candrakAntAH	candrakAnta	pos=n,g=m,c=1,n=p

# id = Megh.2.10
akzayya	akzayya	pos=a,comp=y
antarBavana	antarBavana	pos=n,comp=y
niDayaH	niDi	pos=n,g=m,c=1,n=p
pratyaham	pratyaham	pos=i
rakta	raYj	pos=va,comp=y,f=part
kaRWEH	kaRWa	pos=n,g=m,c=3,n=p
udgAyadBiH	udgA	pos=va,g=m,c=3,n=p,f=part
Danapati	Danapati	pos=n,comp=y
yaSaH	yaSas	pos=n,g=n,c=2,n=s
kiMnarEH	kiMnara	pos=n,g=m,c=3,n=p
yatra	yatra	pos=i
sArDam	sArDam	pos=i
vEBrAja	vEBrAja	pos=n,comp=y
AKyam	AKyA	pos=n,g=n,c=2,n=s
vibuDa	vibuDa	pos=n,comp=y
vanitA	vanitA	pos=n,comp=y
vAramuKyA	vAramuKyA	pos=n,comp=y
sahAyAH	sahAya	pos=n,g=m,c=1,n=p
badDa	banD	pos=va,comp=y,f=part
AlApAH	AlApa	pos=n,g=m,c=1,n=p
bahis	bahis	pos=i
upavanam	upavana	pos=n,g=n,c=2,n=s
kAmino	kAmin	pos=n,g=m,c=1,n=p
nirviSanti	nirviS	pos=v,p=3,n=p,l=lat

# id = Megh.2.11
gati	gati	pos=n,comp=y
utkampAt	utkampa	pos=n,g=m,c=5,n=s
alaka	alaka	pos=n,comp=y
patitEH	pat	pos=va,g=n,c=3,n=p,f=part
yatra	yatra	pos=i
mandAra	mandAra	pos=n,comp=y
puzpEH	puzpa	pos=n,g=n,c=3,n=p
putra	putra	pos=n,comp=y
CedEH	Ceda	pos=n,g=m,c=3,n=p
kanaka	kanaka	pos=n,comp=y
kamalEH	kamala	pos=n,g=n,c=3,n=p
karRa	karRa	pos=n,comp=y
visraMsin	visraMsin	pos=a,g=n,c=3,n=p
ca	ca	pos=i
muktA	muktA	pos=n,comp=y
jAlEH	jAla	pos=n,g=n,c=3,n=p
stana	stana	pos=n,comp=y
parisara	parisara	pos=n,comp=y
Cinna	Cid	pos=va,comp=y,f=part
sUtrEH	sUtra	pos=n,g=m,c=3,n=p
ca	ca	pos=i
hArEH	hAra	pos=n,g=m,c=3,n=p
nESo	nESa	pos=a,g=m,c=1,n=s
mArgaH	mArga	pos=n,g=m,c=1,n=s
savituH	savitf	pos=n,g=m,c=6,n=s
udaye	udaya	pos=n,g=m,c=7,n=s
sUcyate	sUcay	pos=v,p=3,n=s,l=lat
kAminInAm	kAminI	pos=n,g=f,c=6,n=p

# id = Megh.2.12
vAsaH	vAsas	pos=n,g=n,c=1,n=s
citram	citra	pos=a,g=n,c=1,n=s
maDu	maDu	pos=n,g=n,c=1,n=s
nayanayoH	nayana	pos=n,g=n,c=6,n=d
viBrama	viBrama	pos=n,comp=y
AdeSa	AdeSa	pos=n,comp=y
dakzam	dakza	pos=a,g=m,c=2,n=s
puzpa	puzpa	pos=n,comp=y
udBedam	udBeda	pos=n,g=m,c=2,n=s
saha	saha	pos=i
kisalayEH	kisalaya	pos=n,g=m,c=3,n=p
BUzaRAnAm	BUzaRa	pos=n,g=n,c=6,n=p
vikalpam	vikalpa	pos=n,g=m,c=2,n=s
lAkzA	lAkzA	pos=n,comp=y
rAgam	rAga	pos=n,g=m,c=2,n=s
caraRa	caraRa	pos=n,comp=y
kamala	kamala	pos=n,comp=y
nyAsa	nyAsa	pos=n,comp=y
yogyam	yogya	pos=a,g=m,c=2,n=s
ca	ca	pos=i
yasyAm	yad	pos=n,g=f,c=7,n=s
ekaH	eka	pos=n,g=m,c=1,n=s
sUte	sU	pos=v,p=3,n=s,l=lat
sakalam	sakala	pos=a,g=n,c=2,n=s
abalA	abalA	pos=n,comp=y
maRqanam	maRqana	pos=n,g=n,c=2,n=s
kalpavfkzaH	kalpavfkza	pos=n,g=m,c=1,n=s

# id = Megh.2.13
pattra	pattra	pos=n,comp=y
SyAmAH	SyAma	pos=a,g=m,c=1,n=p
dinakara	dinakara	pos=n,comp=y
haya	haya	pos=n,comp=y
sparDin	sparDin	pos=a,g=m,c=1,n=p
yatra	yatra	pos=i
vAhAH	vAha	pos=n,g=m,c=1,n=p
SEla	SEla	pos=n,comp=y
udagrAH	udagra	pos=a,g=m,c=1,n=p
tvam	tvad	pos=n,g=,c=1,n=s
iva	iva	pos=i
kariRo	karin	pos=n,g=m,c=1,n=p
vfzwimantaH	vfzwimat	pos=a,g=m,c=1,n=p
praBedAt	praBeda	pos=n,g=m,c=5,n=s
prati	prati	pos=i
daSa	daSan	pos=n,comp=y
muKam	muKa	pos=n,g=n,c=2,n=s
saMyuge	saMyuga	pos=n,g=n,c=7,n=s
tasTivAMsaH	sTA	pos=va,g=m,c=1,n=p,f=part
pratyAdiH	pratyAdiS	pos=va,comp=y,f=part
ABaraRa	ABaraRa	pos=n,comp=y
rucayaH	ruci	pos=n,g=m,c=1,n=p
candrahAsa	candrahAsa	pos=n,comp=y
vraRa	vraRa	pos=n,comp=y
aNkEH	aNka	pos=n,g=n,c=3,n=p

# id = Megh.2.14
matvA	man	pos=vi
devam	deva	pos=n,g=m,c=2,n=s
Danapati	Danapati	pos=n,comp=y
saKam	saKa	pos=n,g=m,c=2,n=s
yatra	yatra	pos=i
sAkzAd	sAkzAt	pos=i
vasantam	vasanta	pos=n,g=m,c=2,n=s
prAyaH	prAyas	pos=i
cApam	cApa	pos=n,g=m,c=2,n=s
na	na	pos=i
vahati	vah	pos=v,p=3,n=s,l=lat
BayAn	Baya	pos=n,g=n,c=5,n=s
manmaTaH	manmaTa	pos=n,g=m,c=1,n=s
zawpada	zawpada	pos=n,comp=y
jyam	jyA	pos=n,g=m,c=2,n=s
sa	sa	pos=i
BrU	BrU	pos=n,comp=y
BaNga	BaNga	pos=n,comp=y
prahita	prahi	pos=va,comp=y,f=part
nayanEH	nayana	pos=n,g=n,c=3,n=p
kAmin	kAmin	pos=n,comp=y
lakzyezu	lakzya	pos=n,g=n,c=7,n=p
amoGEs	amoGa	pos=a,g=m,c=3,n=p
tasya	tad	pos=n,g=m,c=6,n=s
AramBaH	AramBa	pos=n,g=m,c=1,n=s
catura	catura	pos=a,comp=y
vanitA	vanitA	pos=n,comp=y
viBramEH	viBrama	pos=n,g=m,c=3,n=p
eva	eva	pos=i
sidDaH	siD	pos=va,g=m,c=1,n=s,f=part

# id = Megh.2.15
tatra	tatra	pos=i
AgAram	AgAra	pos=n,g=n,c=1,n=s
Danapati	Danapati	pos=n,comp=y
gfhAn	gfha	pos=n,g=m,c=2,n=p
uttareRa	uttareRa	pos=i
asmadIyam	asmadIya	pos=a,g=n,c=1,n=s
dUrAl	dUrAt	pos=i
lakzyam	lakzay	pos=va,g=n,c=1,n=s,f=krtya
surapati	surapati	pos=n,comp=y
DanuH	Danus	pos=n,comp=y
cAru	cAru	pos=a,g=n,c=3,n=s
toraRena	toraRa	pos=n,g=n,c=3,n=s
yasya	yad	pos=n,g=n,c=6,n=s
upAnte	upAnta	pos=n,g=n,c=7,n=s
kftaka	kftaka	pos=a,comp=y
tanayaH	tanaya	pos=n,g=m,c=1,n=s
kAntayA	kAntA	pos=n,g=f,c=3,n=s
varDito	varDay	pos=va,g=m,c=1,n=s,f=part
me	mad	pos=n,g=,c=6,n=s
hasta	hasta	pos=n,comp=y
prApya	prAp	pos=va,comp=y,f=krtya
stabaka	stabaka	pos=n,comp=y
namitaH	namay	pos=va,g=m,c=1,n=s,f=part
bAla	bAla	pos=a,comp=y
mandAra	mandAra	pos=n,comp=y
vfkzaH	vfkza	pos=n,g=m,c=1,n=s

# id = Megh.2.16
vApI	vApI	pos=n,g=f,c=1,n=s
ca	ca	pos=i
asmin	idam	pos=n,g=n,c=7,n=s
marakata	marakata	pos=n,comp=y
SilA	SilA	pos=n,comp=y
badDa	banD	pos=va,comp=y,f=part
sopAna	sopAna	pos=n,comp=y
mArgA	mArga	pos=n,g=f,c=1,n=s
hEmEH	hEma	pos=a,g=n,c=3,n=p
CannA	Cad	pos=va,g=f,c=1,n=s,f=part
vikaca	vikaca	pos=a,comp=y
kamalEH	kamala	pos=n,g=n,c=3,n=p
snigDa	snigDa	pos=a,comp=y
vEqUrya	vEqUrya	pos=n,comp=y
nAlEH	nAla	pos=n,g=n,c=3,n=p
yasyAs	yad	pos=n,g=f,c=6,n=s
toye	toya	pos=n,g=n,c=7,n=s
kfta	kf	pos=va,comp=y,f=part
vasati	vasati	pos=n,g=m,c=1,n=p
mAnasam	mAnasa	pos=n,g=n,c=2,n=s
saMnikfzwam	saMnikfzwa	pos=a,g=n,c=2,n=s
na	na	pos=i
ADyAsyanti	ADyA	pos=v,p=3,n=p,l=lrt
vyapagata	vyapagam	pos=va,comp=y,f=part
Suc	Suc	pos=n,g=m,c=1,n=p
tvAm	tvad	pos=n,g=,c=2,n=s
api	api	pos=i
prekzya	prekz	pos=vi
haMsAH	haMsa	pos=n,g=m,c=1,n=p

# id = Megh.2.17
tasyAs	tad	pos=n,g=f,c=6,n=s
tIre	tIra	pos=n,g=n,c=7,n=s
racita	racay	pos=va,comp=y,f=part
SiKaraH	SiKara	pos=n,g=m,c=1,n=s
peSalEH	peSala	pos=a,g=m,c=3,n=p
indranIlEH	indranIla	pos=n,g=m,c=3,n=p
krIqA	krIqA	pos=n,comp=y
SElaH	SEla	pos=n,g=m,c=1,n=s
kanakakadalI	kanakakadalI	pos=n,comp=y
vezwana	vezwana	pos=n,comp=y
prekz	prekz	pos=va,g=m,c=1,n=s,f=krtya
mad	mad	pos=n,comp=y
gehinyAH	gehinI	pos=n,g=f,c=6,n=s
priya	priya	pos=a,g=m,c=1,n=s
iti	iti	pos=i
saKe	saKI	pos=n,g=f,c=8,n=s
cetasA	cetas	pos=n,g=n,c=3,n=s
kAtareRa	kAtara	pos=a,g=n,c=3,n=s
prekzya	prekz	pos=vi
upAnta	upAnta	pos=n,comp=y
sPurita	sPur	pos=va,comp=y,f=part
taqit	taqit	pos=n,g=m,c=2,n=s
tvAm	tvad	pos=n,g=,c=2,n=s
tam	tad	pos=n,g=m,c=2,n=s
eva	eva	pos=i
smarAmi	smf	pos=v,p=1,n=s,l=lat

# id = Megh.2.18
rakta	rakta	pos=a,comp=y
aSokaH	aSoka	pos=n,g=m,c=1,n=s
cala	cala	pos=a,comp=y
kisalayaH	kisalaya	pos=n,g=m,c=1,n=s
kesaraH	kesara	pos=n,g=m,c=1,n=s
ca	ca	pos=i
atra	atra	pos=i
kAntaH	kAnta	pos=a,g=m,c=1,n=s
pratyAsannO	pratyAsad	pos=va,g=m,c=1,n=d,f=part
kuravaka	kuravaka	pos=n,comp=y
vfti	vfti	pos=n,g=m,c=6,n=s
mADavI	mADavI	pos=n,comp=y
maRqapasya	maRqapa	pos=n,g=m,c=6,n=s
ekaH	eka	pos=n,g=m,c=1,n=s
saKyAs	saKI	pos=n,g=f,c=6,n=s
tava	tvad	pos=n,g=,c=6,n=s
saha	saha	pos=i
mayA	mad	pos=n,g=,c=3,n=s
vAma	vAma	pos=a,comp=y
pAda	pAda	pos=n,comp=y
aBilAzI	aBilAzin	pos=a,g=m,c=1,n=s
kANkzaty	kANkz	pos=v,p=3,n=s,l=lat
anyo	anya	pos=n,g=m,c=1,n=s
vadana	vadana	pos=n,comp=y
madirAm	madirA	pos=n,g=f,c=2,n=s
dohada	dohada	pos=n,comp=y
CadmanA	Cadman	pos=n,g=n,c=3,n=s
asyAH	idam	pos=n,g=f,c=6,n=s

# id = Megh.2.19
tad	tad	pos=n,comp=y
maDye	maDye	pos=i
ca	ca	pos=i
sPawika	sPawika	pos=n,comp=y
PalakA	Palaka	pos=n,g=f,c=1,n=s
kAYcanI	kAYcana	pos=a,g=f,c=1,n=s
vAsayazwiH	vAsayazwi	pos=n,g=f,c=1,n=s
mUle	mUla	pos=n,g=n,c=7,n=s
badDA	banD	pos=va,g=f,c=1,n=s,f=part
maRiBiH	maRi	pos=n,g=m,c=3,n=p
anatiprOQa	anatiprOQa	pos=a,comp=y
vaMSa	vaMSa	pos=n,comp=y
prakASEH	prakASa	pos=n,g=m,c=3,n=p
tAlEH	tAla	pos=n,g=m,c=3,n=p
SiYjA	SiYjA	pos=n,comp=y
valaya	valaya	pos=n,comp=y
suBagEH	suBaga	pos=a,g=m,c=3,n=p
nartitaH	nartay	pos=va,g=m,c=1,n=s,f=part
kAntayA	kAntA	pos=n,g=f,c=3,n=s
me	mad	pos=n,g=,c=6,n=s
yAm	yad	pos=n,g=f,c=2,n=s
aDyAste	aDyAs	pos=v,p=3,n=s,l=lat
divasa	divasa	pos=n,comp=y
vigame	vigama	pos=n,g=m,c=7,n=s
nIlakaRWaH	nIlakaRWa	pos=n,g=m,c=1,n=s
suhfd	suhfd	pos=n,g=m,c=1,n=s
vaH	tvad	pos=n,g=,c=6,n=p

# id = Megh.2.20
eBiH	idam	pos=n,g=n,c=3,n=p
sADo	sADu	pos=a,g=m,c=8,n=s
hfdaya	hfdaya	pos=n,comp=y
nihitEH	niDA	pos=va,g=n,c=3,n=p,f=part
lakzaREH	lakzaRa	pos=n,g=n,c=3,n=p
lakzayeTA	lakzay	pos=v,p=2,n=s,l=vidhilin
dvAra	dvAra	pos=n,comp=y
upAnte	upAnta	pos=n,g=n,c=7,n=s
liKita	liK	pos=va,comp=y,f=part
vapuzO	vapuza	pos=a,g=m,c=2,n=d
SaNKa	SaNKa	pos=n,comp=y
padmO	padma	pos=n,g=m,c=2,n=d
ca	ca	pos=i
dfzwvA	dfS	pos=vi
kzAma	kzAma	pos=a,comp=y
CAyam	CAyA	pos=n,g=n,c=1,n=s
Bavanam	Bavana	pos=n,g=n,c=1,n=s
aDunA	aDunA	pos=i
mad	mad	pos=n,comp=y
viyogena	viyoga	pos=n,g=m,c=3,n=s
nUnam	nUnam	pos=i
sUrya	sUrya	pos=n,comp=y
apAye	apAya	pos=n,g=m,c=7,n=s
na	na	pos=i
Kalu	Kalu	pos=i
kamalam	kamala	pos=n,g=n,c=1,n=s
puzyati	puz	pos=v,p=3,n=s,l=lat
svAm	sva	pos=a,g=f,c=2,n=s
aBiKyAm	aBiKyA	pos=n,g=f,c=2,n=s

# id = Megh.2.21
gatvA	gam	pos=vi
sadyaH	sadyas	pos=i
kalaBa	kalaBa	pos=n,comp=y
tanu	tanu	pos=n,comp=y
tAm	tA	pos=n,g=f,c=2,n=s
SIGra	SIGra	pos=a,comp=y
sampAta	sampAta	pos=n,comp=y
hetoH	hetu	pos=n,g=m,c=5,n=s
krIqA	krIqA	pos=n,comp=y
SEle	SEla	pos=n,g=m,c=7,n=s
praTama	praTama	pos=a,comp=y
kaTite	kaTay	pos=va,g=m,c=7,n=s,f=part
ramya	ramya	pos=a,comp=y
sAnO	sAnu	pos=n,g=m,c=7,n=s
nizaRRaH	nizad	pos=va,g=m,c=1,n=s,f=part
arhasy	arh	pos=v,p=2,n=s,l=lat
antaH	antar	pos=i
Bavana	Bavana	pos=n,comp=y
patitAm	pat	pos=va,g=f,c=2,n=s,f=part
kartum	kf	pos=vi
alpa	alpa	pos=a,comp=y
alpa	alpa	pos=a,comp=y
BAs	BAs	pos=n,g=f,c=2,n=s
Kadyota	Kadyota	pos=n,comp=y
AlI	Ali	pos=n,comp=y
vilasita	vilasita	pos=n,comp=y
niBAm	niBa	pos=a,g=f,c=2,n=s
vidyut	vidyut	pos=n,comp=y
unmeza	unmeza	pos=n,comp=y
dfzwim	dfzwi	pos=n,g=f,c=2,n=s

# id = Megh.2.22
tanvI	tanvI	pos=n,g=f,c=1,n=s
SyAmA	SyAma	pos=a,g=f,c=1,n=s
SiKarin	SiKarin	pos=a,comp=y
daSanA	daSana	pos=n,g=f,c=1,n=s
pakva	pakva	pos=a,comp=y
bimba	bimba	pos=n,comp=y
aDara	aDara	pos=n,comp=y
ozWI	ozWI	pos=n,g=f,c=1,n=s
maDye	maDya	pos=n,g=n,c=7,n=s
kzAmA	kzAma	pos=a,g=f,c=1,n=s
cak	cak	pos=va,comp=y,f=part
hariRI	hariRI	pos=n,comp=y
prekzaRA	prekzaRa	pos=n,g=f,c=1,n=s
nimna	nimna	pos=a,comp=y
nABiH	nABi	pos=n,g=f,c=1,n=s
SroRI	SroRI	pos=n,comp=y
BArAt	BAra	pos=n,g=m,c=5,n=s
alasa	alasa	pos=a,comp=y
gamanA	gamana	pos=n,g=f,c=1,n=s
stoka	stoka	pos=a,comp=y
namrA	namra	pos=a,g=f,c=1,n=s
stanAByAm	stana	pos=n,g=m,c=3,n=d
yA	yad	pos=n,g=f,c=1,n=s
tatra	tatra	pos=i
syAd	as	pos=v,p=3,n=s,l=vidhilin
yuvatI	yuvatI	pos=n,comp=y
vizaye	vizaya	pos=n,g=m,c=7,n=s
sfzwiH	sfzwi	pos=n,g=f,c=1,n=s
AdyA	Adya	pos=a,g=f,c=1,n=s
eva	eva	pos=i
DAtuH	DAtf	pos=n,g=m,c=6,n=s

# id = Megh.2.23
tAm	tad	pos=n,g=f,c=2,n=s
jAnITAH	jYA	pos=v,p=2,n=s,l=vidhilin
parimita	parimA	pos=va,comp=y,f=part
kaTAm	kaTA	pos=n,g=f,c=2,n=s
jIvitam	jIvita	pos=n,g=n,c=2,n=s
me	mad	pos=n,g=,c=6,n=s
dvitIyam	dvitIya	pos=a,g=n,c=2,n=s
dUrIBUte	dUrIBU	pos=va,g=m,c=7,n=s,f=part
mayi	mad	pos=n,g=,c=7,n=s
sahacare	sahacara	pos=n,g=m,c=7,n=s
cakravAkIm	cakravAkI	pos=n,g=f,c=2,n=s
iva	iva	pos=i
ekAm	eka	pos=n,g=f,c=2,n=s
gAQa	gAQa	pos=a,comp=y
utkaRWAm	utkaRWA	pos=n,g=f,c=2,n=s
guruzu	guru	pos=a,g=m,c=7,n=p
divasezv	divasa	pos=n,g=m,c=7,n=p
ezu	idam	pos=n,g=m,c=7,n=p
gacCatsu	gam	pos=va,g=m,c=7,n=p,f=part
bAlAm	bAla	pos=a,g=f,c=2,n=s
jAtAm	jan	pos=va,g=f,c=2,n=s,f=part
manye	man	pos=v,p=1,n=s,l=lat
SiSira	SiSira	pos=n,comp=y
maTitAm	maT	pos=va,g=f,c=2,n=s,f=part
padminIm	padminI	pos=n,g=f,c=2,n=s
vA	vA	pos=i
anya	anya	pos=n,comp=y
rUpAm	rUpa	pos=n,g=f,c=2,n=s

# id = Megh.2.24
nUnam	nUnam	pos=i
tasyAH	tad	pos=n,g=f,c=6,n=s
prabala	prabala	pos=a,comp=y
rudita	rudita	pos=n,comp=y
ucCvi	ucCvi	pos=va,comp=y,f=part
netram	netra	pos=n,g=n,c=1,n=s
priyAyA	priya	pos=a,g=f,c=6,n=s
niHSvAsAnAm	niHSvAsa	pos=n,g=m,c=6,n=p
aSiSira	aSiSira	pos=a,comp=y
tayA	tA	pos=n,g=f,c=3,n=s
BinnavarRa	BinnavarRa	pos=a,comp=y
aDara	aDara	pos=n,comp=y
uzWam	uzWa	pos=n,g=n,c=1,n=s
hasta	hasta	pos=n,comp=y
nyastam	nyas	pos=va,g=n,c=1,n=s,f=part
muKam	muKa	pos=n,g=n,c=1,n=s
asakala	asakala	pos=a,comp=y
vyakti	vyakti	pos=n,g=n,c=1,n=s
lamba	lamba	pos=a,comp=y
alaka	alaka	pos=n,comp=y
tvAt	tva	pos=n,g=n,c=5,n=s
indoH	indu	pos=n,g=m,c=6,n=s
dEnyam	dEnya	pos=n,g=n,c=2,n=s
tvad	tvad	pos=n,comp=y
anusaraRa	anusaraRa	pos=n,comp=y
klizwa	kliS	pos=va,comp=y,f=part
kAnti	kAnti	pos=n,g=m,c=6,n=s
biBarti	Bf	pos=v,p=3,n=s,l=lat

# id = Megh.2.25
Aloke	Aloka	pos=n,g=m,c=7,n=s
te	tvad	pos=n,g=,c=6,n=s
nipatati	nipat	pos=v,p=3,n=s,l=lat
purA	purA	pos=i
sA	tad	pos=n,g=f,c=1,n=s
bali	bali	pos=n,comp=y
vyAkulA	vyAkula	pos=a,g=f,c=1,n=s
vA	vA	pos=i
mad	mad	pos=n,comp=y
sAdfSyam	sAdfSya	pos=n,g=n,c=2,n=s
viraha	viraha	pos=n,comp=y
tanu	tanu	pos=a,g=n,c=2,n=s
vA	vA	pos=i
BAva	BAva	pos=n,comp=y
gamanIyam	gam	pos=va,g=n,c=2,n=s,f=krtya
liKantI	liK	pos=va,g=f,c=1,n=s,f=part
pfcCantI	pracC	pos=va,g=f,c=1,n=s,f=part
vA	vA	pos=i
maDura	maDura	pos=a,comp=y
vacanAm	vacana	pos=n,g=f,c=2,n=s
sArikAm	sArikA	pos=n,g=f,c=2,n=s
paYjara	paYjara	pos=n,comp=y
sTAm	sTa	pos=a,g=f,c=2,n=s
kaccid	kaccit	pos=i
BartuH	Bartf	pos=n,g=m,c=6,n=s
smarasi	smf	pos=v,p=2,n=s,l=lat
rasike	rasika	pos=a,g=f,c=8,n=s
tvam	tvad	pos=n,g=,c=1,n=s
hi	hi	pos=i
tasya	tad	pos=n,g=m,c=6,n=s
priyA	priya	pos=a,g=f,c=1,n=s
iti	iti	pos=i

# id = Megh.2.26
utsaNge	utsaNga	pos=n,g=m,c=7,n=s
vA	vA	pos=i
malina	malina	pos=a,comp=y
vasane	vasana	pos=n,g=m,c=7,n=s
sOmya	sOmya	pos=a,g=m,c=8,n=s
nikzipya	nikzip	pos=vi
vIRAm	vIRA	pos=n,g=f,c=2,n=s
mad	mad	pos=n,comp=y
gotra	gotra	pos=n,comp=y
aNkam	aNka	pos=n,g=n,c=2,n=s
viracita	viracay	pos=va,comp=y,f=part
padam	pada	pos=n,g=n,c=2,n=s
geyam	geya	pos=n,g=n,c=2,n=s
udgAtu	udgAtu	pos=n,comp=y
kAmA	kAma	pos=n,g=f,c=1,n=s
tantrIm	tantrI	pos=n,g=f,c=2,n=s
ArdrAm	Ardra	pos=a,g=f,c=2,n=s
nayana	nayana	pos=n,comp=y
salilEH	salila	pos=n,g=n,c=3,n=p
sArayitvA	sAray	pos=vi
kaTaMcid	kaTaMcid	pos=i
BUyo	BUyas	pos=i
BUyaH	BUyas	pos=i
svayam	svayam	pos=i
api	api	pos=i
kftAm	kf	pos=va,g=f,c=2,n=s,f=part
mUrcCanAm	mUrCana	pos=n,g=f,c=2,n=s
vismarantI	vismf	pos=va,g=f,c=1,n=s,f=part

# id = Megh.2.27
SezAn	Seza	pos=a,g=m,c=2,n=p
mAsAn	mAsa	pos=n,g=m,c=2,n=p
viraha	viraha	pos=n,comp=y
divasa	divasa	pos=n,comp=y
sTApitasya	sTApay	pos=va,g=m,c=6,n=s,f=part
avaDi	avaDi	pos=n,g=m,c=6,n=s
vA	vA	pos=i
vinyasyantI	vinyas	pos=va,g=f,c=1,n=s,f=part
Buvi	BU	pos=n,g=f,c=7,n=s
gaRanayA	gaRanA	pos=n,g=f,c=3,n=s
dehalI	dehalI	pos=n,comp=y
datta	dA	pos=va,comp=y,f=part
puzpEH	puzpa	pos=n,g=n,c=3,n=p
samBogam	samBoga	pos=n,g=m,c=2,n=s
vA	vA	pos=i
hfdaya	hfdaya	pos=n,comp=y
nihita	niDA	pos=va,comp=y,f=part
AramBam	AramBa	pos=n,g=m,c=2,n=s
AsvAdayantI	AsvAday	pos=va,g=f,c=1,n=s,f=part
prAyeRa	prAyeRa	pos=i
ete	etad	pos=n,g=m,c=1,n=p
ramaRa	ramaRa	pos=n,comp=y
virahezu	viraha	pos=n,g=m,c=7,n=p
aNganAnAm	aNganA	pos=n,g=f,c=6,n=p
vinodAH	vinoda	pos=n,g=m,c=1,n=p

# id = Megh.2.28
sa	sa	pos=i
vyApArAm	vyApAra	pos=n,g=f,c=2,n=s
ahani	ahar	pos=n,g=n,c=7,n=s
na	na	pos=i
taTA	taTA	pos=i
pIqayed	pIqay	pos=v,p=3,n=s,l=vidhilin
viprayogaH	viprayoga	pos=n,g=m,c=1,n=s
SaNke	SaNk	pos=v,p=1,n=s,l=lat
rAtrO	rAtri	pos=n,g=f,c=7,n=s
gurutara	gurutara	pos=a,comp=y
Sucam	Suc	pos=n,g=f,c=2,n=s
nirvinodAm	nirvinoda	pos=a,g=f,c=2,n=s
saKIm	saKI	pos=n,g=f,c=2,n=s
te	tvad	pos=n,g=,c=6,n=s
mad	mad	pos=n,comp=y
saMdeSEH	saMdeSa	pos=n,g=m,c=3,n=p
suKayitum	suKay	pos=vi
alam	alam	pos=i
paSya	paS	pos=v,p=2,n=s,l=lot
sADvIm	sADu	pos=a,g=f,c=2,n=s
niSITe	niSITa	pos=n,g=m,c=7,n=s
tAm	tad	pos=n,g=f,c=2,n=s
unnidrAm	unnidra	pos=a,g=f,c=2,n=s
avani	avani	pos=n,comp=y
SayanAm	Sayana	pos=n,g=f,c=2,n=s
sODa	sODa	pos=n,comp=y
vAtAyana	vAtAyana	pos=n,comp=y
sTaH	sTa	pos=a,g=m,c=1,n=s

# id = Megh.2.29
ADi	ADi	pos=n,comp=y
kzAmAm	kzAma	pos=a,g=f,c=2,n=s
viraha	viraha	pos=n,comp=y
Sayane	Sayana	pos=n,g=n,c=7,n=s
saMnizad	saMnizad	pos=va,comp=y,f=part
eka	eka	pos=n,comp=y
pArSvAm	pArSva	pos=n,g=f,c=2,n=s
prAcImUle	prAcImUla	pos=n,g=n,c=7,n=s
tanum	tanu	pos=n,g=f,c=2,n=s
iva	iva	pos=i
kalA	kalA	pos=n,comp=y
mAtra	mAtra	pos=n,comp=y
SezAm	Seza	pos=n,g=f,c=2,n=s
himAMSoH	himAMSu	pos=n,g=m,c=6,n=s
nItA	nI	pos=va,g=f,c=1,n=s,f=part
rAtriH	rAtri	pos=n,g=f,c=1,n=s
kzaRa	kzaRa	pos=n,g=m,c=1,n=s
iva	iva	pos=i
mayA	mad	pos=n,g=,c=3,n=s
sArDam	sArDam	pos=i
icCA	icCA	pos=n,comp=y
ratEH	rata	pos=n,g=n,c=3,n=p
yA	yad	pos=n,g=f,c=1,n=s
tAm	tad	pos=n,g=f,c=2,n=s
eva	eva	pos=i
uzREH	uzRa	pos=a,g=n,c=3,n=p
viraha	viraha	pos=n,comp=y
mahatIm	mahat	pos=a,g=f,c=2,n=s
aSruBiH	aSru	pos=n,g=n,c=3,n=p
yApayantIm	yApay	pos=va,g=f,c=2,n=s,f=part

# id = Megh.2.30
pAdAn	pAda	pos=n,g=m,c=2,n=p
indoH	indu	pos=n,g=m,c=6,n=s
amfta	amfta	pos=n,comp=y
SiSirAn	SiSira	pos=a,g=m,c=2,n=p
jala	jala	pos=n,comp=y
mArga	mArga	pos=n,comp=y
pravizwAn	praviS	pos=va,g=m,c=2,n=p,f=part
pUrva	pUrva	pos=n,comp=y
prItyA	prIti	pos=n,g=f,c=3,n=s
gatam	gam	pos=va,g=m,c=2,n=s,f=part
aBimuKam	aBimuKa	pos=a,g=m,c=2,n=s
saMnivfttam	saMnivft	pos=va,g=m,c=2,n=s,f=part
taTA	taTA	pos=i
eva	eva	pos=i
cakzuH	cakzus	pos=n,g=n,c=2,n=s
KedAt	Keda	pos=n,g=m,c=5,n=s
salila	salila	pos=n,comp=y
guruBiH	guru	pos=a,g=n,c=3,n=p
pakzman	pakzman	pos=n,g=n,c=3,n=p
CAday	CAday	pos=va,g=f,c=2,n=s,f=part
sa	sa	pos=i
aBre	aBra	pos=n,g=n,c=7,n=s
ahani	ahar	pos=n,g=n,c=7,n=s
iva	iva	pos=i
sTala	sTala	pos=n,comp=y
kamalinI	kamalinI	pos=n,g=f,c=1,n=s
na	na	pos=i
prabudDAm	prabuD	pos=va,g=f,c=2,n=s,f=part
na	na	pos=i
suptAm	svap	pos=va,g=f,c=2,n=s,f=part

# id = Megh.2.31
niHSvAsena	niHSvAsa	pos=n,g=m,c=3,n=s
aDara	aDara	pos=n,comp=y
kisalaya	kisalaya	pos=n,comp=y
kleSinA	kleSin	pos=a,g=m,c=3,n=s
vikzipantIm	vikzip	pos=va,g=f,c=2,n=s,f=part
SudDa	SudDa	pos=a,comp=y
snAnAt	snAna	pos=n,g=n,c=5,n=s
paruzam	paruza	pos=a,g=m,c=2,n=s
alakam	alaka	pos=n,g=m,c=2,n=s
nUnam	nUnam	pos=i
AgaRqa	AgaRqa	pos=i
lambam	lamba	pos=a,g=m,c=2,n=s
mad	mad	pos=n,comp=y
samBogaH	samBoga	pos=n,g=m,c=1,n=s
kaTam	kaTam	pos=i
upanamet	upanam	pos=v,p=3,n=s,l=vidhilin
svapna	svapna	pos=n,comp=y
jaH	ja	pos=a,g=m,c=1,n=s
api	api	pos=i
iti	iti	pos=i
nidrAm	nidrA	pos=n,g=f,c=2,n=s
AkANkzantIm	AkANkz	pos=va,g=f,c=2,n=s,f=part
nayana	nayana	pos=n,comp=y
salila	salila	pos=n,comp=y
utpIqa	utpIqa	pos=n,comp=y
rudDa	ruD	pos=va,comp=y,f=part
avakASam	avakASa	pos=n,g=m,c=2,n=s

# id = Megh.2.32
Adye	Adya	pos=a,g=m,c=7,n=s
badDA	banD	pos=va,g=f,c=1,n=s,f=part
viraha	viraha	pos=n,comp=y
divase	divasa	pos=n,g=m,c=7,n=s
yA	yad	pos=n,g=f,c=1,n=s
SiKA	SiKA	pos=n,g=f,c=1,n=s
dAma	dAman	pos=n,g=n,c=2,n=s
hitvA	hA	pos=vi
SApasya	SApa	pos=n,g=m,c=6,n=s
ante	anta	pos=n,g=m,c=7,n=s
vigalita	vigal	pos=va,comp=y,f=part
Suc	Suc	pos=n,g=m,c=3,n=s
tAm	tad	pos=n,g=f,c=2,n=s
mayA	mad	pos=n,g=,c=3,n=s
udvezw	udvezw	pos=va,g=f,c=2,n=s,f=krtya
sparSa	sparSa	pos=n,comp=y
klizwAm	kliS	pos=va,g=f,c=2,n=s,f=part
ayamita	ayamita	pos=a,comp=y
naKena	naKa	pos=n,g=m,c=3,n=s
asakft	asakft	pos=i
sAray	sAray	pos=va,g=f,c=2,n=s,f=part
gaRqa	gaRqa	pos=n,comp=y
ABogAt	ABoga	pos=n,g=m,c=5,n=s
kaWina	kaWina	pos=a,comp=y
vizamAm	vizama	pos=a,g=f,c=2,n=s
eka	eka	pos=n,comp=y
veRIm	veRI	pos=n,g=f,c=2,n=s
kareRa	kara	pos=n,g=m,c=3,n=s

# id = Megh.2.33
sA	tad	pos=n,g=f,c=1,n=s
saMnyasta	saMnyas	pos=va,comp=y,f=part
ABaraRam	ABaraRa	pos=n,g=n,c=2,n=s
abalA	abalA	pos=n,g=f,c=1,n=s
peSalam	peSala	pos=a,g=n,c=2,n=s
DArayantI	DAray	pos=va,g=f,c=1,n=s,f=part
SayyA	SayyA	pos=n,comp=y
utsaNge	utsaNga	pos=n,g=m,c=7,n=s
nihitam	niDA	pos=va,g=n,c=2,n=s,f=part
asakfd	asakft	pos=i
duHKa	duHKa	pos=n,comp=y
duHKena	duHKa	pos=n,g=n,c=3,n=s
gAtram	gAtra	pos=n,g=n,c=2,n=s
tvAm	tvad	pos=n,g=,c=2,n=s
apy	api	pos=i
asram	asra	pos=n,g=n,c=2,n=s
nava	nava	pos=a,comp=y
jala	jala	pos=n,comp=y
mayam	maya	pos=a,g=n,c=2,n=s
mocayizyaty	mocay	pos=v,p=3,n=s,l=lrt
avaSyam	avaSyam	pos=i
prAyaH	prAyas	pos=i
sarvo	sarva	pos=n,g=m,c=1,n=s
Bavati	BU	pos=v,p=3,n=s,l=lat
karuRA	karuRA	pos=n,comp=y
vfttiH	vftti	pos=n,g=m,c=1,n=s
Ardra	Ardra	pos=a,comp=y
antarAtmA	antarAtman	pos=n,g=m,c=1,n=s

# id = Megh.2.34
jAne	jYA	pos=v,p=1,n=s,l=lat
saKyAs	saKI	pos=n,g=f,c=6,n=s
tava	tvad	pos=n,g=,c=6,n=s
mayi	mad	pos=n,g=,c=7,n=s
manaH	manas	pos=n,g=n,c=2,n=s
saMBfta	samBf	pos=va,comp=y,f=part
sneham	sneha	pos=n,g=n,c=2,n=s
asmAt	idam	pos=n,g=n,c=5,n=s
itTaMBUtAm	itTaMBUta	pos=a,g=f,c=2,n=s
praTama	praTama	pos=a,comp=y
virahe	viraha	pos=n,g=m,c=7,n=s
tAm	tad	pos=n,g=f,c=2,n=s
aham	mad	pos=n,g=,c=1,n=s
tarkayAmi	tarkay	pos=v,p=1,n=s,l=lat
vAcAlam	vAcAla	pos=a,g=m,c=2,n=s
mAm	mad	pos=n,g=,c=2,n=s
na	na	pos=i
Kalu	Kalu	pos=i
suBagaMmanya	suBagaMmanya	pos=a,comp=y
BAvaH	BAva	pos=n,g=m,c=1,n=s
karoti	kf	pos=v,p=3,n=s,l=lat
pratyakzam	pratyakza	pos=a,g=n,c=2,n=s
te	tvad	pos=n,g=,c=6,n=s
niKilam	niKila	pos=a,g=n,c=1,n=s
acirAd	acirAt	pos=i
BrAtaH	BrAtf	pos=n,g=m,c=8,n=s
uktam	vac	pos=va,g=n,c=1,n=s,f=part
mayA	mad	pos=n,g=,c=3,n=s
yat	yad	pos=n,g=n,c=1,n=s

# id = Megh.2.35
rudDa	ruD	pos=va,comp=y,f=part
apANga	apANga	pos=n,comp=y
prasaram	prasara	pos=n,g=n,c=1,n=s
alakEH	alaka	pos=n,g=m,c=3,n=p
aYjana	aYjana	pos=n,comp=y
sneha	sneha	pos=n,comp=y
SUnyam	SUnya	pos=a,g=n,c=1,n=s
pratyAdeSAd	pratyAdeSa	pos=n,g=m,c=5,n=s
api	api	pos=i
ca	ca	pos=i
maDuno	maDu	pos=n,g=n,c=6,n=s
vismfta	vismf	pos=va,comp=y,f=part
BrU	BrU	pos=n,comp=y
vilAsam	vilAsa	pos=n,g=n,c=1,n=s
tvayy	tvad	pos=n,g=,c=7,n=s
Asanne	Asad	pos=va,g=m,c=7,n=s,f=part
nayanam	nayana	pos=n,g=n,c=1,n=s
upari	upari	pos=i
spandin	spandin	pos=a,g=n,c=1,n=s
SaNke	SaNk	pos=v,p=1,n=s,l=lat
mfga	mfga	pos=n,comp=y
akzAyAH	akza	pos=a,g=f,c=6,n=s
mIna	mIna	pos=n,comp=y
kzoBAt	kzoBa	pos=n,g=m,c=5,n=s
cala	cala	pos=a,comp=y
kuvalaya	kuvalaya	pos=n,comp=y
SrI	SrI	pos=n,comp=y
tulAm	tulA	pos=n,g=f,c=2,n=s
ezyati	i	pos=v,p=3,n=s,l=lrt
iti	iti	pos=i

# id = Megh.2.36
vAmaH	vAma	pos=a,g=m,c=1,n=s
ca	ca	pos=i
asyAH	idam	pos=n,g=f,c=6,n=s
kararuha	kararuha	pos=n,comp=y
padEH	pada	pos=n,g=n,c=3,n=p
mucyamAno	muc	pos=va,g=m,c=1,n=s,f=part
madIyEH	madIya	pos=a,g=n,c=3,n=p
muktA	muktA	pos=n,comp=y
jAlam	jAla	pos=n,g=n,c=2,n=s
cira	cira	pos=a,comp=y
paricitam	parici	pos=va,g=n,c=2,n=s,f=part
tyAjito	tyAjay	pos=va,g=m,c=1,n=s,f=part
dEva	dEva	pos=n,comp=y
gatyA	gati	pos=n,g=f,c=3,n=s
saMBoga	samBoga	pos=n,comp=y
ante	anta	pos=n,g=m,c=7,n=s
mama	mad	pos=n,g=,c=6,n=s
samucito	samucita	pos=a,g=m,c=1,n=s
hastasaMvAhamAnAm	yA	pos=v,p=3,n=s,l=lrt
yAsyaty	Uru	pos=n,g=m,c=1,n=s
sarasa	sarasa	pos=a,comp=y
kadalI	kadala	pos=n,comp=y
stamBa	stamBa	pos=n,comp=y
gOraH	gOra	pos=a,g=m,c=1,n=s
cala	cala	pos=a,comp=y
tvam	tva	pos=n,g=n,c=2,n=s

# id = Megh.2.37
tasmin	tad	pos=n,g=m,c=7,n=s
kAle	kAla	pos=n,g=m,c=7,n=s
jalada	jalada	pos=n,g=m,c=8,n=s
yadi	yadi	pos=i
sA	tad	pos=n,g=f,c=1,n=s
labDa	laB	pos=va,comp=y,f=part
nidrA	nidrA	pos=n,comp=y
suKA	suKa	pos=n,g=f,c=1,n=s
syAd	as	pos=v,p=3,n=s,l=vidhilin
anvAsya	anvAs	pos=vi
enAm	enad	pos=n,g=f,c=2,n=s
stanita	stanita	pos=n,comp=y
vimuKaH	vimuKa	pos=a,g=m,c=1,n=s
yAma	yAma	pos=n,comp=y
mAtram	mAtra	pos=n,g=n,c=2,n=s
sahasva	sah	pos=v,p=2,n=s,l=lot
mA	mA	pos=i
BUd	BU	pos=v,p=3,n=s,l=lun_unaug
asyAH	idam	pos=n,g=f,c=6,n=s
praRayini	praRayin	pos=a,g=m,c=7,n=s
mayi	mad	pos=n,g=,c=7,n=s
svapna	svapna	pos=n,comp=y
labDe	laB	pos=va,g=m,c=7,n=s,f=part
kaTaMcit	kaTaMcid	pos=i
sadyaH	sadyas	pos=i
kaRWa	kaRWa	pos=n,comp=y
cyuta	cyu	pos=va,comp=y,f=part
Buja	Buja	pos=n,comp=y
latA	latA	pos=n,comp=y
granTi	granTi	pos=n,g=n,c=1,n=s
gAQa	gAQa	pos=a,comp=y
upagUQam	upaguh	pos=va,g=n,c=1,n=s,f=part

# id = Megh.2.38
tAm	tad	pos=n,g=f,c=2,n=s
utTApya	utTApay	pos=vi
sva	sva	pos=a,comp=y
jala	jala	pos=n,comp=y
kaRikA	kaRikA	pos=n,comp=y
SItalena	SItala	pos=a,g=m,c=3,n=s
anilena	anila	pos=n,g=m,c=3,n=s
pratyASvastAm	pratyASvas	pos=va,g=f,c=2,n=s,f=part
samam	samam	pos=i
aBinavEH	aBinava	pos=a,g=n,c=3,n=p
jAlakEH	jAlaka	pos=n,g=n,c=3,n=p
mAlatInAm	mAlatI	pos=n,g=f,c=6,n=p
vidyut	vidyut	pos=n,comp=y
garBaH	garBa	pos=n,g=m,c=1,n=s
stimita	stimita	pos=a,comp=y
nayanAm	nayana	pos=n,g=f,c=2,n=s
tvad	tvad	pos=n,comp=y
sanATe	sanATa	pos=a,g=m,c=7,n=s
gavAkze	gavAkza	pos=n,g=m,c=7,n=s
vaktum	vac	pos=vi
DIraH	DIra	pos=a,g=m,c=1,n=s
stanita	stanita	pos=n,comp=y
vacanEH	vacana	pos=n,g=n,c=3,n=p
mAninIm	mAninI	pos=n,g=f,c=2,n=s
prakrameTAH	prakram	pos=v,p=2,n=s,l=vidhilin

# id = Megh.2.39
BartuH	Bartf	pos=n,g=m,c=6,n=s
mitram	mitra	pos=n,g=m,c=2,n=s
priyam	priya	pos=a,g=m,c=2,n=s
aviDave	aviDavA	pos=n,g=f,c=8,n=s
vidDi	vid	pos=v,p=2,n=s,l=lot
mAm	mad	pos=n,g=,c=2,n=s
ambuvAham	ambuvAha	pos=n,g=m,c=2,n=s
tad	tad	pos=n,comp=y
saMdeSEH	saMdeSa	pos=n,g=m,c=3,n=p
hfdaya	hfdaya	pos=n,comp=y
nihitEH	niDA	pos=va,g=m,c=3,n=p,f=part
Agatam	Agam	pos=va,g=m,c=2,n=s,f=part
tvad	tvad	pos=n,comp=y
samIpam	samIpa	pos=n,g=n,c=2,n=s
yo	yad	pos=n,g=m,c=1,n=s
vfndAni	vfnda	pos=n,g=n,c=2,n=p
tvarayati	tvaray	pos=v,p=3,n=s,l=lat
paTi	paTin	pos=n,g=,c=7,n=s
SrAmyatAm	Sram	pos=va,g=m,c=6,n=p,f=part
prozitAnAm	pravas	pos=va,g=m,c=6,n=p,f=part
mandra	mandra	pos=a,comp=y
snigDEH	snigDa	pos=a,g=m,c=3,n=p
DvaniBiH	Dvani	pos=n,g=m,c=3,n=p
abalA	abalA	pos=n,comp=y
veRI	veRI	pos=n,comp=y
mokza	mokza	pos=n,comp=y
utsukAni	utsuka	pos=a,g=n,c=2,n=p

# id = Megh.2.40
ity	iti	pos=i
AKyAte	AKyA	pos=va,g=n,c=7,n=s,f=part
pavanatanayam	pavanatanaya	pos=n,g=m,c=2,n=s
mETilI	mETilI	pos=n,g=f,c=1,n=s
iva	iva	pos=i
unmuKI	unmuKa	pos=a,g=f,c=1,n=s
sA	tad	pos=n,g=f,c=1,n=s
tvAm	tvad	pos=n,g=,c=2,n=s
utkaRWA	utkaRWA	pos=n,comp=y
ucCvasita	ucCvas	pos=va,comp=y,f=part
hfdayA	hfdaya	pos=n,g=f,c=1,n=s
vIkzya	vIkz	pos=vi
saMBAvya	samBAvay	pos=vi
ca	ca	pos=i
eva	eva	pos=i
Srozyaty	Sru	pos=v,p=3,n=s,l=lrt
asmAt	idam	pos=n,g=n,c=5,n=s
param	param	pos=i
avahitA	avaDA	pos=va,g=f,c=1,n=s,f=part
sOmya	sOmya	pos=a,g=m,c=8,n=s
sImantinInAm	sImantinI	pos=n,g=f,c=6,n=p
kAnta	kAnta	pos=a,comp=y
udantaH	udanta	pos=n,g=m,c=1,n=s
suhfd	suhfd	pos=n,comp=y
upanataH	upanam	pos=va,g=m,c=1,n=s,f=part
saMgamAt	saMgama	pos=n,g=m,c=5,n=s
kiMcid	kaScit	pos=n,g=n,c=2,n=s
UnaH	Una	pos=a,g=m,c=1,n=s

# id = Megh.2.41
tAm	tad	pos=n,g=f,c=2,n=s
Ayuzman	Ayuzmat	pos=a,g=m,c=8,n=s
mama	mad	pos=n,g=,c=6,n=s
ca	ca	pos=i
vacanAd	vacana	pos=n,g=n,c=5,n=s
AtmanaH	Atman	pos=n,g=m,c=6,n=s
ca	ca	pos=i
upakf	upakf	pos=vi
brUyA	brU	pos=v,p=2,n=s,l=vidhilin
evam	evam	pos=i
tava	tvad	pos=n,g=,c=6,n=s
sahacaro	sahacara	pos=n,g=m,c=1,n=s
rAmagiri	rAmagiri	pos=n,comp=y
ASrama	ASrama	pos=n,comp=y
sTaH	sTa	pos=a,g=m,c=1,n=s
avyApannaH	avyApanna	pos=a,g=m,c=1,n=s
kuSalam	kuSala	pos=n,g=n,c=2,n=s
abale	abalA	pos=n,g=f,c=8,n=s
pfcCati	pracC	pos=v,p=3,n=s,l=lat
tvAm	tvad	pos=n,g=,c=2,n=s
viyuktaH	viyuj	pos=va,g=m,c=1,n=s,f=part
pUrva	pUrva	pos=n,comp=y
ABAzitavyam	ABAz	pos=va,g=n,c=1,n=s,f=krtya
sulaBa	sulaBa	pos=a,comp=y
vipad	vipad	pos=n,g=m,c=6,n=p
prARinAm	prARin	pos=n,g=m,c=6,n=p
etad	etad	pos=n,g=n,c=1,n=s
eva	eva	pos=i

# id = Megh.2.42
aNgeRa	aNga	pos=n,g=n,c=3,n=s
aNgam	aNga	pos=n,g=n,c=1,n=s
pratanu	pratanu	pos=a,g=n,c=1,n=s
tanunA	tanu	pos=a,g=n,c=3,n=s
gAQa	gAQa	pos=a,comp=y
taptena	tap	pos=va,g=n,c=3,n=s,f=part
taptam	tap	pos=va,g=n,c=1,n=s,f=part
sa	sa	pos=i
asrena	asra	pos=n,g=n,c=3,n=s
aSru	aSru	pos=n,comp=y
drutam	dru	pos=va,g=n,c=1,n=s,f=part
avirata	avirata	pos=a,comp=y
utkaRWam	utkaRWA	pos=n,g=n,c=1,n=s
utkaRWitena	utkaRW	pos=va,g=m,c=3,n=s,f=part
uzRa	uzRa	pos=a,comp=y
ucCvAsam	ucCvAsa	pos=n,g=m,c=2,n=s
samaDikatara	samaDikatara	pos=a,comp=y
ucCvAsinA	ucCvAsin	pos=a,g=m,c=3,n=s
dUra	dUra	pos=a,comp=y
vartI	vartin	pos=a,g=m,c=1,n=s
saMkalpEs	saMkalpa	pos=n,g=m,c=3,n=p
tEH	tad	pos=n,g=m,c=3,n=p
viSati	viS	pos=v,p=3,n=s,l=lat
viDinA	viDi	pos=n,g=m,c=3,n=s
vEriRA	vErin	pos=a,g=m,c=3,n=s
rudDa	ruD	pos=va,comp=y,f=part
mArgaH	mArga	pos=n,g=m,c=1,n=s

# id = Megh.2.43
Sabda	Sabda	pos=n,comp=y
AKyA	AKyA	pos=va,g=n,c=2,n=s,f=krtya
yat	yad	pos=n,g=n,c=2,n=s
api	api	pos=i
kila	kila	pos=i
te	tvad	pos=n,g=,c=6,n=s
yaH	yad	pos=n,g=m,c=1,n=s
saKInAm	saKI	pos=n,g=f,c=6,n=p
purastAt	purastAt	pos=i
karRe	karRa	pos=n,g=m,c=7,n=s
lolaH	lola	pos=a,g=m,c=1,n=s
kaTayitum	kaTay	pos=vi
aBUd	BU	pos=v,p=3,n=s,l=lun
Anana	Anana	pos=n,comp=y
sparSa	sparSa	pos=n,comp=y
loBAt	loBa	pos=n,g=m,c=5,n=s
so	tad	pos=n,g=m,c=1,n=s
'tikrAntaH	atikram	pos=va,g=m,c=1,n=s,f=part
SravaRa	SravaRa	pos=n,comp=y
vizayam	vizaya	pos=n,g=m,c=2,n=s
locanAByAm	locana	pos=n,g=n,c=3,n=d
adfzwas	adfzwa	pos=a,g=m,c=1,n=s
tvAm	tvad	pos=n,g=,c=2,n=s
utkaRWA	utkaRWA	pos=n,comp=y
viracita	viracay	pos=va,comp=y,f=part
padam	pada	pos=n,g=n,c=2,n=s
mad	mad	pos=n,comp=y
muKena	muKa	pos=n,g=n,c=3,n=s
idam	idam	pos=n,g=n,c=2,n=s
Aha	ah	pos=v,p=3,n=s,l=lit

# id = Megh.2.44
SyAmAsv	SyAma	pos=a,g=f,c=7,n=p
aNgam	aNga	pos=n,g=n,c=2,n=s
cak	cak	pos=va,comp=y,f=part
hariRI	hariRI	pos=n,comp=y
prekzaRe	prekzaRa	pos=n,g=n,c=7,n=s
dfzwi	dfzwi	pos=n,comp=y
pAtam	pAta	pos=n,g=m,c=2,n=s
vaktra	vaktra	pos=n,comp=y
CAyAm	CAyA	pos=n,g=f,c=2,n=s
SaSini	SaSin	pos=n,g=m,c=7,n=s
SiKinAm	SiKin	pos=n,g=m,c=6,n=p
barha	barha	pos=n,comp=y
BArezu	BAra	pos=n,g=m,c=7,n=p
keSAn	keSa	pos=n,g=m,c=2,n=p
utpaSyAmi	utpaS	pos=v,p=1,n=s,l=lat
pratanuzu	pratanu	pos=a,g=m,c=7,n=p
nadI	nadI	pos=n,comp=y
vIci	vIci	pos=n,g=m,c=7,n=p
BrU	BrU	pos=n,comp=y
vilAsAn	vilAsa	pos=n,g=m,c=2,n=p
hanta	hanta	pos=i
ekasmin	eka	pos=n,g=m,c=7,n=s
kvacid	kvacid	pos=i
api	api	pos=i
na	na	pos=i
te	tvad	pos=n,g=,c=6,n=s
caRqi	caRqa	pos=a,g=f,c=8,n=s
sAdfSyam	sAdfSya	pos=n,g=n,c=1,n=s
asti	as	pos=v,p=3,n=s,l=lat

# id = Megh.2.45
tvAm	tvad	pos=n,g=,c=2,n=s
AliKya	AliK	pos=vi
praRaya	praRaya	pos=n,comp=y
kupitAm	kup	pos=va,g=f,c=2,n=s,f=part
DAtu	DAtu	pos=n,comp=y
rAgEH	rAga	pos=n,g=m,c=3,n=p
SilAyAm	SilA	pos=n,g=f,c=7,n=s
AtmAnam	Atman	pos=n,g=m,c=2,n=s
te	tvad	pos=n,g=,c=6,n=s
caraRa	caraRa	pos=n,comp=y
patitam	pat	pos=va,g=m,c=2,n=s,f=part
yAvad	yAvat	pos=i
icCAmi	iz	pos=v,p=1,n=s,l=lat
kartum	kf	pos=vi
asrEs	asra	pos=n,g=n,c=3,n=p
tAvan	tAvat	pos=i
muhuH	muhur	pos=i
upacitEH	upaci	pos=va,g=n,c=3,n=p,f=part
dfzwiH	dfzwi	pos=n,g=f,c=1,n=s
Alupyate	Alup	pos=v,p=3,n=s,l=lat
me	mad	pos=n,g=,c=6,n=s
krUras	krUra	pos=a,g=m,c=1,n=s
tasminn	tad	pos=n,g=n,c=7,n=s
api	api	pos=i
na	na	pos=i
sahate	sah	pos=v,p=3,n=s,l=lat
saMgamam	saMgama	pos=n,g=m,c=2,n=s
nO	mad	pos=n,g=,c=6,n=d
kftAntaH	kftAnta	pos=n,g=m,c=1,n=s

# id = Megh.2.46
mAm	mad	pos=n,g=,c=2,n=s
AkASa	AkASa	pos=n,comp=y
praRiDA	praRiDA	pos=va,comp=y,f=part
Bujam	Buja	pos=n,g=m,c=2,n=s
nirdaya	nirdaya	pos=a,comp=y
ASleza	ASleza	pos=n,comp=y
hetoH	hetu	pos=n,g=m,c=5,n=s
labDAyAs	laB	pos=va,g=f,c=6,n=s,f=part
te	tvad	pos=n,g=,c=6,n=s
kaTam	kaTam	pos=i
api	api	pos=i
mayA	mad	pos=n,g=,c=3,n=s
svapna	svapna	pos=n,comp=y
saMdarSanezu	saMdarSana	pos=n,g=n,c=7,n=p
paSyantInAm	dfS	pos=va,g=f,c=6,n=p,f=part
na	na	pos=i
Kalu	Kalu	pos=i
bahuSo	bahuSas	pos=i
na	na	pos=i
sTalIdevatAnAm	sTalIdevatA	pos=n,g=f,c=6,n=p
muktA	muktA	pos=n,comp=y
sTUlAH	sTUla	pos=a,g=m,c=1,n=p
taru	taru	pos=n,comp=y
kisalayezu	kisalaya	pos=n,g=m,c=7,n=p
aSru	aSru	pos=n,comp=y
leSAH	leSa	pos=n,g=m,c=1,n=p
patanti	pat	pos=v,p=3,n=p,l=lat

# id = Megh.2.47
BittvA	Bid	pos=vi
sadyaH	sadyas	pos=i
kisalaya	kisalaya	pos=n,comp=y
puwAn	puwa	pos=n,g=m,c=2,n=p
devadAru	devadAru	pos=n,comp=y
drumARAm	druma	pos=n,g=m,c=6,n=p
ye	yad	pos=n,g=m,c=1,n=p
tad	tad	pos=n,comp=y
kzIra	kzIra	pos=n,comp=y
sruti	sruti	pos=n,comp=y
suraBayaH	suraBi	pos=a,g=m,c=1,n=p
dakziRena	dakziRena	pos=i
pravfttAH	pravft	pos=va,g=m,c=1,n=p,f=part
AliNgyante	AliNg	pos=v,p=3,n=p,l=lat
guRavati	guRavat	pos=a,g=f,c=8,n=s
mayA	mad	pos=n,g=,c=3,n=s
te	tad	pos=n,g=m,c=1,n=p
tuzArAdri	tuzArAdri	pos=n,comp=y
vAtAH	vAta	pos=n,g=m,c=1,n=p
pUrvam	pUrvam	pos=i
spfzwam	spfS	pos=va,g=n,c=1,n=s,f=part
yadi	yadi	pos=i
kila	kila	pos=i
Baved	BU	pos=v,p=3,n=s,l=vidhilin
aNgam	aNga	pos=n,g=n,c=1,n=s
eBis	idam	pos=n,g=m,c=3,n=p
te	tvad	pos=n,g=,c=6,n=s
iti	iti	pos=i

# id = Megh.2.48
saMkzipyante	saMkzip	pos=v,p=3,n=p,l=lat
kzaRa	kzaRa	pos=n,g=m,c=1,n=s
iva	iva	pos=i
kaTam	kaTam	pos=i
dIrGa	dIrGa	pos=a,comp=y
yAmA	yAma	pos=n,g=f,c=1,n=s
triyAmA	triyAmA	pos=n,g=f,c=1,n=s
sarva	sarva	pos=n,comp=y
avasTAsu	avasTA	pos=n,g=f,c=7,n=p
ahaH	ahar	pos=n,g=n,c=1,n=s
api	api	pos=i
kaTam	kaTam	pos=i
manda	manda	pos=a,comp=y
manda	manda	pos=a,comp=y
Atapam	Atapa	pos=n,g=n,c=1,n=s
syAt	as	pos=v,p=3,n=s,l=vidhilin
itTam	itTam	pos=i
cetaH	cetas	pos=n,g=n,c=1,n=s
cawula	cawula	pos=a,comp=y
nayane	nayana	pos=n,g=f,c=8,n=s
durlaBa	durlaBa	pos=a,comp=y
prArTanam	prArTanA	pos=n,g=n,c=1,n=s
me	mad	pos=n,g=,c=6,n=s
gAQa	gAQa	pos=a,comp=y
uzmABiH	uzma	pos=n,g=f,c=3,n=p
kftam	kf	pos=va,g=n,c=1,n=s,f=part
aSaraRam	aSaraRa	pos=a,g=n,c=1,n=s
tvad	tvad	pos=n,comp=y
viyoga	viyoga	pos=n,comp=y
vyaTABiH	vyaTA	pos=n,g=f,c=3,n=p

# id = Megh.2.49
nanv	nanu	pos=i
AtmAnam	Atman	pos=n,g=m,c=2,n=s
bahu	bahu	pos=a,g=n,c=2,n=s
vigaRayann	vigaRay	pos=va,g=m,c=1,n=s,f=part
AtmanA	Atman	pos=n,g=m,c=3,n=s
eva	eva	pos=i
avalambe	avalamb	pos=v,p=1,n=s,l=lat
tat	tad	pos=n,g=n,c=2,n=s
kalyARi	kalyARa	pos=a,g=f,c=8,n=s
tvam	tvad	pos=n,g=,c=1,n=s
api	api	pos=i
nitarAm	nitarAm	pos=i
mA	mA	pos=i
gamaH	gam	pos=v,p=2,n=s,l=lun_unaug
kAtara	kAtara	pos=a,comp=y
tvam	tva	pos=n,g=n,c=2,n=s
kasya	ka	pos=n,g=m,c=6,n=s
atyantam	atyanta	pos=a,g=n,c=1,n=s
suKam	suKa	pos=n,g=n,c=1,n=s
upanatam	upanam	pos=va,g=n,c=1,n=s,f=part
duHKam	duHKa	pos=n,g=n,c=1,n=s
ekAntato	ekAntataH	pos=i
vA	vA	pos=i
nIcEH	nIcEs	pos=i
gacCaty	gam	pos=v,p=3,n=s,l=lat
upari	upari	pos=i
ca	ca	pos=i
daSA	daSA	pos=n,g=f,c=1,n=s
cakra	cakra	pos=n,comp=y
nemi	nemi	pos=n,comp=y
krameRa	krama	pos=n,g=m,c=3,n=s

# id = Megh.2.50
SApa	SApa	pos=n,comp=y
antaH	anta	pos=n,g=m,c=1,n=s
me	mad	pos=n,g=,c=6,n=s
Bujaga	Bujaga	pos=n,comp=y
SayanAt	Sayana	pos=n,g=n,c=5,n=s
utTite	utTA	pos=va,g=m,c=7,n=s,f=part
SArNgapARO	SArNgapARi	pos=n,g=m,c=7,n=s
SezAn	Seza	pos=a,g=m,c=2,n=p
mAsAn	mAsa	pos=n,g=m,c=2,n=p
gamaya	gamay	pos=v,p=2,n=s,l=lot
caturo	catur	pos=n,g=m,c=2,n=p
locane	locana	pos=n,g=n,c=2,n=d
mIlayitvA	mIlay	pos=vi
paScAd	paScAt	pos=i
AvAm	mad	pos=n,g=,c=1,n=d
viraha	viraha	pos=n,comp=y
guRitam	guRay	pos=va,g=m,c=2,n=s,f=part
tam	tad	pos=n,g=m,c=2,n=s
tam	tad	pos=n,g=m,c=2,n=s
Atma	Atman	pos=n,comp=y
aBilAzam	aBilAza	pos=n,g=m,c=2,n=s
nirvekzyAvaH	nirviS	pos=v,p=1,n=d,l=lrt
pariRata	pariRam	pos=va,comp=y,f=part
Sarad	Sarad	pos=n,comp=y
candrikAsu	candrikA	pos=n,g=f,c=7,n=p
kzapAsu	kzapA	pos=n,g=f,c=7,n=p

# id = Megh.2.51
BUyas	BUyas	pos=i
ca	ca	pos=i
Aha	ah	pos=v,p=3,n=s,l=lit
tvam	tvad	pos=n,g=,c=1,n=s
api	api	pos=i
Sayane	Sayana	pos=n,g=n,c=7,n=s
kaRWa	kaRWa	pos=n,comp=y
lagnA	lag	pos=va,g=f,c=1,n=s,f=part
purA	purA	pos=i
me	mad	pos=n,g=,c=6,n=s
nidrAm	nidrA	pos=n,g=f,c=2,n=s
gatvA	gam	pos=vi
kim	ka	pos=n,g=n,c=2,n=s
api	api	pos=i
rudatI	rud	pos=va,g=f,c=1,n=s,f=part
sa	sa	pos=i
svaram	svara	pos=n,g=n,c=2,n=s
viprabudDA	viprabuD	pos=va,g=f,c=1,n=s,f=part
sa	sa	pos=i
antarhAsam	antarhAsa	pos=n,g=n,c=2,n=s
kaTitam	kaTay	pos=va,g=n,c=2,n=s,f=part
asakft	asakft	pos=i
pfcCataH	pracC	pos=va,g=m,c=6,n=s,f=part
ca	ca	pos=i
tvayA	tvad	pos=n,g=,c=3,n=s
me	mad	pos=n,g=,c=6,n=s
dfzwaH	dfS	pos=va,g=m,c=1,n=s,f=part
svapne	svapna	pos=n,g=m,c=7,n=s
kitava	kitava	pos=n,g=m,c=8,n=s
ramayan	ramay	pos=va,g=m,c=1,n=s,f=part
kAm	ka	pos=n,g=f,c=2,n=s
api	api	pos=i
tvam	tvad	pos=n,g=,c=1,n=s
mayA	mad	pos=n,g=,c=3,n=s
iti	iti	pos=i

# id = Megh.2.52
etasmAn	etad	pos=n,g=n,c=5,n=s
mAm	mad	pos=n,g=,c=2,n=s
kuSalinam	kuSalin	pos=a,g=m,c=2,n=s
aBijYAna	aBijYAna	pos=n,comp=y
dAnAt	dAna	pos=n,g=n,c=5,n=s
viditvA	vid	pos=vi
mA	mA	pos=i
kOlInAd	kOlIna	pos=n,g=n,c=5,n=s
asita	asita	pos=a,comp=y
nayane	nayana	pos=n,g=f,c=8,n=s
mayy	mad	pos=n,g=,c=7,n=s
aviSvAsinI	aviSvAsin	pos=a,g=f,c=1,n=s
BUH	BU	pos=v,p=2,n=s,l=lun_unaug
snehAn	sneha	pos=n,g=m,c=2,n=p
AhuH	ah	pos=v,p=3,n=p,l=lit
kim	ka	pos=n,g=n,c=2,n=s
api	api	pos=i
virahe	viraha	pos=n,g=m,c=7,n=s
DvaMsinas	DvaMsin	pos=a,g=m,c=1,n=p
te	tad	pos=n,g=m,c=1,n=p
tv	tu	pos=i
aBogAd	aBoga	pos=n,g=m,c=5,n=s
izwe	iz	pos=va,g=n,c=7,n=s,f=part
vastuny	vastu	pos=n,g=n,c=7,n=s
upacita	upaci	pos=va,comp=y,f=part
rasAH	rasa	pos=n,g=m,c=1,n=p
prema	preman	pos=n,comp=y
rASIBavanti	rASIBU	pos=v,p=3,n=p,l=lat

# id = Megh.2.53
ASvAsya	ASvAsay	pos=vi
evam	evam	pos=i
praTama	praTama	pos=a,comp=y
viraha	viraha	pos=n,comp=y
udagra	udagra	pos=a,comp=y
SokAm	Soka	pos=n,g=f,c=2,n=s
saKIm	saKI	pos=n,g=f,c=2,n=s
te	tvad	pos=n,g=,c=6,n=s
SElAd	SEla	pos=n,g=m,c=5,n=s
ASu	ASu	pos=i
trinayana	trinayana	pos=n,comp=y
vfza	vfza	pos=n,comp=y
utKAta	utKan	pos=va,comp=y,f=part
kUwAt	kUwa	pos=n,g=m,c=5,n=s
nivfttaH	nivft	pos=va,g=m,c=1,n=s,f=part
sa	sa	pos=i
aBijYAna	aBijYAna	pos=n,comp=y
prahita	prahi	pos=va,comp=y,f=part
kuSalEH	kuSala	pos=a,g=n,c=3,n=p
tad	tad	pos=n,comp=y
vacoBiH	vacas	pos=n,g=n,c=3,n=p
me	mad	pos=n,g=,c=6,n=s
api	api	pos=i
prAtaH	prAtar	pos=i
kunda	kunda	pos=n,comp=y
prasava	prasava	pos=n,comp=y
SiTilam	SiTila	pos=a,g=n,c=2,n=s
jIvitam	jIvita	pos=n,g=n,c=2,n=s
DArayeTAH	DAray	pos=v,p=2,n=s,l=vidhilin

# id = Megh.2.54
kaccit	kaScit	pos=n,g=n,c=1,n=s
sOmya	sOmya	pos=a,g=m,c=8,n=s
vyavasitam	vyavasA	pos=va,g=n,c=1,n=s,f=part
idam	idam	pos=n,g=n,c=1,n=s
banDu	banDu	pos=n,comp=y
kftyam	kftya	pos=n,g=n,c=1,n=s
tvayA	tvad	pos=n,g=,c=3,n=s
me	mad	pos=n,g=,c=6,n=s
pratyAdeSAn	pratyAdeSa	pos=n,g=m,c=5,n=s
na	na	pos=i
Kalu	Kalu	pos=i
Bavato	Bavat	pos=a,g=m,c=6,n=s
DIra	DIra	pos=a,comp=y
tAm	tA	pos=n,g=f,c=2,n=s
kalpayAmi	kalpay	pos=v,p=1,n=s,l=lat
niHSabdo	niHSabda	pos=a,g=m,c=1,n=s
'pi	api	pos=i
pradiSasi	pradiS	pos=v,p=2,n=s,l=lat
jalam	jala	pos=n,g=n,c=2,n=s
yAcitaH	yAc	pos=va,g=m,c=1,n=s,f=part
cAtakeByaH	cAtaka	pos=n,g=m,c=4,n=p
pratyuktam	prativac	pos=va,g=n,c=1,n=s,f=part
hi	hi	pos=i
praRayizu	praRayin	pos=a,g=m,c=7,n=p
satAm	sat	pos=a,g=m,c=6,n=p
Ipsita	Ipsay	pos=va,comp=y,f=part
arTa	arTa	pos=n,comp=y
kriyA	kriyA	pos=n,g=f,c=1,n=s
eva	eva	pos=i

# id = Megh.2.55
etat	etad	pos=n,g=n,c=2,n=s
kftvA	kf	pos=vi
priyam	priya	pos=n,g=n,c=2,n=s
anucita	anucita	pos=a,comp=y
prArTana	prArthana	pos=n,g=n,comp=y
AvartinaH	Avartin	pos=n,g=m,c=6,n=s
me	mad	pos=n,g=,c=6,n=s
sauhArdAt	sauhArda	pos=n,g=n,c=5,n=s
vA	vA	pos=i
vidhuraH	vidhura	pos=n,g=m,c=1,n=s
iti	iti	pos=i
vA	vA	pos=i
mayi	mad	pos=n,g=,c=7,n=s
anukroSa	anukroSa	pos=n,comp=y
budDyA	budDi	pos=n,g=f,c=3,n=s
izwAn	iz	pos=va,g=m,c=2,n=p,f=part
deSAn	deSa	pos=n,g=m,c=2,n=p
jalada	jalada	pos=n,g=m,c=8,n=s
vicara	vicar	pos=v,p=2,n=s,l=lot
prAvfzA	prAvfz	pos=n,g=f,c=3,n=s
saMBfta	saMBf	pos=a,comp=y
SrIH	SrI	pos=f,g=m,c=1,n=s
mA	mA	pos=i
BUt	BU	pos=v,p=3,n=s,l=vidhilin
evam	evam	pos=i
kzaRam	kzaRam	pos=i
api	api	pos=i
ca	ca	pos=i
te	tvad	pos=n,g=,c=6,n=s
vidyutA	vidyut	pos=n,g=f,c=3,n=s
viprayogaH	viprayoga	pos=n,g=m,c=1,n=s
