# id = KMuk.1
vande	vand	pos=v,p=1,n=s,l=lat
mukundam	mukunda	pos=n,g=m,c=2,n=s
aravinda	aravinda	pos=n,comp=y
dala	dala	pos=n,comp=y
Ayata	Ayam	pos=va,comp=y,f=part
akzam	akza	pos=n,g=m,c=2,n=s
kunda	kunda	pos=n,comp=y
indu	indu	pos=n,comp=y
SaNKa	SaNKa	pos=n,comp=y
daSanam	daSana	pos=n,g=m,c=2,n=s
SiSu	SiSu	pos=n,comp=y
gopa	gopa	pos=n,comp=y
vezam	veza	pos=n,g=m,c=2,n=s
indra	indra	pos=n,comp=y
Adi	Adi	pos=n,comp=y
deva	deva	pos=n,comp=y
gaRa	gaRa	pos=n,comp=y
vandita	vand	pos=va,comp=y,f=part
pAda	pAda	pos=n,comp=y
pIWam	pIWa	pos=n,g=m,c=2,n=s
vfndAvana	vfndAvana	pos=n,comp=y
Alayam	Alaya	pos=n,g=m,c=2,n=s
aham	mad	pos=n,g=,c=1,n=s
vasudeva	vasudeva	pos=n,comp=y
sUnum	sUnu	pos=n,g=m,c=2,n=s

# id = KMuk.2
jayatu	ji	pos=v,p=3,n=s,l=lot
jayatu	ji	pos=v,p=3,n=s,l=lot
devo	deva	pos=n,g=m,c=1,n=s
devakInandano	devakInandana	pos=n,g=m,c=1,n=s
'yam	idam	pos=n,g=m,c=1,n=s
jayatu	ji	pos=v,p=3,n=s,l=lot
jayatu	ji	pos=v,p=3,n=s,l=lot
kfzRo	kfzRa	pos=n,g=m,c=1,n=s
vfzRi	vfzRi	pos=n,comp=y
vaMSa	vaMSa	pos=n,comp=y
pradIpaH	pradIpa	pos=n,g=m,c=1,n=s
jayatu	ji	pos=v,p=3,n=s,l=lot
jayatu	ji	pos=v,p=3,n=s,l=lot
meGa	meGa	pos=n,comp=y
SyAmalaH	SyAmala	pos=a,g=m,c=1,n=s
komala	komala	pos=a,comp=y
aNgaH	aNga	pos=n,g=m,c=1,n=s
jayatu	ji	pos=v,p=3,n=s,l=lot
jayatu	ji	pos=v,p=3,n=s,l=lot
pfTvI	pfTvI	pos=n,comp=y
BAra	BAra	pos=n,comp=y
nASaH	nASa	pos=n,g=m,c=1,n=s
mukundaH	mukunda	pos=n,g=m,c=1,n=s

# id = KMuk.3
mukunda	mukunda	pos=n,g=m,c=8,n=s
mUrDnA	mUrDan	pos=n,g=m,c=3,n=s
praRipatya	praRipat	pos=vi
yAce	yAc	pos=v,p=1,n=s,l=lat
Bavantam	Bavat	pos=a,g=m,c=2,n=s
ekAntam	ekAnta	pos=n,g=m,c=2,n=s
iyantam	iyat	pos=a,g=m,c=2,n=s
arTam	arTa	pos=n,g=m,c=2,n=s
a	a	pos=i
vismftiH	vismfti	pos=n,g=f,c=1,n=s
tvad	tvad	pos=n,comp=y
caraRa	caraRa	pos=n,comp=y
aravinde	aravinda	pos=n,g=n,c=7,n=s
Bave	Bava	pos=n,g=m,c=7,n=s
Bave	Bava	pos=n,g=m,c=7,n=s
me	mad	pos=n,g=,c=6,n=s
'sti	as	pos=v,p=3,n=s,l=lat
Bavat	Bavat	pos=a,comp=y
prasAdAt	prasAda	pos=n,g=m,c=5,n=s

# id = KMuk.4
SrI	SrI	pos=n,comp=y
mukunda	mukunda	pos=n,comp=y
pada	pada	pos=n,comp=y
amBoja	amBoja	pos=n,comp=y
maDvaH	maDu	pos=n,g=n,c=6,n=s
parama	parama	pos=a,comp=y
adButam	adButa	pos=n,g=n,c=2,n=s
yad	yad	pos=n,comp=y
pAyin	pAyin	pos=a,g=m,c=1,n=p
na	na	pos=i
muhyanti	muh	pos=v,p=3,n=p,l=lat
muhyanti	muh	pos=v,p=3,n=p,l=lat
yad	yad	pos=n,comp=y
a	a	pos=i
pAyin	pAyin	pos=a,g=m,c=1,n=p

# id = KMuk.5
na	na	pos=i
aham	mad	pos=n,g=,c=1,n=s
vande	vand	pos=v,p=1,n=s,l=lat
tava	tvad	pos=n,g=,c=6,n=s
caraRayoH	caraRa	pos=n,g=n,c=6,n=d
dvandvam	dvaMdva	pos=n,g=n,c=2,n=s
a	a	pos=i
dvandva	dvaMdva	pos=n,comp=y
hetoH	hetu	pos=n,g=m,c=5,n=s
kumBIpAkam	kumBIpAka	pos=n,g=m,c=2,n=s
gurum	guru	pos=a,g=m,c=2,n=s
api	api	pos=i
hare	hari	pos=n,g=m,c=8,n=s
nArakam	nAraka	pos=n,g=m,c=2,n=s
na	na	pos=i
apanetum	apanI	pos=vi
ramyA	ramya	pos=a,g=f,c=2,n=p
rAmA	rAmA	pos=n,g=f,c=2,n=p
mfdu	mfdu	pos=a,comp=y
tanu	tanu	pos=n,comp=y
latAH	latA	pos=n,g=f,c=2,n=p
nandane	nandana	pos=n,g=n,c=7,n=s
na	na	pos=i
api	api	pos=i
rantum	ram	pos=vi
BAve	BAva	pos=n,g=m,c=7,n=s
BAve	BAva	pos=n,g=m,c=7,n=s
hfdaya	hfdaya	pos=n,comp=y
Bavane	Bavana	pos=n,g=n,c=7,n=s
BAvaye	BAvay	pos=v,p=1,n=s,l=lat
'ham	mad	pos=n,g=,c=1,n=s
Bavantam	Bavat	pos=a,g=m,c=2,n=s

# id = KMuk.6
na	na	pos=i
AsTA	AsTA	pos=n,g=f,c=1,n=s
Darme	Darma	pos=n,g=m,c=7,n=s
na	na	pos=i
vasu	vasu	pos=n,comp=y
nicaye	nicaya	pos=n,g=m,c=7,n=s
na	na	pos=i
eva	eva	pos=i
kAma	kAma	pos=n,comp=y
upaBoge	upaBoga	pos=n,g=m,c=7,n=s
yat	yad	pos=n,g=n,c=1,n=s
Bavitavyam	BU	pos=va,g=n,c=1,n=s,f=krtya
tat	tad	pos=n,g=n,c=1,n=s
Bavatu	BU	pos=v,p=3,n=s,l=lot
Bagavan	Bagavat	pos=a,g=m,c=8,n=s
pUrva	pUrva	pos=n,comp=y
karma	karman	pos=n,comp=y
anurUpam	anurUpa	pos=a,g=n,c=1,n=s
etat	etad	pos=n,g=n,c=1,n=s
prArTay	prArTay	pos=va,g=n,c=1,n=s,f=krtya
mama	mad	pos=n,g=,c=6,n=s
bahu	bahu	pos=a,comp=y
matam	man	pos=va,g=n,c=1,n=s,f=part
janma	janman	pos=n,comp=y
janma	janman	pos=n,comp=y
antare	antara	pos=n,g=n,c=7,n=s
'pi	api	pos=i
tvad	tvad	pos=n,comp=y
pAda	pAda	pos=n,comp=y
amBoruha	amBoruha	pos=n,comp=y
yuga	yuga	pos=n,comp=y
gatA	gam	pos=va,g=f,c=1,n=s,f=part
niScalA	niScala	pos=a,g=f,c=1,n=s
BaktiH	Bakti	pos=n,g=f,c=1,n=s
astu	as	pos=v,p=3,n=s,l=lot

# id = KMuk.7
divi	div	pos=n,g=,c=7,n=s
vA	vA	pos=i
Buvi	BU	pos=n,g=f,c=7,n=s
vA	vA	pos=i
me	mad	pos=n,g=,c=6,n=s
astu	as	pos=v,p=3,n=s,l=lot
vAso	vAsa	pos=n,g=m,c=1,n=s
narake	naraka	pos=n,g=m,c=7,n=s
vA	vA	pos=i
naraka	naraka	pos=n,comp=y
antake	antaka	pos=n,g=m,c=7,n=s
prakAmam	prakAma	pos=n,g=m,c=2,n=s
avaDIrita	avaDIrita	pos=a,comp=y
SArada	SArada	pos=a,comp=y
aravindO	aravinda	pos=n,g=m,c=2,n=d
caraRO	caraRa	pos=n,g=m,c=2,n=d
te	tvad	pos=n,g=,c=6,n=s
maraRe	maraRa	pos=n,g=n,c=7,n=s
'pi	api	pos=i
cintayAmi	cintay	pos=v,p=1,n=s,l=lat

# id = KMuk.8
sarasija	sarasija	pos=n,comp=y
nayane	nayana	pos=n,g=m,c=7,n=s
sa	sa	pos=i
SaNKa	SaNKa	pos=n,comp=y
cakre	cakra	pos=n,g=m,c=7,n=s
muraBidi	muraBid	pos=n,g=m,c=7,n=s
mA	mA	pos=i
virama	viram	pos=v,p=2,n=s,l=lot
iha	iha	pos=i
citta	citta	pos=n,g=n,c=8,n=s
rantum	ram	pos=vi
suKa	suKa	pos=n,comp=y
karam	kara	pos=a,g=n,c=2,n=s
aparam	apara	pos=n,g=n,c=2,n=s
na	na	pos=i
jAtu	jAtu	pos=i
jAne	jYA	pos=v,p=1,n=s,l=lat
hari	hari	pos=n,comp=y
caraRa	caraRa	pos=n,comp=y
smaraRa	smaraRa	pos=n,comp=y
amftena	amfta	pos=n,g=n,c=3,n=s
tulyam	tulya	pos=a,g=n,c=2,n=s

# id = KMuk.9
mA	mA	pos=i
BEH	BI	pos=v,p=2,n=s,l=lun_unaug
manda	manda	pos=a,comp=y
manaH	manas	pos=n,g=n,c=8,n=s
vicintya	vicintay	pos=vi
bahuDA	bahuDA	pos=i
yAmAH	yAma	pos=a,g=f,c=2,n=p
ciram	ciram	pos=i
yAtanA	yAtanA	pos=n,g=f,c=2,n=p
na	na	pos=i
amI	adas	pos=n,g=m,c=1,n=p
naH	mad	pos=n,g=,c=6,n=p
praBavanti	praBU	pos=v,p=3,n=p,l=lat
pApa	pApa	pos=a,comp=y
ripavaH	ripu	pos=n,g=m,c=1,n=p
svAmI	svAmin	pos=n,g=m,c=1,n=s
nanu	nanu	pos=i
SrIDaraH	SrIDara	pos=n,g=m,c=1,n=s
Alasyam	Alasya	pos=n,g=n,c=2,n=s
vyapanIya	vyapanI	pos=vi
Bakti	Bakti	pos=n,comp=y
sulaBam	sulaBa	pos=a,g=m,c=2,n=s
DyAyasva	DyA	pos=v,p=2,n=s,l=lot
nArAyaRam	nArAyaRa	pos=n,g=m,c=2,n=s
lokasya	loka	pos=n,g=m,c=6,n=s
vyasana	vyasana	pos=n,comp=y
apanodana	apanodana	pos=n,comp=y
karaH	kara	pos=a,g=m,c=1,n=s
dAsasya	dAsa	pos=n,g=m,c=6,n=s
kim	kim	pos=i
na	na	pos=i
kzamaH	kzama	pos=a,g=m,c=1,n=s

# id = KMuk.10
Bava	Bava	pos=n,comp=y
jalaDi	jalaDi	pos=n,g=m,c=2,n=s
agADam	agADa	pos=a,g=m,c=2,n=s
dustaram	dustara	pos=a,g=m,c=2,n=s
nistareyam	nistf	pos=v,p=1,n=s,l=vidhilin
kaTam	kaTam	pos=i
aham	mad	pos=n,g=,c=1,n=s
iti	iti	pos=i
ceto	cetas	pos=n,g=n,c=8,n=s
mA	mA	pos=i
sma	sma	pos=i
gAH	gA	pos=v,p=2,n=s,l=lun_unaug
kAtara	kAtara	pos=a,comp=y
tvam	tva	pos=n,g=n,c=2,n=s
sarasija	sarasija	pos=n,comp=y
dfH	dfS	pos=n,g=m,c=7,n=s
deve	deva	pos=n,g=m,c=7,n=s
tAvakI	tAvaka	pos=a,g=f,c=1,n=s
BaktiH	Bakti	pos=n,g=f,c=1,n=s
ekA	eka	pos=n,g=f,c=1,n=s
naraka	naraka	pos=n,comp=y
Bid	Bid	pos=a,g=m,c=7,n=s
nizaRRA	nizad	pos=va,g=f,c=1,n=s,f=part
tArayizyati	tAray	pos=v,p=3,n=s,l=lrt
avaSyam	avaSyam	pos=i

# id = KMuk.11
tfzRA	tfzRA	pos=n,comp=y
toye	toya	pos=n,g=m,c=7,n=s
madana	madana	pos=n,comp=y
pavana	pavana	pos=n,comp=y
udDUta	udDU	pos=va,comp=y,f=part
moha	moha	pos=n,comp=y
Urmi	Urmi	pos=n,comp=y
mAle	mAlA	pos=n,g=m,c=7,n=s
dAra	dAra	pos=n,comp=y
Avarte	Avarta	pos=n,g=m,c=7,n=s
sahaja	sahaja	pos=a,comp=y
tanaya	tanaya	pos=n,comp=y
grAha	grAha	pos=n,comp=y
saMGa	saMGa	pos=n,comp=y
Akule	Akula	pos=a,g=m,c=7,n=s
ca	ca	pos=i
saMsAra	saMsAra	pos=n,comp=y
AKye	AKyA	pos=n,g=m,c=7,n=s
mahati	mahat	pos=a,g=m,c=7,n=s
jalaDO	jalaDi	pos=n,g=m,c=7,n=s
majjatAm	majj	pos=va,g=m,c=6,n=p,f=part
naH	mad	pos=n,g=,c=6,n=p
triDAman	triDAman	pos=n,g=m,c=8,n=s
pAda	pAda	pos=n,comp=y
amBoje	amBoja	pos=n,g=n,c=7,n=s
vara	vara	pos=n,comp=y
da	da	pos=a,g=m,c=8,n=s
Bavato	Bavat	pos=a,g=m,c=6,n=s
Bakti	Bakti	pos=n,comp=y
nAve	nAva	pos=n,g=m,c=7,n=s
prasIda	prasad	pos=v,p=2,n=s,l=lot

# id = KMuk.12
pfTvI	pfTvI	pos=n,comp=y
reRuH	reRu	pos=n,g=m,c=1,n=s
aRuH	aRu	pos=a,g=m,c=1,n=s
payAMsi	payas	pos=n,g=n,c=1,n=p
kaRikAH	kaRikA	pos=n,g=f,c=1,n=p
PalguH	Palgu	pos=a,g=m,c=1,n=s
sPuliNgo	sPuliNga	pos=n,g=m,c=1,n=s
laGuH	laGu	pos=a,g=m,c=1,n=s
tejaH	tejas	pos=n,g=n,c=1,n=s
niHSvasanam	niHSvasana	pos=n,g=n,c=1,n=s
marut	marut	pos=n,comp=y
tanutaram	tanutara	pos=a,g=n,c=1,n=s
ranDram	ranDra	pos=n,g=n,c=1,n=s
su	su	pos=i
sUkzmam	sUkzma	pos=a,g=n,c=1,n=s
naBaH	naBas	pos=n,g=n,c=1,n=s
kzudrA	kzudra	pos=a,g=m,c=1,n=p
rudra	rudra	pos=n,comp=y
pitAmaha	pitAmaha	pos=n,comp=y
praBftayaH	praBfti	pos=n,g=m,c=1,n=p
kIwAH	kIwa	pos=n,g=m,c=1,n=p
samastAH	samasta	pos=a,g=m,c=1,n=p
surA	sura	pos=n,g=m,c=1,n=p
dfzwe	dfzwa	pos=n,g=n,c=7,n=s
yatra	yatra	pos=i
sa	tad	pos=n,g=m,c=1,n=s
tAvako	tAvaka	pos=a,g=m,c=1,n=s
vijayate	viji	pos=v,p=3,n=s,l=lat
BUmA	BUman	pos=n,g=m,c=1,n=s
avaDUta	avaDU	pos=va,comp=y,f=part
avaDiH	avaDi	pos=n,g=m,c=1,n=s

# id = KMuk.13
AmnAya	AmnAya	pos=n,comp=y
aByasanAni	aByasana	pos=n,g=n,c=1,n=p
araRyaruditam	araRyarudita	pos=n,g=n,c=1,n=s
kfcCra	kfcCra	pos=n,comp=y
vratAni	vrata	pos=n,g=n,c=1,n=p
anvaham	anvaham	pos=i
medaH	medas	pos=n,comp=y
Ceda	Ceda	pos=n,comp=y
padAni	pada	pos=n,g=n,c=1,n=p
pUrta	pUrta	pos=n,comp=y
viDayaH	viDi	pos=n,g=m,c=1,n=p
sarve	sarva	pos=n,g=m,c=1,n=p
hutam	huta	pos=n,g=n,c=1,n=s
Basmani	Basman	pos=n,g=n,c=7,n=s
tIrTAnAm	tIrTa	pos=n,g=n,c=6,n=p
avagAhanAni	avagAhana	pos=n,g=n,c=1,n=p
ca	ca	pos=i
gajasnAnam	gajasnAna	pos=n,g=n,c=1,n=s
vinA	vinA	pos=i
yat	yat	pos=i
pada	pada	pos=n,comp=y
dvandva	dvaMdva	pos=n,comp=y
amBoruha	amBoruha	pos=n,comp=y
saMstutim	saMstuti	pos=n,g=f,c=2,n=s
vijayate	viji	pos=v,p=3,n=s,l=lat
devaH	deva	pos=n,g=m,c=1,n=s
sa	tad	pos=n,g=m,c=1,n=s
nArAyaRaH	nArAyaRa	pos=n,g=m,c=1,n=s

# id = KMuk.14
Ananda	Ananda	pos=n,g=m,c=8,n=s
govinda	govinda	pos=n,g=m,c=8,n=s
mukunda	mukunda	pos=n,g=m,c=8,n=s
rAma	rAma	pos=n,g=m,c=8,n=s
nArAyaRa	nArAyaRa	pos=n,g=m,c=8,n=s
ananta	ananta	pos=n,g=m,c=8,n=s
nirAmayEH	nirAmaya	pos=n,g=m,c=8,n=s
iti	iti	pos=i
vaktum	vac	pos=vi
samarTo	samarTa	pos=a,g=m,c=1,n=s
'pi	api	pos=i
na	na	pos=i
vakti	vac	pos=v,p=3,n=s,l=lat
kaScid	kaScit	pos=n,g=m,c=1,n=s
aho	aho	pos=i
janAnAm	jana	pos=n,g=m,c=6,n=p
vyasanAni	vyasana	pos=n,g=n,c=2,n=p
mokze	mokza	pos=n,g=m,c=7,n=s

# id = KMuk.15
kzIrasAgara	kzIrasAgara	pos=n,comp=y
taraNga	taraMga	pos=n,comp=y
SIkara	SIkara	pos=n,comp=y
AsAra	AsAra	pos=n,comp=y
tArakita	tArakita	pos=a,comp=y
cAru	cAru	pos=a,comp=y
mUrtaye	mUrti	pos=n,g=m,c=4,n=s
Bogi	Bogin	pos=n,comp=y
Boga	Boga	pos=n,comp=y
SayanIya	SayanIya	pos=n,comp=y
SAyine	SAyin	pos=a,g=m,c=4,n=s
mADavAya	mADava	pos=n,g=m,c=4,n=s
maDuvidvize	maDuvidviz	pos=n,g=m,c=4,n=s
namaH	namas	pos=n,g=n,c=1,n=s

# id = KMuk.16
vAtsalyAt	vAtsalya	pos=n,g=n,c=5,n=s
aBaya	aBaya	pos=n,comp=y
pradAna	pradAna	pos=n,comp=y
samayAt	samaya	pos=n,g=m,c=5,n=s
Arta	Arta	pos=a,comp=y
Arti	Arti	pos=n,comp=y
nirvApaRAt	nirvApaRa	pos=n,g=n,c=5,n=s
OdAryAt	OdArya	pos=n,g=n,c=5,n=s
aGa	aGa	pos=n,comp=y
SozaRAt	SozaRa	pos=n,g=n,c=5,n=s
a	a	pos=i
gaRay	gaRay	pos=va,comp=y,f=part
SreyaH	Sreyas	pos=a,comp=y
pada	pada	pos=n,comp=y
prApaRAt	prApaRa	pos=n,g=n,c=5,n=s
sevyaH	sev	pos=va,g=m,c=1,n=s,f=krtya
SrIpati	SrIpati	pos=n,g=m,c=1,n=s
eva	eva	pos=i
sarva	sarva	pos=n,comp=y
jagatAm	jagant	pos=n,g=n,c=6,n=p
ekAntataH	ekAntataH	pos=i
sAkziRaH	sAkzin	pos=n,g=m,c=1,n=p
prahlAdaH	prahlAda	pos=n,g=m,c=1,n=s
ca	ca	pos=i
viBIzaRaH	viBIzaRa	pos=n,g=m,c=1,n=s
ca	ca	pos=i
kari	karin	pos=n,comp=y
rAj	rAj	pos=n,g=m,c=1,n=s
pAYcAlI	pAYcAlI	pos=n,g=f,c=1,n=s
ahalyA	ahalyA	pos=n,g=f,c=1,n=s
DruvaH	Druva	pos=n,g=m,c=1,n=s

# id = KMuk.17
nATe	nATa	pos=n,g=m,c=7,n=s
SrI	SrI	pos=n,comp=y
puruzottame	puruzottama	pos=n,g=m,c=7,n=s
tri	tri	pos=n,comp=y
jagatAm	jagant	pos=n,g=n,c=6,n=p
eka	eka	pos=n,comp=y
aDipe	aDipa	pos=n,g=m,c=7,n=s
cetasA	cetas	pos=n,g=n,c=3,n=s
sevye	sev	pos=va,g=m,c=7,n=s,f=krtya
svasya	sva	pos=a,g=n,c=6,n=s
padasya	pada	pos=n,g=n,c=6,n=s
dAtari	dAtf	pos=a,g=m,c=7,n=s
pare	para	pos=n,g=m,c=7,n=s
nArAyaRe	nArAyaRa	pos=n,g=m,c=7,n=s
tizWati	sTA	pos=va,g=m,c=7,n=s,f=part
yam	yad	pos=n,g=m,c=2,n=s
kaMcid	kaScit	pos=n,g=m,c=2,n=s
puruza	puruza	pos=n,comp=y
aDamam	aDama	pos=a,g=m,c=2,n=s
katipaya	katipaya	pos=a,comp=y
grAma	grAma	pos=n,comp=y
ISam	ISa	pos=n,g=m,c=2,n=s
alpAt	alpa	pos=a,g=m,c=5,n=s
arTa	arTa	pos=n,comp=y
dam	da	pos=a,g=m,c=2,n=s
sevAyE	sevA	pos=n,g=f,c=4,n=s
mfgayAmahe	mfgay	pos=v,p=1,n=p,l=lat
naram	nara	pos=n,g=m,c=2,n=s
aho	aho	pos=i
mUQA	muh	pos=va,g=m,c=1,n=p,f=part
varAkA	varAka	pos=a,g=m,c=1,n=p
vayam	mad	pos=n,g=,c=1,n=p

# id = KMuk.18
Bo	Bo	pos=i
lokAH	loka	pos=n,g=m,c=8,n=p
SfRuta	Sru	pos=v,p=2,n=p,l=lot
prasUti	prasUti	pos=n,comp=y
maraRa	maraRa	pos=n,comp=y
vyADeH	vyADi	pos=n,g=m,c=6,n=s
cikitsAm	cikitsA	pos=n,g=f,c=2,n=s
imAm	idam	pos=n,g=f,c=2,n=s
yoga	yoga	pos=n,comp=y
jYAH	jYa	pos=a,g=m,c=1,n=p
samudAharanti	samudAhf	pos=v,p=3,n=p,l=lat
munayo	muni	pos=n,g=m,c=1,n=p
yAm	yad	pos=n,g=f,c=2,n=s
yAjYavalkya	yAjYavalkya	pos=n,comp=y
AdayaH	Adi	pos=n,g=m,c=1,n=p
antaH	antar	pos=i
jyotiH	jyotis	pos=n,g=n,c=1,n=s
ameyam	ameya	pos=a,g=n,c=1,n=s
ekam	eka	pos=n,g=n,c=1,n=s
amftam	amfta	pos=n,g=n,c=1,n=s
kfzRa	kfzRa	pos=n,comp=y
AKyam	AKyA	pos=n,g=n,c=1,n=s
ApIyatAm	ApA	pos=v,p=3,n=s,l=lot
yat	yad	pos=n,g=n,c=1,n=s
pItam	pA	pos=va,g=n,c=1,n=s,f=part
parama	parama	pos=a,comp=y
OzaDam	OzaDa	pos=n,g=n,c=1,n=s
vitanute	vitan	pos=v,p=3,n=s,l=lat
nirvARam	nirvARa	pos=n,g=n,c=2,n=s
Atyantikam	Atyantika	pos=a,g=n,c=2,n=s

# id = KMuk.19
badDena	banD	pos=va,g=m,c=3,n=s,f=part
aYjalinA	aYjali	pos=n,g=m,c=3,n=s
natena	nam	pos=va,g=n,c=3,n=s,f=part
SirasA	Siras	pos=n,g=n,c=3,n=s
gAtrEH	gAtra	pos=n,g=n,c=3,n=p
sa	sa	pos=i
roma	roman	pos=n,comp=y
udgamEH	udgama	pos=n,g=n,c=3,n=p
kaRWena	kaRWa	pos=n,g=m,c=3,n=s
sa	sa	pos=i
vara	vara	pos=a,comp=y
gadgadena	gadgada	pos=a,g=m,c=3,n=s
nayanena	nayana	pos=n,g=n,c=3,n=s
udgf	udgf	pos=va,comp=y,f=part
bAzpa	bAzpa	pos=n,comp=y
ambunA	ambu	pos=n,g=n,c=3,n=s
nityam	nityam	pos=i
tvad	tvad	pos=n,comp=y
caraRa	caraRa	pos=n,comp=y
aravinda	aravinda	pos=n,comp=y
yugala	yugala	pos=n,comp=y
DyAna	DyAna	pos=n,comp=y
amfta	amfta	pos=n,comp=y
AsvAdin	AsvAdin	pos=a,g=m,c=6,n=p
asmAkam	mad	pos=n,g=,c=6,n=p
sarasIruha	sarasIruha	pos=n,comp=y
akza	akza	pos=n,g=m,c=8,n=s
satatam	satatam	pos=i
saMpadyatAm	sampad	pos=v,p=3,n=s,l=lot
jIvitam	jIvita	pos=n,g=n,c=1,n=s

# id = KMuk.20
tattvam	tattva	pos=n,g=n,c=2,n=s
bruvARAni	brU	pos=va,g=n,c=1,n=p,f=part
param	para	pos=n,g=n,c=2,n=s
parasmAt	para	pos=n,g=n,c=5,n=s
aho	aho	pos=i
kzaranti	kzar	pos=v,p=3,n=p,l=lat
iva	iva	pos=i
suDAm	suDA	pos=n,g=f,c=2,n=s
padAni	pada	pos=n,g=n,c=1,n=p
Avartaya	Avartay	pos=v,p=2,n=s,l=lot
prAYjaliH	prAYjali	pos=a,g=m,c=1,n=s
asmi	as	pos=v,p=1,n=s,l=lat
jihve	jihvA	pos=n,g=f,c=8,n=s
nAmAni	nAman	pos=n,g=n,c=2,n=p
nArAyaRa	nArAyaRa	pos=n,comp=y
gocarAni	gocara	pos=a,g=n,c=2,n=p

# id = KMuk.21
idam	idam	pos=n,g=n,c=1,n=s
SarIram	SarIra	pos=n,g=n,c=1,n=s
pariRAma	pariRAma	pos=n,comp=y
peSalam	peSala	pos=a,g=n,c=1,n=s
patati	pat	pos=v,p=3,n=s,l=lat
avaSyam	avaSyam	pos=i
SlaTa	SlaTa	pos=a,comp=y
saMDi	saMDi	pos=n,g=n,c=1,n=s
jarjaram	jarjara	pos=a,g=n,c=1,n=s
kim	kim	pos=i
OzaDEH	OzaDa	pos=n,g=n,c=3,n=p
kliSyasi	kliS	pos=v,p=2,n=s,l=lat
mUQa	muh	pos=va,g=m,c=8,n=s,f=part
durmate	durmati	pos=a,g=m,c=8,n=s
nirAmayam	nirAmaya	pos=a,g=n,c=2,n=s
kfzRa	kfzRa	pos=n,comp=y
rasAyanam	rasAyana	pos=n,g=n,c=2,n=s
piba	pA	pos=v,p=2,n=s,l=lot

# id = KMuk.22
SrImat	SrImat	pos=a,comp=y
nAma	nAman	pos=n,g=n,c=2,n=s
procya	pravac	pos=vi
nArAyaRa	nArAyaRa	pos=n,comp=y
AKyam	AKyA	pos=n,g=n,c=2,n=s
yena	yad	pos=n,g=n,c=3,n=s
prAptA	prAp	pos=va,g=m,c=1,n=p,f=part
vAYCitam	vAYCita	pos=n,g=n,c=2,n=s
pApino	pApin	pos=a,g=m,c=1,n=p
'pi	api	pos=i
hA	hA	pos=i
naH	mad	pos=n,g=,c=6,n=p
pUrvam	pUrvam	pos=i
vAc	vAc	pos=n,g=f,c=1,n=s
pravfttA	pravft	pos=va,g=f,c=1,n=s,f=part
na	na	pos=i
tasmin	tad	pos=n,g=m,c=7,n=s
tena	tad	pos=n,g=m,c=3,n=s
prAptam	prAp	pos=va,g=n,c=1,n=s,f=part
garBa	garBa	pos=n,comp=y
vAsa	vAsa	pos=n,comp=y
Adi	Adi	pos=n,comp=y
duHKam	duHKa	pos=n,g=n,c=1,n=s

# id = KMuk.23
mA	mA	pos=i
drAkzam	dfS	pos=v,p=1,n=s,l=lun_unaug
kzIRa	kzi	pos=va,comp=y,f=part
puRyAn	puRya	pos=n,g=m,c=2,n=p
kzaRam	kzaRa	pos=n,g=m,c=2,n=s
api	api	pos=i
Bavato	Bavat	pos=a,g=m,c=2,n=p
Bakti	Bakti	pos=n,comp=y
hAtAn	hA	pos=va,g=m,c=2,n=p,f=part
pada	pada	pos=n,comp=y
abje	abja	pos=n,g=n,c=7,n=s
mA	mA	pos=i
SrOzam	Sru	pos=v,p=1,n=s,l=lun_unaug
SravaRIya	Sru	pos=va,comp=y,f=krtya
badDam	banD	pos=va,g=n,c=2,n=s,f=part
tava	tvad	pos=n,g=,c=6,n=s
caritam	carita	pos=n,g=n,c=2,n=s
apAsya	apAs	pos=vi
anyat	anya	pos=n,g=n,c=2,n=s
AKyAna	AKyAna	pos=n,comp=y
jAtam	jAta	pos=n,g=n,c=2,n=s
mA	mA	pos=i
sprAkzam	spfS	pos=v,p=1,n=s,l=lun_unaug
mADava	mADava	pos=n,g=m,c=8,n=s
tvA	tvad	pos=n,g=,c=2,n=s
api	api	pos=i
Buvana	Buvana	pos=n,comp=y
pate	pati	pos=n,g=m,c=8,n=s
cetasA	cetas	pos=n,g=n,c=3,n=s
apahnu	apahnu	pos=va,g=m,c=2,n=s,f=part
mA	mA	pos=i
BUvam	BU	pos=v,p=1,n=s,l=lun_unaug
tvad	tvad	pos=n,comp=y
saparyA	saparyA	pos=n,comp=y
vyatikara	vyatikara	pos=n,comp=y
rahitaH	rahita	pos=a,g=m,c=1,n=s
janma	janman	pos=n,comp=y
janma	janman	pos=n,comp=y
antare	antara	pos=n,g=n,c=7,n=s
'pi	api	pos=i

# id = KMuk.24
madana	madana	pos=n,g=m,c=8,n=s
parihara	parihf	pos=v,p=2,n=s,l=lot
sTitim	sTiti	pos=n,g=f,c=2,n=s
madIye	madIya	pos=a,g=n,c=7,n=s
manasi	manas	pos=n,g=n,c=7,n=s
mukunda	mukunda	pos=n,comp=y
pada	pada	pos=n,comp=y
aravinda	aravinda	pos=n,comp=y
DAmani	DAman	pos=n,g=n,c=7,n=s
hara	hara	pos=n,comp=y
nayana	nayana	pos=n,comp=y
kfSAnunA	kfSAnu	pos=n,g=m,c=3,n=s
kfSo	kfSa	pos=a,g=m,c=1,n=s
'si	as	pos=v,p=2,n=s,l=lat
smarasi	smf	pos=v,p=2,n=s,l=lat
na	na	pos=i
cakra	cakra	pos=n,comp=y
parAkramam	parAkrama	pos=n,g=m,c=2,n=s
murAreH	murAri	pos=n,g=m,c=6,n=s

# id = KMuk.25
dArA	dAra	pos=n,g=m,c=1,n=p
vAra	vAra	pos=n,comp=y
Akara	Akara	pos=n,comp=y
vara	vara	pos=a,comp=y
sutA	sutA	pos=n,g=f,c=1,n=s
te	tvad	pos=n,g=,c=6,n=s
aNga	aNga	pos=n,comp=y
jaH	ja	pos=a,g=m,c=1,n=s
'yam	idam	pos=n,g=m,c=1,n=s
viriYcaH	viriYca	pos=n,g=m,c=1,n=s
stotA	stotf	pos=a,g=m,c=1,n=s
vedaH	veda	pos=n,g=m,c=1,n=s
te	tvad	pos=n,g=,c=6,n=s
sura	sura	pos=n,comp=y
gaRaH	gaRa	pos=n,g=m,c=1,n=s
Bftya	Bftya	pos=n,comp=y
vargaH	varga	pos=n,g=m,c=1,n=s
prasAdaH	prasAda	pos=n,g=m,c=1,n=s
muktiH	mukti	pos=n,g=f,c=1,n=s
maDye	maDya	pos=n,g=n,c=7,n=s
jagat	jagant	pos=n,g=n,c=1,n=s
avikalam	avikala	pos=a,g=n,c=1,n=s
tAvake	tAvaka	pos=a,g=m,c=7,n=s
devakI	devakI	pos=n,g=f,c=1,n=s
te	tvad	pos=n,g=,c=6,n=s
mAtA	mAtf	pos=n,g=f,c=1,n=s
mitram	mitra	pos=n,g=n,c=1,n=s
bala	bala	pos=n,comp=y
ripu	ripu	pos=n,comp=y
sutaH	suta	pos=n,g=m,c=1,n=s
tattvataH	tattva	pos=n,g=n,c=5,n=s
anyat	anya	pos=n,g=n,c=2,n=s
na	na	pos=i
jAne	jYA	pos=v,p=1,n=s,l=lat

# id = KMuk.26
jihve	jihvA	pos=n,g=f,c=8,n=s
kIrtaya	kIrtay	pos=v,p=2,n=s,l=lot
keSavam	keSava	pos=n,g=m,c=2,n=s
muraripum	muraripu	pos=n,g=m,c=2,n=s
ceto	cetas	pos=n,g=n,c=8,n=s
Baja	Baj	pos=v,p=2,n=s,l=lot
SrIDaram	SrIDara	pos=n,g=m,c=2,n=s
pARi	pARi	pos=n,comp=y
dvaMdvEH	dvaMdva	pos=n,g=m,c=8,n=s
samarcaya	samarcay	pos=v,p=2,n=s,l=lot
acyuta	acyuta	pos=n,comp=y
kaTAm	kaTA	pos=n,g=f,c=2,n=s
Srotra	Srotra	pos=n,comp=y
dvayEH	dvaya	pos=n,g=m,c=8,n=s
tvam	tvad	pos=n,g=,c=1,n=s
SfRu	Sru	pos=v,p=2,n=s,l=lot
kfzRam	kfzRa	pos=n,g=m,c=2,n=s
lokaya	lokay	pos=v,p=2,n=s,l=lot
locana	locana	pos=n,comp=y
dvayEH	dvaya	pos=n,g=m,c=8,n=s
hareH	hf	pos=v,p=2,n=s,l=vidhilin
gacCa	gam	pos=v,p=2,n=s,l=lot
aNGri	aNGri	pos=n,comp=y
yugma	yugma	pos=n,comp=y
Alayam	Alaya	pos=n,g=m,c=2,n=s
jiGra	GrA	pos=v,p=2,n=s,l=lot
GrARa	GrARa	pos=n,g=m,c=8,n=s
mukunda	mukunda	pos=n,comp=y
pAda	pAda	pos=n,comp=y
tulasIm	tulasI	pos=n,g=f,c=2,n=s
mUrDan	mUrDan	pos=n,g=m,c=8,n=s
nama	nam	pos=v,p=2,n=s,l=lot
aDokzajam	aDokzaja	pos=n,g=m,c=2,n=s

# id = KMuk.27
yat	yad	pos=n,g=n,c=1,n=s
kfzRa	kfzRa	pos=n,comp=y
praRipAta	praRipAta	pos=n,comp=y
DUli	DUli	pos=n,comp=y
Davalam	Davala	pos=a,g=n,c=1,n=s
tat	tad	pos=n,g=n,c=1,n=s
vE	vE	pos=i
SiraH	Siras	pos=n,g=n,c=1,n=s
syAt	as	pos=v,p=3,n=s,l=vidhilin
SuBam	SuBa	pos=a,g=n,c=1,n=s
te	tad	pos=n,g=n,c=1,n=d
netre	netra	pos=n,g=n,c=1,n=d
tamasA	tamas	pos=n,g=n,c=3,n=s
ujJite	ujJita	pos=a,g=n,c=1,n=d
su	su	pos=i
rucire	rucira	pos=a,g=n,c=1,n=d
yAByAm	yad	pos=n,g=n,c=3,n=d
hariH	hari	pos=n,g=m,c=1,n=s
dfSyate	dfS	pos=v,p=3,n=s,l=lat
sA	tad	pos=n,g=f,c=1,n=s
budDiH	budDi	pos=n,g=f,c=1,n=s
niyamEH	niyama	pos=n,g=m,c=3,n=p
yamEH	yama	pos=n,g=m,c=3,n=p
ca	ca	pos=i
vimalA	vimala	pos=a,g=f,c=1,n=s
yA	yad	pos=n,g=f,c=1,n=s
mADava	mADava	pos=n,comp=y
DyAyin	DyAyin	pos=a,g=f,c=1,n=s
sA	tad	pos=n,g=f,c=1,n=s
jihvA	jihvA	pos=n,g=f,c=1,n=s
amfta	amfta	pos=n,comp=y
varziRI	varzin	pos=a,g=f,c=1,n=s
pratipadam	pratipad	pos=n,g=f,c=2,n=s
yA	yad	pos=n,g=f,c=1,n=s
stOti	stu	pos=v,p=3,n=s,l=lat
nArAyaRam	nArAyaRa	pos=n,g=m,c=2,n=s

# id = KMuk.28
Bakta	Bakta	pos=n,comp=y
dvezin	dvezin	pos=a,comp=y
BujaNga	BujaMga	pos=n,comp=y
gAruqa	gAruqa	pos=n,comp=y
maRiH	maRi	pos=n,g=m,c=1,n=s
trElokya	trElokya	pos=n,comp=y
rakzA	rakzA	pos=n,comp=y
maRiH	maRi	pos=n,g=m,c=1,n=s
gopI	gopI	pos=n,comp=y
locana	locana	pos=n,comp=y
cAtaka	cAtaka	pos=n,comp=y
ambuda	ambuda	pos=n,comp=y
maRiH	maRi	pos=n,g=m,c=1,n=s
sOndarya	sOndarya	pos=n,comp=y
mudrA	mudrA	pos=n,comp=y
maRiH	maRi	pos=n,g=m,c=1,n=s
SrI	SrI	pos=n,comp=y
kAntA	kAntA	pos=n,comp=y
maRi	maRi	pos=n,comp=y
rukmiRI	rukmiRI	pos=n,comp=y
Gana	Gana	pos=a,comp=y
kuca	kuca	pos=n,comp=y
dvandva	dvaMdva	pos=n,comp=y
eka	eka	pos=n,comp=y
BUzA	BUzA	pos=n,comp=y
maRiH	maRi	pos=n,g=m,c=1,n=s
Sreyo	Sreyas	pos=n,g=n,c=1,n=s
DyA	DyA	pos=va,comp=y,f=krtya
SiKAm	SiKA	pos=n,g=f,c=2,n=s
nirdiSatu	nirdiS	pos=v,p=3,n=s,l=lot
no	mad	pos=n,g=,c=6,n=p
gopAla	gopAla	pos=n,comp=y
cUqAmaRiH	cUqAmaRi	pos=n,g=m,c=1,n=s

# id = KMuk.29
Satru	Satru	pos=n,comp=y
Ceda	Ceda	pos=n,comp=y
eka	eka	pos=n,comp=y
mantram	mantra	pos=n,g=m,c=2,n=s
sakalam	sakala	pos=a,g=m,c=2,n=s
upanizad	upanizad	pos=n,comp=y
vAkya	vAkya	pos=n,comp=y
sampUjay	sampUjay	pos=va,comp=y,f=krtya
mantram	mantra	pos=n,g=m,c=2,n=s
saMsAra	saMsAra	pos=n,comp=y
uttAra	uttAra	pos=n,comp=y
mantram	mantra	pos=n,g=m,c=2,n=s
samudi	samudi	pos=va,comp=y,f=part
manasAm	manas	pos=n,g=m,c=6,n=p
saNga	saNga	pos=n,comp=y
niryARa	niryARa	pos=n,comp=y
mantram	mantra	pos=n,g=m,c=2,n=s
sarva	sarva	pos=n,comp=y
ESvarya	ESvarya	pos=n,comp=y
eka	eka	pos=n,comp=y
mantram	mantra	pos=n,g=m,c=2,n=s
vyasana	vyasana	pos=n,comp=y
Bujaga	Bujaga	pos=n,comp=y
saMdazwa	saMdaMS	pos=va,comp=y,f=part
saMtrARa	saMtrARa	pos=n,comp=y
mantram	mantra	pos=n,g=m,c=2,n=s
jihve	jihvA	pos=n,g=f,c=8,n=s
SrI	SrI	pos=n,comp=y
kfzRa	kfzRa	pos=n,comp=y
mantram	mantra	pos=n,g=m,c=2,n=s
japa	jap	pos=v,p=2,n=s,l=lot
japa	jap	pos=v,p=2,n=s,l=lot
satatam	satatam	pos=i
janma	janman	pos=n,comp=y
sAPalya	sAPalya	pos=n,comp=y
mantram	mantra	pos=n,g=m,c=2,n=s

# id = KMuk.30
vyAmoha	vyAmoha	pos=n,comp=y
uddalana	uddalana	pos=n,comp=y
OzaDam	OzaDa	pos=n,g=n,c=2,n=s
muni	muni	pos=n,comp=y
manaH	manas	pos=n,comp=y
vftti	vftti	pos=n,comp=y
pravftti	pravftti	pos=n,comp=y
OzaDam	OzaDa	pos=n,g=n,c=2,n=s
dEtya	dEtya	pos=n,comp=y
anarTa	anarTa	pos=n,comp=y
kara	kara	pos=a,comp=y
OzaDam	OzaDa	pos=n,g=n,c=2,n=s
trijagatAm	trijagant	pos=n,g=n,c=6,n=p
saMjIvana	saMjIvana	pos=n,comp=y
eka	eka	pos=n,comp=y
OzaDam	OzaDa	pos=n,g=n,c=2,n=s
Bakta	Bakta	pos=n,comp=y
Arti	Arti	pos=n,comp=y
praSama	praSama	pos=n,comp=y
OzaDam	OzaDa	pos=n,g=n,c=2,n=s
Bava	Bava	pos=n,comp=y
Baya	Baya	pos=n,comp=y
praDvaMsin	praDvaMsin	pos=a,g=n,c=2,n=s
divya	divya	pos=a,comp=y
OzaDam	OzaDa	pos=n,g=n,c=2,n=s
SreyaH	Sreyas	pos=n,comp=y
prApti	prApti	pos=n,comp=y
kara	kara	pos=a,comp=y
OzaDam	OzaDa	pos=n,g=n,c=2,n=s
piba	pA	pos=v,p=2,n=s,l=lot
manaH	manas	pos=n,g=n,c=8,n=s
SrI	SrI	pos=n,comp=y
kfzRa	kfzRa	pos=n,comp=y
nAma	nAman	pos=n,comp=y
OzaDam	OzaDa	pos=n,g=n,c=2,n=s

# id = KMuk.31
AScaryam	AScarya	pos=n,g=n,c=1,n=s
etat	etad	pos=n,g=n,c=1,n=s
hi	hi	pos=i
manuzya	manuzya	pos=n,comp=y
loke	loka	pos=n,g=m,c=7,n=s
suDAm	suDA	pos=n,g=f,c=2,n=s
parityajya	parityaj	pos=vi
vizam	viza	pos=n,g=n,c=2,n=s
pibanti	pA	pos=v,p=3,n=p,l=lat
nAmAni	nAman	pos=n,g=n,c=2,n=p
nArAyaRa	nArAyaRa	pos=n,comp=y
gocarAni	gocara	pos=a,g=n,c=2,n=p
tyaktvA	tyaj	pos=vi
anya	anya	pos=n,comp=y
vAcaH	vAc	pos=n,g=f,c=2,n=p
kuhakAH	kuhaka	pos=n,g=m,c=1,n=p
paWanti	paW	pos=v,p=3,n=p,l=lat

# id = KMuk.32
lAwI	lAwI	pos=n,comp=y
netra	netra	pos=n,comp=y
puwI	puwI	pos=n,comp=y
payoDara	payoDara	pos=n,comp=y
GawI	GawI	pos=n,comp=y
revA	revA	pos=n,comp=y
tawI	tawI	pos=n,comp=y
duzkuwI	duzkuwI	pos=n,comp=y
pAwIra	pAwIra	pos=n,comp=y
druma	druma	pos=n,comp=y
varRanena	varRana	pos=n,g=n,c=3,n=s
kaviBiH	kavi	pos=n,g=m,c=3,n=p
mUQEH	muh	pos=va,g=m,c=3,n=p,f=part
dinam	dina	pos=n,g=n,c=1,n=s
nIyate	nI	pos=v,p=3,n=s,l=lat
govinda	govinda	pos=n,g=m,c=8,n=s
iti	iti	pos=i
janArdana	janArdana	pos=n,g=m,c=8,n=s
iti	iti	pos=i
jagatAm	jagant	pos=n,g=n,c=6,n=p
nATa	nATa	pos=n,g=m,c=8,n=s
iti	iti	pos=i
kfzRa	kfzRa	pos=n,g=m,c=8,n=s
iti	iti	pos=i
ca	ca	pos=i
vyAhArEH	vyAhAra	pos=n,g=m,c=3,n=p
samayaH	samaya	pos=n,g=m,c=1,n=s
tad	tad	pos=n,comp=y
ekamanas	ekamanas	pos=a,g=m,c=6,n=p
puMsAm	puMs	pos=n,g=m,c=6,n=p
atikrAmati	atikram	pos=v,p=3,n=s,l=lat

# id = KMuk.33
a	a	pos=i
yAc	yAc	pos=va,g=n,c=1,n=s,f=krtya
a	a	pos=i
krI	krI	pos=va,g=n,c=1,n=s,f=krtya
a	a	pos=i
yAtayAmam	yAtayAma	pos=a,g=n,c=1,n=s
a	a	pos=i
paktavyam	pac	pos=va,g=n,c=1,n=s,f=krtya
akzayyam	akzayya	pos=a,g=n,c=1,n=s
a	a	pos=i
durBaram	durBara	pos=a,g=n,c=1,n=s
me	mad	pos=n,g=,c=6,n=s
asti	as	pos=v,p=3,n=s,l=lat
eva	eva	pos=i
pATeyam	pATeya	pos=n,g=n,c=1,n=s
itas	itas	pos=i
prayARe	prayARa	pos=n,g=n,c=7,n=s
SrI	SrI	pos=n,comp=y
kfzRa	kfzRa	pos=n,comp=y
nAma	nAman	pos=n,comp=y
mfta	mf	pos=va,comp=y,f=part
BAgaDeyam	BAgaDeya	pos=n,g=n,c=1,n=s

# id = KMuk.34
yasya	yad	pos=n,g=m,c=6,n=s
priyO	priya	pos=a,g=m,c=1,n=d
SrutaDarO	SrutaDara	pos=a,g=m,c=1,n=d
kavi	kavi	pos=n,comp=y
loka	loka	pos=n,comp=y
gItO	gA	pos=va,g=m,c=1,n=d,f=part
mitre	mitra	pos=n,g=n,c=7,n=s
dvijanman	dvijanman	pos=n,comp=y
parivAra	parivAra	pos=n,comp=y
Siva	Siva	pos=n,comp=y
avaBUtAm	avaBU	pos=va,g=f,c=2,n=s,f=part
tena	tad	pos=n,g=m,c=3,n=s
ambuja	ambuja	pos=n,comp=y
akza	akza	pos=n,comp=y
caraRa	caraRa	pos=n,comp=y
ambuja	ambuja	pos=n,comp=y
zawpadena	zawpada	pos=n,g=m,c=3,n=s
rAjYA	rAjan	pos=n,g=m,c=3,n=s
kftA	kf	pos=va,g=f,c=1,n=s,f=part
stutiH	stuti	pos=n,g=f,c=1,n=s
iyam	idam	pos=n,g=f,c=1,n=s
kulaSeKareRa	kulaSeKara	pos=n,g=m,c=3,n=s

