# id = Rtu.1.1
pracaRqa	pracaRqa	pos=a,comp=y
sUryaH	sUrya	pos=n,g=m,c=1,n=s
spfhaRIya	spfh	pos=va,comp=y,f=krtya
candramAH	candramas	pos=n,g=m,c=1,n=s
sadA	sadA	pos=i
avagAha	avagAha	pos=n,comp=y
kzata	kzan	pos=va,comp=y,f=part
vAri	vAri	pos=n,comp=y
saMcayaH	saMcaya	pos=n,g=m,c=1,n=s
dina	dina	pos=n,comp=y
anta	anta	pos=n,comp=y
ramyaH	ramya	pos=a,g=m,c=1,n=s
aByupaSam	aByupaSam	pos=va,comp=y,f=part
manmaTaH	manmaTa	pos=n,g=m,c=1,n=s
nidAGa	nidAGa	pos=n,comp=y
kAlaH	kAla	pos=n,g=m,c=1,n=s
ayam	idam	pos=n,g=m,c=1,n=s
upAgataH	upAgam	pos=va,g=m,c=1,n=s,f=part
priye	priya	pos=a,g=f,c=8,n=s

# id = Rtu.1.2
niSAH	niSA	pos=n,g=f,c=1,n=p
SaSANka	SaSANka	pos=n,comp=y
kzata	kzan	pos=va,comp=y,f=part
nIlarAjyaH	nIlarAji	pos=n,g=f,c=1,n=p
kvacid	kvacid	pos=i
vicitram	vicitra	pos=a,g=n,c=1,n=s
jalayantra	jalayantra	pos=n,comp=y
mandiram	mandira	pos=n,g=n,c=1,n=s
maRi	maRi	pos=n,comp=y
prakArAH	prakAra	pos=n,g=f,c=1,n=p
sarasam	sarasa	pos=a,g=n,c=1,n=s
ca	ca	pos=i
candanam	candana	pos=n,g=n,c=1,n=s
SucO	Suci	pos=n,g=m,c=7,n=s
priye	priya	pos=a,g=f,c=8,n=s
yAnti	yA	pos=v,p=3,n=p,l=lat
janasya	jana	pos=n,g=m,c=6,n=s
sevyatAm	sevyatA	pos=n,g=f,c=2,n=s

# id = Rtu.1.3
su	su	pos=i
vAsitam	vAsay	pos=va,g=n,c=1,n=s,f=part
harmya	harmya	pos=n,comp=y
talam	tala	pos=n,g=n,c=1,n=s
manoharam	manohara	pos=a,g=n,c=1,n=s
priyA	priyA	pos=n,comp=y
muKa	muKa	pos=n,comp=y
ucCvAsa	ucCvAsa	pos=n,comp=y
vikampitam	vikampay	pos=va,g=n,c=1,n=s,f=part
maDu	maDu	pos=n,g=n,c=1,n=s
sutantri	sutantri	pos=a,comp=y
gItam	gA	pos=va,g=n,c=2,n=s,f=part
madanasya	madana	pos=n,g=m,c=6,n=s
dIpanam	dIpana	pos=n,g=n,c=2,n=s
SucO	Suci	pos=a,g=m,c=7,n=s
niSITe	niSITa	pos=n,g=m,c=7,n=s
anuBavanti	anuBU	pos=v,p=3,n=p,l=lat
kAminaH	kAmin	pos=n,g=m,c=1,n=p

# id = Rtu.1.4
nitamba	nitamba	pos=n,comp=y
bimbEH	bimba	pos=n,g=m,c=3,n=p
sadukUla	sadukUla	pos=a,comp=y
meKalA	meKalA	pos=n,g=n,c=3,n=p
stanEH	stana	pos=n,g=n,c=3,n=p
sahAra	sahAra	pos=a,comp=y
ABaraREH	ABaraRa	pos=n,g=n,c=3,n=p
sacandanEH	sacandana	pos=a,g=n,c=3,n=p
SiroruhEH	Siroruha	pos=n,g=m,c=3,n=p
snAna	snAna	pos=n,comp=y
kazAya	kazAya	pos=a,comp=y
vAsitEH	vAsay	pos=va,g=m,c=3,n=p,f=part
striyo	strI	pos=n,g=f,c=1,n=p
nidAGam	nidAGa	pos=n,g=m,c=2,n=s
Samayanti	Samay	pos=v,p=3,n=p,l=lat
kAminAm	kAmin	pos=n,g=m,c=6,n=p

# id = Rtu.1.5
nitAnta	nitAnta	pos=a,comp=y
lAkzA	lAkzA	pos=n,comp=y
rasa	rasa	pos=n,comp=y
rAga	rAga	pos=n,comp=y
raYjitEH	raYjay	pos=va,g=m,c=3,n=p,f=part
nitambinInAm	nitambinI	pos=n,g=f,c=6,n=p
caraREH	caraRa	pos=n,g=m,c=3,n=p
sanUpurEH	sanUpura	pos=a,g=m,c=3,n=p
pade	pada	pos=n,g=m,c=7,n=s
pade	pada	pos=n,g=m,c=7,n=s
haMsa	haMsa	pos=n,comp=y
ruta	ruta	pos=n,comp=y
anukAriBiH	anukArin	pos=a,g=m,c=3,n=p
janasya	jana	pos=n,g=m,c=6,n=s
cittam	citta	pos=n,g=n,c=1,n=s
kriyate	kf	pos=v,p=3,n=s,l=lat
sa	sa	pos=i
manmaTam	manmaTa	pos=n,g=n,c=1,n=s

# id = Rtu.1.6
payoDarAH	payoDara	pos=n,g=m,c=1,n=p
candana	candana	pos=n,comp=y
paNka	paNka	pos=n,comp=y
carcitAH	carcay	pos=va,g=m,c=1,n=p,f=part
tuzAragOra	tuzAragOra	pos=n,comp=y
arpita	arpay	pos=va,comp=y,f=part
hAra	hAra	pos=n,comp=y
SeKarAH	SeKara	pos=n,g=m,c=1,n=p
nitamba	nitamba	pos=n,comp=y
deSAH	deSa	pos=n,g=m,c=1,n=p
ca	ca	pos=i
sa	sa	pos=i
hema	heman	pos=n,comp=y
meKalA	meKalA	pos=n,g=m,c=1,n=p
prakurvate	prakf	pos=v,p=3,n=p,l=lat
kasya	ka	pos=n,g=m,c=6,n=s
mano	manas	pos=n,g=n,c=2,n=s
na	na	pos=i
sa	sa	pos=i
utsukam	utsuka	pos=a,g=m,c=2,n=s

# id = Rtu.1.7
samudgata	samudgam	pos=va,comp=y,f=part
sveda	sveda	pos=n,comp=y
cita	cita	pos=a,comp=y
aNga	aNga	pos=n,comp=y
saMDi	saMDi	pos=n,g=m,c=1,n=p
vimucya	vimuc	pos=vi
vAsAMsi	vAsas	pos=n,g=n,c=2,n=p
gurURi	guru	pos=a,g=n,c=2,n=p
sAmpratam	sAMpratam	pos=i
stanezu	stana	pos=n,g=n,c=7,n=p
tanu	tanu	pos=a,comp=y
aMSukam	aMSuka	pos=n,g=n,c=2,n=s
unnata	unnam	pos=va,comp=y,f=part
stanA	stana	pos=n,g=f,c=1,n=s
niveSayanti	niveSay	pos=v,p=3,n=p,l=lat
pramadAH	pramadA	pos=n,g=f,c=1,n=p
sayOvanAH	sayOvana	pos=a,g=f,c=1,n=p

# id = Rtu.1.8
sacandana	sacandana	pos=a,comp=y
ambu	ambu	pos=n,comp=y
vyajana	vyajana	pos=n,comp=y
udBava	udBava	pos=a,comp=y
anilEH	anila	pos=n,g=m,c=3,n=p
sahAra	sahAra	pos=a,comp=y
yazwi	yazwi	pos=n,comp=y
stana	stana	pos=n,comp=y
maRqalI	maRqala	pos=n,comp=y
arpaREH	arpaRa	pos=a,g=m,c=3,n=p
viboDyate	viboDay	pos=v,p=3,n=s,l=lat
supta	svap	pos=va,g=m,c=1,n=s,f=part
iva	iva	pos=i
adya	adya	pos=i
manmaTaH	manmaTa	pos=n,g=m,c=1,n=s

# id = Rtu.1.9
sitezu	sita	pos=a,g=n,c=7,n=p
harmyezu	harmya	pos=n,g=n,c=7,n=p
niSAsu	niSA	pos=n,g=f,c=7,n=p
yozitAm	yozit	pos=n,g=f,c=6,n=p
suKa	suKa	pos=n,comp=y
prasuptAni	prasvap	pos=va,g=n,c=2,n=p,f=part
muKAni	muKa	pos=n,g=n,c=2,n=p
candramAH	candramas	pos=n,g=m,c=1,n=s
vilokya	vilokay	pos=vi
nUnam	nUnam	pos=i
BfSam	BfSam	pos=i
utsukaH	utsuka	pos=a,g=m,c=1,n=s
ciram	ciram	pos=i
niSA	niSA	pos=n,comp=y
kzaye	kzaya	pos=n,g=m,c=7,n=s
yAti	yA	pos=v,p=3,n=s,l=lat
hriyA	hrI	pos=n,g=f,c=3,n=s
iva	iva	pos=i
pARqutAm	pARqutA	pos=n,g=f,c=2,n=s

# id = Rtu.1.10
asahya	asahya	pos=a,comp=y
vAta	vAta	pos=n,comp=y
udData	udDan	pos=va,comp=y,f=part
reRu	reRu	pos=n,comp=y
maRqalA	maRqala	pos=n,g=f,c=1,n=s
pracaRqa	pracaRqa	pos=a,comp=y
sUrya	sUrya	pos=n,comp=y
Atapa	Atapa	pos=n,comp=y
tApitA	tApay	pos=va,g=f,c=1,n=s,f=part
mahI	mahI	pos=n,g=f,c=1,n=s
na	na	pos=i
Sakyate	Sak	pos=v,p=3,n=s,l=lat
drazwum	dfS	pos=vi
api	api	pos=i
pravAsiBiH	pravAsin	pos=a,g=m,c=3,n=p
priyA	priyA	pos=n,comp=y
viyoga	viyoga	pos=n,comp=y
anala	anala	pos=n,comp=y
dagDa	dah	pos=va,comp=y,f=part
mAnasEH	mAnasa	pos=n,g=m,c=3,n=p

# id = Rtu.1.11
mfgAH	mfga	pos=n,g=m,c=1,n=p
pracaRqa	pracaRqa	pos=a,comp=y
Atapa	Atapa	pos=n,comp=y
tApitAH	tApay	pos=va,g=m,c=1,n=p,f=part
BfSam	BfSam	pos=i
tfzA	tfz	pos=n,g=f,c=3,n=s
mahatyA	mahat	pos=a,g=f,c=3,n=s
pariSuzka	pariSuzka	pos=n,comp=y
tAlavaH	tAlu	pos=n,g=m,c=1,n=p
vana	vana	pos=n,comp=y
antare	antara	pos=n,g=n,c=7,n=s
toyam	toya	pos=n,g=n,c=1,n=s
iti	iti	pos=i
praDAvitA	praDAv	pos=va,g=m,c=1,n=p,f=part
nirIkzya	nirIkzay	pos=vi
BinnAYjana	BinnAYjana	pos=n,comp=y
saMniBam	saMniBa	pos=a,g=n,c=2,n=s
naBaH	naBas	pos=n,g=n,c=2,n=s

# id = Rtu.1.12
sa	sa	pos=i
viBramEH	viBrama	pos=n,g=n,c=3,n=p
sa	sa	pos=i
smita	smita	pos=n,comp=y
jihma	jihma	pos=a,comp=y
vIkzitEH	vIkzita	pos=n,g=n,c=3,n=p
vilAsavatyo	vilAsavat	pos=a,g=f,c=1,n=p
manasi	manas	pos=n,g=n,c=7,n=s
pravAsinAm	pravAsin	pos=a,g=m,c=6,n=p
anaNga	anaNga	pos=n,comp=y
saMdIpanam	saMdIpana	pos=n,g=n,c=2,n=s
ASu	ASu	pos=a,g=n,c=2,n=s
kurvate	kf	pos=v,p=3,n=p,l=lat
yaTA	yaTA	pos=i
pradozAH	pradoza	pos=n,g=m,c=1,n=p
SaSi	SaSin	pos=n,comp=y
cAru	cAru	pos=a,comp=y
BUzaRAH	BUzaRa	pos=n,g=m,c=1,n=p

# id = Rtu.1.13
raveH	ravi	pos=n,g=m,c=6,n=s
mayUKEH	mayUKa	pos=n,g=m,c=3,n=p
aBitApito	aBitApay	pos=va,g=m,c=1,n=s,f=part
BfSam	BfSam	pos=i
vidahyamAnaH	vidah	pos=va,g=m,c=1,n=s,f=part
paTi	paTin	pos=n,g=m,c=7,n=s
tapta	tap	pos=va,comp=y,f=part
pAMsuBiH	pAMsu	pos=n,g=m,c=3,n=p
avANmuKo	avANmuKa	pos=a,g=m,c=1,n=s
jihma	jihma	pos=a,comp=y
gatiH	gati	pos=n,g=m,c=1,n=s
Svasat	Svas	pos=va,comp=y,f=part
muhuH	muhur	pos=i
PaRI	PaRin	pos=n,g=m,c=1,n=s
mayUrasya	mayUra	pos=n,g=m,c=6,n=s
tale	tala	pos=n,g=n,c=7,n=s
nizIdati	nizad	pos=v,p=3,n=s,l=lat

# id = Rtu.1.14
tfzA	tfz	pos=n,g=f,c=3,n=s
mahatyA	mahat	pos=a,g=f,c=3,n=s
hata	han	pos=va,comp=y,f=part
vikrama	vikrama	pos=n,comp=y
udyamaH	udyama	pos=n,g=m,c=1,n=s
Svasan	Svas	pos=va,g=m,c=1,n=s,f=part
muhuH	muhur	pos=i
dUra	dUra	pos=a,comp=y
vidArita	vidAray	pos=va,comp=y,f=part
AnanaH	Anana	pos=n,g=m,c=1,n=s
na	na	pos=i
hanti	han	pos=v,p=3,n=s,l=lat
adUre	adUra	pos=a,g=n,c=7,n=s
api	api	pos=i
gajAn	gaja	pos=n,g=m,c=2,n=p
mfgeSvaraH	mfgeSvara	pos=n,g=m,c=1,n=s
vilola	vilola	pos=a,comp=y
jihvaH	jihvA	pos=n,g=m,c=1,n=s
calita	cal	pos=va,comp=y,f=part
agra	agra	pos=n,comp=y
kesaraH	kesara	pos=n,g=m,c=1,n=s

# id = Rtu.1.15
viSuzka	viSuzka	pos=a,comp=y
kaRWa	kaRWa	pos=n,comp=y
udgata	udgam	pos=va,comp=y,f=part
sIkara	sIkara	pos=n,comp=y
amBas	amBas	pos=n,g=m,c=1,n=p
gaBastiBiH	gaBasti	pos=n,g=m,c=3,n=p
BAnumato	BAnumant	pos=n,g=m,c=6,n=s
'nutApitAH	anutApay	pos=va,g=m,c=1,n=p,f=part
pravfdDa	pravfD	pos=va,comp=y,f=part
tfzRA	tfzRA	pos=n,comp=y
upahatAH	upahan	pos=va,g=m,c=1,n=p,f=part
jala	jala	pos=n,comp=y
arTinaH	arTin	pos=a,g=m,c=1,n=p
na	na	pos=i
dantinaH	dantin	pos=n,g=m,c=1,n=p
kesarin	kesarin	pos=n,g=m,c=2,n=p
api	api	pos=i
biByati	BI	pos=v,p=3,n=p,l=lat

# id = Rtu.1.16
huta	hu	pos=va,comp=y,f=part
agni	agni	pos=n,comp=y
kalpEH	kalpa	pos=a,g=m,c=3,n=p
savituH	savitf	pos=n,g=m,c=6,n=s
gaBasti	gaBasti	pos=n,g=m,c=3,n=p
kalApinaH	kalApin	pos=n,g=m,c=6,n=s
klam	klam	pos=va,comp=y,f=part
SarIra	SarIra	pos=n,comp=y
cetasaH	cetas	pos=n,g=m,c=1,n=p
na	na	pos=i
Boginam	Bogin	pos=n,g=m,c=2,n=s
Gnanti	han	pos=v,p=3,n=p,l=lat
samIpa	samIpa	pos=n,comp=y
vartinam	vartin	pos=a,g=m,c=2,n=s
kalApa	kalApa	pos=n,comp=y
cakrezu	cakra	pos=n,g=n,c=7,n=p
niveSita	niveSay	pos=va,comp=y,f=part
Ananam	Anana	pos=n,g=m,c=2,n=s

# id = Rtu.1.17
saBadramustam	saBadramusta	pos=a,g=n,c=2,n=s
pariSuzka	pariSuzka	pos=n,comp=y
kardamam	kardama	pos=n,g=n,c=2,n=s
saraH	saras	pos=n,g=n,c=2,n=s
Kanann	Kan	pos=va,g=m,c=1,n=s,f=part
Ayata	Ayam	pos=va,comp=y,f=part
potf	potf	pos=n,comp=y
maRqalEH	maRqala	pos=n,g=m,c=3,n=p
raveH	ravi	pos=n,g=m,c=6,n=s
mayUKEH	mayUKa	pos=n,g=m,c=3,n=p
aBitApitaH	aBitApay	pos=va,g=m,c=1,n=s,f=part
BfSam	BfSam	pos=i
varAha	varAha	pos=n,comp=y
yUTaH	yUTa	pos=n,g=m,c=1,n=s
viSati	viS	pos=v,p=3,n=s,l=lat
iva	iva	pos=i
BU	BU	pos=n,comp=y
talam	tala	pos=n,g=n,c=2,n=s

# id = Rtu.1.18
vivasvatA	vivasvant	pos=n,g=m,c=3,n=s
tIkzRatara	tIkzRatara	pos=a,comp=y
aMSu	aMSu	pos=n,comp=y
mAlinA	mAlin	pos=a,g=m,c=3,n=s
sa	sa	pos=i
paNka	paNka	pos=n,comp=y
toyAt	toya	pos=n,g=n,c=5,n=s
saraso	saras	pos=n,g=n,c=5,n=s
'BitApitaH	aBitApay	pos=va,g=m,c=1,n=s,f=part
utplutya	utplu	pos=vi
BekaH	Beka	pos=n,g=m,c=1,n=s
tfzitasya	tfzita	pos=a,g=m,c=6,n=s
BoginaH	Bogin	pos=n,g=m,c=6,n=s
PaRa	PaRa	pos=n,comp=y
Atapatrasya	Atapatra	pos=n,g=m,c=6,n=s
tale	tala	pos=n,g=m,c=7,n=s
nizIdati	nizad	pos=v,p=3,n=s,l=lat

# id = Rtu.1.19
samudDf	samudDf	pos=va,comp=y,f=part
aSeza	aSeza	pos=n,comp=y
mfRAla	mfRAla	pos=n,comp=y
jAlakam	jAlaka	pos=n,g=n,c=1,n=s
vipanna	vipad	pos=va,comp=y,f=part
mInam	mIna	pos=n,g=n,c=1,n=s
druta	dru	pos=va,comp=y,f=part
BIta	BI	pos=va,comp=y,f=part
sArasam	sArasa	pos=n,g=n,c=1,n=s
paraspara	paraspara	pos=n,comp=y
utpIqana	utpIqana	pos=n,comp=y
saMhatEH	saMhan	pos=va,g=m,c=3,n=p,f=part
gajEH	gaja	pos=n,g=m,c=3,n=p
kftam	kf	pos=va,g=n,c=1,n=s,f=part
saraH	saras	pos=n,g=n,c=1,n=s
sAndra	sAndra	pos=a,comp=y
vimarda	vimarda	pos=n,comp=y
kardamam	kardama	pos=n,g=n,c=1,n=s

# id = Rtu.1.20
ravi	ravi	pos=n,comp=y
praBA	praBA	pos=n,comp=y
udBid	udBid	pos=va,comp=y,f=part
SiromaRi	SiromaRi	pos=n,comp=y
praBaH	praBA	pos=n,g=m,c=1,n=s
vilola	vilola	pos=a,comp=y
jihvA	jihvA	pos=n,comp=y
dvaya	dvaya	pos=n,comp=y
lih	lih	pos=va,comp=y,f=part
mArutaH	mAruta	pos=n,g=m,c=1,n=s
vizAgni	vizAgni	pos=n,comp=y
sUrya	sUrya	pos=n,comp=y
Atapa	Atapa	pos=n,comp=y
tApitaH	tApay	pos=va,g=m,c=1,n=s,f=part
PaRI	PaRin	pos=n,g=m,c=1,n=s
na	na	pos=i
hanti	han	pos=v,p=3,n=s,l=lat
maRqUka	maRqUka	pos=n,comp=y
kulam	kula	pos=n,g=n,c=2,n=s
tfzA	tfzA	pos=n,comp=y
AkulaH	Akula	pos=a,g=m,c=1,n=s

# id = Rtu.1.21
saPena	saPena	pos=a,comp=y
lAlA	lAlA	pos=n,comp=y
Avfta	Avf	pos=va,comp=y,f=part
vaktra	vaktra	pos=n,comp=y
sampuwam	sampuwa	pos=n,g=n,c=1,n=s
viniHsf	viniHsf	pos=va,comp=y,f=part
Alohita	Alohita	pos=a,comp=y
jihvam	jihvA	pos=n,g=n,c=1,n=s
unmuKam	unmuKa	pos=a,g=n,c=1,n=s
tfzA	tfzA	pos=n,comp=y
Akulam	Akula	pos=a,g=n,c=1,n=s
niHsftam	niHsf	pos=va,g=n,c=1,n=s,f=part
adri	adri	pos=n,comp=y
gahvarAt	gahvara	pos=n,g=n,c=5,n=s
avekz	avekz	pos=va,g=n,c=1,n=s,f=part
mahizI	mahizI	pos=n,comp=y
kulam	kula	pos=n,g=n,c=1,n=s
jalam	jala	pos=n,g=n,c=2,n=s

# id = Rtu.1.22
pawutara	pawutara	pos=a,comp=y
dava	dava	pos=n,comp=y
dAha	dAha	pos=n,comp=y
ucCuzka	ucCuzka	pos=a,comp=y
sasya	sasya	pos=n,comp=y
prarohAH	praroha	pos=n,g=m,c=1,n=p
paruza	paruza	pos=a,comp=y
pavana	pavana	pos=n,comp=y
vega	vega	pos=n,comp=y
utkzipta	utkzip	pos=va,comp=y,f=part
saMSuzka	saMSuzka	pos=a,comp=y
parRAH	parRa	pos=n,g=m,c=1,n=p
dinakara	dinakara	pos=n,comp=y
paritApa	paritApa	pos=n,comp=y
kzIRa	kzi	pos=va,comp=y,f=part
toyAH	toya	pos=n,g=m,c=1,n=p
samantAt	samantAt	pos=i
vidaDati	viDA	pos=v,p=3,n=p,l=lat
Bayam	Baya	pos=n,g=n,c=2,n=s
uccEs	uccEs	pos=i
vIkzyamARA	vIkz	pos=va,g=m,c=1,n=p,f=part
vanAntAH	vanAnta	pos=n,g=m,c=1,n=p

# id = Rtu.1.23
Svasiti	Svas	pos=v,p=3,n=s,l=lat
vihaga	vihaga	pos=n,comp=y
vargaH	varga	pos=n,g=m,c=1,n=s
SIrRa	Sf	pos=va,comp=y,f=part
parRa	parRa	pos=n,comp=y
druma	druma	pos=n,comp=y
sTaH	sTa	pos=a,g=m,c=1,n=s
kapi	kapi	pos=n,comp=y
kulam	kula	pos=n,g=n,c=1,n=s
upayAti	upayA	pos=v,p=3,n=s,l=lat
klAntam	klam	pos=va,g=n,c=1,n=s,f=part
adreH	adri	pos=n,g=m,c=6,n=s
nikuYjam	nikuYja	pos=n,g=m,c=2,n=s
Bramati	Bram	pos=v,p=3,n=s,l=lat
gavaya	gavaya	pos=n,comp=y
yUTaH	yUTa	pos=n,g=m,c=1,n=s
sarvatas	sarvatas	pos=i
toyam	toya	pos=n,g=n,c=2,n=s
icCan	iz	pos=va,g=m,c=1,n=s,f=part
SaraBa	SaraBa	pos=n,comp=y
kulam	kula	pos=n,g=n,c=1,n=s
ajihmam	ajihma	pos=a,g=n,c=1,n=s
prodDarati	prodDf	pos=v,p=3,n=s,l=lat
aMbu	ambu	pos=n,g=n,c=2,n=s
kUpAt	kUpa	pos=n,g=m,c=5,n=s

# id = Rtu.1.24
vikaca	vikaca	pos=a,comp=y
nava	navan	pos=n,comp=y
kusumBa	kusumBa	pos=n,comp=y
svacCa	svacCa	pos=a,comp=y
sindUra	sindUra	pos=n,comp=y
BAsA	BAs	pos=n,g=f,c=3,n=s
prabala	prabala	pos=a,comp=y
pavana	pavana	pos=n,comp=y
vega	vega	pos=n,comp=y
udBUta	udBU	pos=va,comp=y,f=part
vegena	vega	pos=n,g=m,c=3,n=s
tUrRam	tUrRam	pos=i
tawa	tawa	pos=n,comp=y
viwapa	viwapa	pos=n,comp=y
latA	latA	pos=n,comp=y
agra	agra	pos=n,comp=y
AliNgana	AliNgana	pos=n,comp=y
vyAkulena	vyAkula	pos=a,g=m,c=3,n=s
diSi	diS	pos=n,g=f,c=7,n=s
diSi	diS	pos=n,g=f,c=7,n=s
paridagDA	paridah	pos=va,g=f,c=1,n=p,f=part
BUmayaH	BUmi	pos=n,g=f,c=1,n=p
pAvakena	pAvaka	pos=n,g=m,c=3,n=s

# id = Rtu.1.25
jvalati	jval	pos=v,p=3,n=s,l=lat
pavana	pavana	pos=n,comp=y
vfdDaH	vfD	pos=va,g=m,c=1,n=s,f=part
parvatAnAm	parvata	pos=n,g=m,c=6,n=p
darIzu	darI	pos=n,g=f,c=7,n=p
sPuwati	sPuw	pos=v,p=3,n=s,l=lat
pawu	pawu	pos=a,comp=y
ninAdEH	ninAda	pos=n,g=m,c=3,n=p
Suzka	Suzka	pos=a,comp=y
vaMSa	vaMSa	pos=n,comp=y
sTalI	sTalI	pos=n,g=f,c=7,n=p
prasarati	prasf	pos=v,p=3,n=s,l=lat
tfRa	tfRa	pos=n,comp=y
maDye	maDya	pos=n,g=n,c=7,n=s
labDa	laB	pos=va,comp=y,f=part
vfdDiH	vfdDi	pos=n,g=m,c=1,n=s
kzaRena	kzaRa	pos=n,g=m,c=3,n=s
glapayati	glapay	pos=v,p=3,n=s,l=lat
mfga	mfga	pos=n,comp=y
vargam	varga	pos=n,g=m,c=2,n=s
prAnta	prAnta	pos=n,comp=y
lagnaH	lag	pos=va,g=m,c=1,n=s,f=part
dava	dava	pos=n,comp=y
agniH	agni	pos=n,g=m,c=1,n=s

# id = Rtu.1.26
bahutara	bahutara	pos=a,g=m,c=1,n=s
iva	iva	pos=i
jAtaH	jan	pos=va,g=m,c=1,n=s,f=part
SAlmalInAm	SAlmalI	pos=n,g=f,c=6,n=p
vanezu	vana	pos=n,g=n,c=7,n=p
sPurati	sPur	pos=v,p=3,n=s,l=lat
kanaka	kanaka	pos=n,comp=y
gOraH	gOra	pos=a,g=m,c=1,n=s
kowarezu	kowara	pos=n,g=m,c=7,n=p
drumARAm	druma	pos=n,g=m,c=6,n=p
pariRata	pariRam	pos=va,comp=y,f=part
dala	dala	pos=n,comp=y
SAKA	SAKA	pos=n,g=m,c=2,n=p
utpatan	utpat	pos=va,g=m,c=1,n=s,f=part
prAMSu	prAMSu	pos=a,comp=y
vfkzAn	vfkza	pos=n,g=m,c=2,n=p
Bramati	Bram	pos=v,p=3,n=s,l=lat
pavana	pavana	pos=n,comp=y
DUtaH	DU	pos=va,g=m,c=1,n=s,f=part
sarvatas	sarvatas	pos=i
agniH	agni	pos=n,g=m,c=1,n=s
vanAnte	vanAnta	pos=n,g=m,c=7,n=s

# id = Rtu.1.27
gaja	gaja	pos=n,comp=y
gavaya	gavaya	pos=n,comp=y
mfgendrAH	mfgendra	pos=n,g=m,c=1,n=p
vahni	vahni	pos=n,comp=y
saMtapta	saMtap	pos=va,comp=y,f=part
dehAH	deha	pos=n,g=m,c=1,n=p
suhfda	suhfd	pos=n,g=m,c=1,n=p
iva	iva	pos=i
sametA	same	pos=va,g=m,c=1,n=p,f=part
dvandva	dvaMdva	pos=n,comp=y
BAvam	BAva	pos=n,g=m,c=2,n=s
vihAya	vihA	pos=vi
hutavaha	hutavaha	pos=n,comp=y
pariKedAt	pariKeda	pos=n,g=n,c=5,n=s
ASu	ASu	pos=a,g=n,c=2,n=s
nirgatya	nirgam	pos=vi
kakzAt	kakza	pos=n,g=m,c=5,n=s
vipula	vipula	pos=a,comp=y
pulina	pulina	pos=n,comp=y
deSAm	deSa	pos=n,g=f,c=2,n=s
nimnagAm	nimnagA	pos=n,g=f,c=2,n=s
saMviSanti	saMviS	pos=v,p=3,n=p,l=lat

# id = Rtu.1.28
kamala	kamala	pos=n,comp=y
vana	vana	pos=n,comp=y
ci	ci	pos=va,comp=y,f=part
ambuH	ambu	pos=n,g=m,c=1,n=s
pAwalA	pAwalA	pos=n,comp=y
Amoda	Amoda	pos=n,comp=y
ramyaH	ramya	pos=a,g=m,c=1,n=s
suKa	suKa	pos=a,comp=y
salila	salila	pos=n,comp=y
nizekaH	nizeka	pos=n,g=m,c=1,n=s
sevya	sev	pos=va,comp=y,f=krtya
candra	candra	pos=n,comp=y
aMSu	aMSu	pos=n,comp=y
hAraH	hAra	pos=n,g=m,c=1,n=s
vrajatu	vraj	pos=v,p=3,n=s,l=lot
tava	tvad	pos=n,g=,c=6,n=s
nidAGaH	nidAGa	pos=n,g=m,c=1,n=s
kAminIBiH	kAminI	pos=n,g=f,c=3,n=p
sameto	same	pos=va,g=m,c=1,n=s,f=part
niSi	niS	pos=n,g=f,c=7,n=s
su	su	pos=i
lalita	lal	pos=va,comp=y,f=part
gIte	gIta	pos=n,g=n,c=7,n=s
harmya	harmya	pos=n,comp=y
pfzWe	pfzWa	pos=n,g=n,c=7,n=s
suKena	suKa	pos=n,g=n,c=3,n=s

# id = Rtu.2.1
sasIkara	sasIkara	pos=a,comp=y
amBoDara	amBoDara	pos=n,comp=y
matta	mad	pos=va,comp=y,f=part
kuYjaraH	kuYjara	pos=n,g=m,c=1,n=s
taqit	taqit	pos=n,comp=y
patAkaH	patAkA	pos=n,g=m,c=1,n=s
aSani	aSani	pos=n,comp=y
Sabda	Sabda	pos=n,comp=y
mardalaH	mardala	pos=n,g=m,c=1,n=s
samAgato	samAgam	pos=va,g=m,c=1,n=s,f=part
rAja	rAjan	pos=n,comp=y
vat	vat	pos=i
udData	udDan	pos=va,comp=y,f=part
dyutiH	dyuti	pos=n,g=m,c=1,n=s
Gana	Gana	pos=n,comp=y
AgamaH	Agama	pos=n,g=m,c=1,n=s
kAmin	kAmin	pos=a,comp=y
jana	jana	pos=n,comp=y
priyaH	priya	pos=a,g=m,c=1,n=s
priye	priya	pos=a,g=f,c=8,n=s

# id = Rtu.2.2
nitAnta	nitAnta	pos=a,comp=y
nIlotpala	nIlotpala	pos=n,comp=y
pattra	pattra	pos=n,comp=y
kAntiBiH	kAnti	pos=n,g=f,c=3,n=p
kvacit	kvacid	pos=i
praBid	praBid	pos=va,comp=y,f=part
aYjana	aYjana	pos=n,comp=y
rASi	rASi	pos=n,comp=y
saMniBEH	saMniBa	pos=a,g=m,c=3,n=p
kvacid	kvacid	pos=i
sagarBa	sagarBa	pos=a,comp=y
pramadA	pramadA	pos=n,comp=y
stana	stana	pos=n,comp=y
praBA	praBA	pos=n,g=m,c=3,n=p
samAcitam	samAci	pos=va,g=n,c=1,n=s,f=part
vyoma	vyoman	pos=n,g=n,c=1,n=s
GanEH	Gana	pos=n,g=m,c=3,n=p
samantataH	samantataH	pos=i

# id = Rtu.2.3
tfzA	tfzA	pos=n,comp=y
AkulEH	Akula	pos=a,g=n,c=3,n=p
cAtaka	cAtaka	pos=n,comp=y
pakziRAm	pakzin	pos=n,g=m,c=6,n=p
kulEH	kula	pos=n,g=n,c=3,n=p
prayAcitAs	prayAc	pos=va,g=m,c=1,n=p,f=part
toya	toya	pos=n,comp=y
Bara	Bara	pos=n,comp=y
avalambinaH	avalambin	pos=a,g=m,c=1,n=p
prayAnti	prayA	pos=v,p=3,n=p,l=lat
mandam	manda	pos=a,g=n,c=2,n=s
bahu	bahu	pos=a,comp=y
DAra	DAra	pos=n,comp=y
varziRaH	varzin	pos=a,g=m,c=1,n=p
balAhakAH	balAhaka	pos=n,g=m,c=1,n=p
Srotra	Srotra	pos=n,comp=y
manohara	manohara	pos=a,comp=y
svanAH	svana	pos=n,g=m,c=1,n=p

# id = Rtu.2.4
balAhakAH	balAhaka	pos=n,g=m,c=1,n=p
ca	ca	pos=i
aSani	aSani	pos=n,comp=y
Sabda	Sabda	pos=n,comp=y
mardalAH	mardala	pos=n,g=m,c=1,n=p
surendra	surendra	pos=n,comp=y
cApam	cApa	pos=n,g=m,c=2,n=s
daDataH	DA	pos=va,g=m,c=1,n=p,f=part
taqit	taqit	pos=n,comp=y
guRam	guRa	pos=n,g=m,c=2,n=s
su	su	pos=i
tIkzRa	tIkzRa	pos=a,comp=y
DAra	DArA	pos=n,comp=y
patana	patana	pos=n,comp=y
ugra	ugra	pos=a,comp=y
sAyakEH	sAyaka	pos=n,g=m,c=3,n=p
tudanti	tud	pos=v,p=3,n=p,l=lat
cetaH	cetas	pos=n,g=n,c=2,n=s
prasaBam	prasaBam	pos=i
pravAsinAm	pravAsin	pos=a,g=m,c=6,n=p

# id = Rtu.2.5
praBid	praBid	pos=va,comp=y,f=part
vEqUrya	vEqUrya	pos=n,comp=y
niBEH	niBa	pos=a,g=m,c=3,n=p
tfRa	tfRa	pos=n,comp=y
aNkurEH	aNkura	pos=n,g=m,c=3,n=p
samAcitA	samAci	pos=va,g=f,c=1,n=s,f=part
protTita	protTita	pos=a,comp=y
kandalI	kandalI	pos=n,comp=y
dalEH	dala	pos=n,g=n,c=3,n=p
viBAti	viBA	pos=v,p=3,n=s,l=lat
Sukletara	Sukletara	pos=a,comp=y
ratna	ratna	pos=n,comp=y
BUzitA	BUzay	pos=va,g=f,c=1,n=s,f=part
vara	vara	pos=a,comp=y
aNganA	aNganA	pos=n,g=f,c=1,n=s
iva	iva	pos=i
kzitiH	kziti	pos=n,g=f,c=1,n=s
indragopakEH	indragopaka	pos=n,g=m,c=3,n=p

# id = Rtu.2.6
sadA	sadA	pos=i
manojYam	manojYa	pos=a,g=n,c=1,n=s
svanat	svan	pos=va,g=n,c=1,n=s,f=part
utsava	utsava	pos=n,comp=y
utsukam	utsuka	pos=a,g=n,c=1,n=s
vikIrRa	vikf	pos=va,comp=y,f=part
vistIrRa	vistf	pos=va,comp=y,f=part
kalApi	kalApin	pos=n,comp=y
SoBitam	SoBay	pos=va,g=n,c=1,n=s,f=part
sa	sa	pos=i
saMBrama	samBrama	pos=n,comp=y
AliNgana	AliNgana	pos=n,comp=y
cumbana	cumbana	pos=n,comp=y
Akulam	Akula	pos=a,g=n,c=1,n=s
pravftta	pravft	pos=va,comp=y,f=part
nftyam	nftya	pos=n,g=n,c=1,n=s
kulam	kula	pos=n,g=n,c=1,n=s
adya	adya	pos=i
barhiRAm	barhin	pos=n,g=m,c=6,n=p

# id = Rtu.2.7
nipAtayantyaH	nipAtay	pos=va,g=f,c=1,n=p,f=part
paritas	paritas	pos=i
tawa	tawa	pos=n,comp=y
drumAn	druma	pos=n,g=m,c=2,n=p
pravfdDa	pravfD	pos=va,comp=y,f=part
vegEH	vega	pos=n,g=n,c=3,n=p
salilEH	salila	pos=n,g=n,c=3,n=p
anirmalEH	anirmala	pos=a,g=n,c=3,n=p
striyaH	strI	pos=n,g=f,c=1,n=p
suduzwA	suduzwa	pos=a,g=f,c=1,n=p
iva	iva	pos=i
jAti	jAti	pos=n,comp=y
viBrama	viBrama	pos=n,g=f,c=1,n=p
prayAnti	prayA	pos=v,p=3,n=p,l=lat
nadyaH	nadI	pos=n,g=f,c=1,n=p
tvaritam	tvarita	pos=a,g=n,c=2,n=s
payoniDim	payoniDi	pos=n,g=m,c=2,n=s

# id = Rtu.2.8
tfRa	tfRa	pos=n,comp=y
utkarEH	utkara	pos=n,g=m,c=3,n=p
udgata	udgam	pos=va,comp=y,f=part
komala	komala	pos=a,comp=y
aNkurEH	aNkura	pos=n,g=m,c=3,n=p
citAni	cita	pos=a,g=n,c=1,n=p
nIlEH	nIla	pos=a,g=m,c=3,n=p
hariRI	hariRI	pos=n,comp=y
muKa	muKa	pos=n,comp=y
kzatEH	kzan	pos=va,g=m,c=3,n=p,f=part
vanAni	vana	pos=n,g=n,c=1,n=p
vEnDyAni	vEnDya	pos=a,g=n,c=1,n=p
haranti	hf	pos=v,p=3,n=p,l=lat
mAnasam	mAnasa	pos=n,g=n,c=2,n=s
viBUzitAni	viBUzay	pos=va,g=n,c=1,n=p,f=part
udgata	udgam	pos=va,comp=y,f=part
pallavEH	pallava	pos=n,g=m,c=3,n=p
drumEH	druma	pos=n,g=m,c=3,n=p

# id = Rtu.2.9
vilola	vilola	pos=a,comp=y
netra	netra	pos=n,comp=y
utpala	utpala	pos=n,comp=y
SoBay	SoBay	pos=va,comp=y,f=part
AnanEH	Anana	pos=n,g=m,c=3,n=p
mfgEH	mfga	pos=n,g=m,c=3,n=p
samantAd	samantAt	pos=i
upajAta	upajan	pos=va,comp=y,f=part
sADvasEH	sADvasa	pos=n,g=m,c=3,n=p
samAcitA	samAci	pos=va,g=f,c=1,n=s,f=part
sEkatinI	sEkatin	pos=a,g=f,c=1,n=s
vana	vana	pos=n,comp=y
sTalI	sTalI	pos=n,g=f,c=1,n=s
samutsuka	samutsuka	pos=a,comp=y
tvam	tva	pos=n,g=n,c=2,n=s
prakaroti	prakf	pos=v,p=3,n=s,l=lat
cetasaH	cetas	pos=n,g=n,c=6,n=s

# id = Rtu.2.10
aBIkzRam	aBIkzRa	pos=a,g=n,c=2,n=s
uccEs	uccEs	pos=i
DvanatA	Dvan	pos=va,g=m,c=3,n=s,f=part
payomucA	payomuc	pos=n,g=m,c=3,n=s
Gana	Gana	pos=n,comp=y
anDakArI	anDakArI	pos=n,comp=y
kfta	kf	pos=va,comp=y,f=part
SarvarI	SarvarI	pos=n,g=f,c=7,n=p
api	api	pos=i
taqit	taqit	pos=n,comp=y
praBA	praBA	pos=n,comp=y
darSita	darSay	pos=va,comp=y,f=part
mArga	mArga	pos=n,comp=y
BUmayaH	BUmi	pos=n,g=f,c=1,n=p
prayAnti	prayA	pos=v,p=3,n=p,l=lat
rAgAt	rAga	pos=n,g=m,c=5,n=s
aBisArikAH	aBisArikA	pos=n,g=f,c=1,n=p
striyaH	strI	pos=n,g=f,c=1,n=p

# id = Rtu.2.11
payoDarEH	payoDara	pos=n,g=m,c=3,n=p
BIma	BIma	pos=a,comp=y
gaBIra	gaBIra	pos=a,comp=y
nisvanEH	nisvana	pos=n,g=m,c=3,n=p
taqidBiH	taqit	pos=n,g=,c=3,n=p
udvejay	udvejay	pos=va,comp=y,f=part
cetasaH	cetas	pos=n,g=m,c=1,n=p
BfSam	BfSam	pos=i
kfta	kf	pos=va,comp=y,f=part
aparADAn	aparADa	pos=n,g=m,c=2,n=p
api	api	pos=i
yozitaH	yozit	pos=n,g=f,c=1,n=p
priyAn	priya	pos=a,g=m,c=2,n=p
parizvajante	parizvaj	pos=v,p=3,n=p,l=lat
Sayane	Sayana	pos=n,g=n,c=7,n=s
nirantaram	nirantara	pos=a,g=n,c=2,n=s

# id = Rtu.2.12
vilocana	vilocana	pos=n,comp=y
indIvara	indIvara	pos=n,comp=y
vAri	vAri	pos=n,comp=y
binduBiH	bindu	pos=n,g=m,c=3,n=p
nizikta	nizic	pos=va,comp=y,f=part
biMba	bimba	pos=n,comp=y
aDara	aDara	pos=n,comp=y
cAru	cAru	pos=a,comp=y
pallava	pallava	pos=n,g=f,c=1,n=p
nirasta	niras	pos=va,comp=y,f=part
mAlya	mAlya	pos=n,comp=y
ABaraRa	ABaraRa	pos=n,comp=y
anulepana	anulepana	pos=n,g=f,c=1,n=p
sTitA	sTA	pos=va,g=f,c=1,n=p,f=part
nirASAH	nirASa	pos=a,g=f,c=1,n=p
pramadAH	pramadA	pos=n,g=f,c=1,n=p
pravAsinAm	pravAsin	pos=a,g=m,c=6,n=p

# id = Rtu.2.13
vipARquram	vipARqura	pos=a,g=n,c=1,n=s
kIwa	kIwa	pos=n,comp=y
rajaH	rajas	pos=n,comp=y
tfRa	tfRa	pos=n,comp=y
anvitam	anvita	pos=a,g=n,c=1,n=s
BujaNga	BujaMga	pos=n,comp=y
vat	vat	pos=i
vakragati	vakragati	pos=n,comp=y
prasarpitam	prasarpay	pos=va,g=n,c=1,n=s,f=part
sa	sa	pos=i
sADvasEH	sADvasa	pos=n,g=n,c=3,n=p
Beka	Beka	pos=n,comp=y
kulEH	kula	pos=n,g=n,c=3,n=p
nirIkzitam	nirIkzay	pos=va,g=n,c=1,n=s,f=part
prayAti	prayA	pos=v,p=3,n=s,l=lat
nimna	nimna	pos=n,comp=y
aBimuKam	aBimuKa	pos=a,g=n,c=1,n=s
nava	nava	pos=a,comp=y
udakam	udaka	pos=n,g=n,c=1,n=s

# id = Rtu.2.14
vipattra	vipattra	pos=a,comp=y
puzpAm	puzpa	pos=n,g=f,c=2,n=s
nalinIm	nalinI	pos=n,g=f,c=2,n=s
samutsukA	samutsuka	pos=a,g=m,c=1,n=p
vihAya	vihA	pos=vi
BfNgAH	BfNga	pos=n,g=m,c=1,n=p
Sruti	Sruti	pos=n,comp=y
hAri	hArin	pos=a,comp=y
nisvanAH	nisvana	pos=n,g=m,c=1,n=p
patanti	pat	pos=v,p=3,n=p,l=lat
mUQAH	muh	pos=va,g=m,c=1,n=p,f=part
SiKinAm	SiKin	pos=n,g=m,c=6,n=p
pranftyatAm	pranft	pos=va,g=m,c=6,n=p,f=part
kalApa	kalApa	pos=n,comp=y
cakrezu	cakra	pos=n,g=n,c=7,n=p
nava	nava	pos=a,comp=y
utpala	utpala	pos=n,comp=y
ASayA	ASA	pos=n,g=f,c=3,n=s

# id = Rtu.2.15
vana	vana	pos=n,comp=y
dvipAnAm	dvipa	pos=n,g=m,c=6,n=p
nava	nava	pos=a,comp=y
vArida	vArida	pos=n,comp=y
svanEH	svana	pos=n,g=m,c=3,n=p
mada	mada	pos=n,comp=y
anvitAnAm	anvita	pos=a,g=m,c=6,n=p
DvanatAm	Dvan	pos=va,g=m,c=6,n=p,f=part
muhuH	muhur	pos=i
muhuH	muhur	pos=i
kapola	kapola	pos=n,comp=y
deSAH	deSa	pos=n,g=m,c=1,n=p
vimala	vimala	pos=a,comp=y
utpala	utpala	pos=n,comp=y
praBAH	praBA	pos=n,g=m,c=1,n=p
saBfNga	saBfNga	pos=a,comp=y
yUTEH	yUTa	pos=n,g=m,c=3,n=p
mada	mada	pos=n,comp=y
vAriBiH	vAri	pos=n,g=n,c=3,n=p
citAH	cita	pos=a,g=m,c=1,n=p

# id = Rtu.2.16
sitotpala	sitotpala	pos=n,comp=y
ABa	ABa	pos=a,comp=y
ambuda	ambuda	pos=n,comp=y
cumb	cumb	pos=va,comp=y,f=part
upalAH	upala	pos=n,g=m,c=1,n=p
samAcitAH	samAci	pos=va,g=m,c=1,n=p,f=part
prasravaREH	prasravaRa	pos=n,g=n,c=3,n=p
samantataH	samantataH	pos=i
pravftta	pravft	pos=va,comp=y,f=part
nftyEH	nftya	pos=n,g=m,c=3,n=p
SiKiBiH	SiKin	pos=n,g=m,c=3,n=p
samAkulAH	samAkula	pos=a,g=m,c=1,n=p
samutsuka	samutsuka	pos=a,comp=y
tvam	tva	pos=n,g=n,c=2,n=s
janayanti	janay	pos=v,p=3,n=p,l=lat
BUDarAH	BUDara	pos=n,g=m,c=1,n=p

# id = Rtu.2.17
kadamba	kadamba	pos=n,comp=y
sarja	sarja	pos=n,comp=y
arjuna	arjuna	pos=n,comp=y
ketakI	ketakI	pos=n,comp=y
vanam	vana	pos=n,g=n,c=2,n=s
vikampay	vikampay	pos=va,g=m,c=1,n=s,f=part
tad	tad	pos=n,comp=y
kusuma	kusuma	pos=n,comp=y
aDivAsitaH	aDivAsita	pos=a,g=m,c=1,n=s
sasIkara	sasIkara	pos=a,comp=y
amBoDara	amBoDara	pos=n,comp=y
saNga	saNga	pos=n,comp=y
SItalaH	SItala	pos=a,g=m,c=1,n=s
samIraRaH	samIraRa	pos=n,g=m,c=1,n=s
kam	ka	pos=n,g=m,c=2,n=s
na	na	pos=i
karoti	kf	pos=v,p=3,n=s,l=lat
sa	sa	pos=i
utsukam	utsuka	pos=a,g=m,c=2,n=s

# id = Rtu.2.18
SiroruhEH	Siroruha	pos=n,g=m,c=3,n=p
SroRi	SroRi	pos=n,comp=y
tawa	tawa	pos=n,comp=y
avalambin	avalambin	pos=a,g=m,c=3,n=p
kfta	kf	pos=va,comp=y,f=part
avataMsEH	avataMsa	pos=n,g=n,c=3,n=p
kusumEH	kusuma	pos=n,g=n,c=3,n=p
suganDiBiH	suganDi	pos=a,g=n,c=3,n=p
stanEH	stana	pos=n,g=n,c=3,n=p
sahArEH	sahAra	pos=a,g=n,c=3,n=p
vadanEH	vadana	pos=n,g=n,c=3,n=p
sasIDuBiH	sasIDu	pos=a,g=n,c=3,n=p
striyo	strI	pos=n,g=f,c=1,n=p
ratim	rati	pos=n,g=f,c=2,n=s
saMjanayanti	saMjanay	pos=v,p=3,n=p,l=lat
kAminAm	kAmin	pos=n,g=m,c=6,n=p

# id = Rtu.2.19
vahanti	vah	pos=v,p=3,n=p,l=lat
varzanti	vfz	pos=v,p=3,n=p,l=lat
nadanti	nad	pos=v,p=3,n=p,l=lat
BAnti	BA	pos=v,p=3,n=p,l=lat
vyAyanti	vye	pos=v,p=3,n=p,l=lat
nftyanti	nft	pos=v,p=3,n=p,l=lat
samASrayanti	samASri	pos=v,p=3,n=p,l=lat
nadyo	nadI	pos=n,g=f,c=1,n=p
GanA	Gana	pos=n,g=m,c=1,n=p
matta	mad	pos=va,comp=y,f=part
gajAH	gaja	pos=n,g=m,c=1,n=p
vana	vana	pos=n,comp=y
antAH	anta	pos=n,g=m,c=1,n=p
priyA	priyA	pos=n,comp=y
vihInAH	vihA	pos=va,g=m,c=1,n=p,f=part
SiKinaH	SiKin	pos=n,g=m,c=1,n=p
plavaMgAH	plavaMga	pos=n,g=m,c=1,n=p

# id = Rtu.2.20
taqit	taqit	pos=n,comp=y
latA	latA	pos=n,comp=y
SakraDanus	SakraDanus	pos=n,comp=y
viBUzitAH	viBUzay	pos=va,g=m,c=1,n=p,f=part
payoDarAH	payoDara	pos=n,g=m,c=1,n=p
toya	toya	pos=n,comp=y
Bara	Bara	pos=n,comp=y
avalambinaH	avalambin	pos=a,g=m,c=1,n=p
striyaH	strI	pos=n,g=f,c=1,n=p
ca	ca	pos=i
kAYcI	kAYcI	pos=n,comp=y
maRi	maRi	pos=n,comp=y
kuRqala	kuRqala	pos=n,comp=y
ujjvala	ujjvala	pos=a,g=f,c=1,n=p
haranti	hf	pos=v,p=3,n=p,l=lat
ceto	cetas	pos=n,g=n,c=2,n=s
yugapad	yugapad	pos=i
pravAsin	pravAsin	pos=a,g=m,c=6,n=p

# id = Rtu.2.21
mAlAH	mAlA	pos=n,g=f,c=2,n=p
kadamba	kadamba	pos=n,comp=y
nava	nava	pos=a,comp=y
kesara	kesara	pos=n,comp=y
ketakI	ketakI	pos=n,g=f,c=3,n=p
AyojitAH	Ayojay	pos=va,g=f,c=2,n=p,f=part
Sirasi	Siras	pos=n,g=n,c=7,n=s
biBrati	Bf	pos=v,p=3,n=p,l=lat
yozitaH	yozit	pos=n,g=f,c=1,n=p
adya	adya	pos=i
karRa	karRa	pos=n,comp=y
antarezu	antara	pos=n,g=n,c=7,n=p
kakuBa	kakuBa	pos=n,comp=y
druma	druma	pos=n,comp=y
maYjarI	maYjarI	pos=n,g=f,c=3,n=p
icCA	icCA	pos=n,comp=y
anukUla	anukUla	pos=a,comp=y
racitAn	racay	pos=va,g=m,c=2,n=p,f=part
avataMsakAn	avataMsaka	pos=n,g=m,c=2,n=p
ca	ca	pos=i

# id = Rtu.2.22
kAlAguru	kAlAguru	pos=n,comp=y
pracara	pracara	pos=n,comp=y
candana	candana	pos=n,comp=y
carcay	carcay	pos=va,comp=y,f=part
aNga	aNga	pos=a,g=f,c=1,n=p
puzpa	puzpa	pos=n,comp=y
avataMsa	avataMsa	pos=n,comp=y
suraBIkf	suraBIkf	pos=va,comp=y,f=part
keSapASa	keSapASa	pos=n,g=f,c=1,n=p
SrutvA	Sru	pos=vi
Dvanim	Dvani	pos=n,g=m,c=2,n=s
jalamucAm	jalamuc	pos=n,g=m,c=6,n=p
tvaritam	tvarita	pos=a,g=n,c=2,n=s
pradoze	pradoza	pos=n,g=m,c=7,n=s
SayyA	SayyA	pos=n,comp=y
gfham	gfha	pos=n,g=n,c=2,n=s
guru	guru	pos=n,comp=y
gfhAt	gfha	pos=n,g=n,c=5,n=s
praviSanti	praviS	pos=v,p=3,n=p,l=lat
nAryaH	nArI	pos=n,g=f,c=1,n=p

# id = Rtu.2.23
kuvalaya	kuvalaya	pos=n,comp=y
dala	dala	pos=n,comp=y
nIlEH	nIla	pos=a,g=m,c=3,n=p
unnatEs	unnam	pos=va,g=m,c=3,n=p,f=part
toya	toya	pos=n,comp=y
namrEH	namra	pos=a,g=m,c=3,n=p
mfdu	mfdu	pos=a,comp=y
pavana	pavana	pos=n,comp=y
viDUtEH	viDU	pos=va,g=m,c=3,n=p,f=part
mandamandam	mandamandam	pos=i
caladBiH	cal	pos=va,g=m,c=3,n=p,f=part
apahftam	apahf	pos=va,g=n,c=1,n=s,f=part
iva	iva	pos=i
cetaH	cetas	pos=n,g=n,c=1,n=s
toyadEH	toyada	pos=n,g=m,c=3,n=p
sa	sa	pos=i
indracApEH	indracApa	pos=n,g=m,c=3,n=p
paTika	paTika	pos=n,comp=y
jana	jana	pos=n,comp=y
vaDUnAm	vaDU	pos=n,g=f,c=6,n=p
tad	tad	pos=n,comp=y
viyoga	viyoga	pos=n,comp=y
AkulAnAm	Akula	pos=a,g=f,c=6,n=p

# id = Rtu.2.24
mudita	mud	pos=va,g=m,c=1,n=s,f=part
iva	iva	pos=i
kadambEH	kadamba	pos=n,g=m,c=3,n=p
jAta	jan	pos=va,comp=y,f=part
puzpEH	puzpa	pos=n,g=m,c=3,n=p
samantAt	samantAt	pos=i
pavana	pavana	pos=n,comp=y
calita	cal	pos=va,comp=y,f=part
SAKA	SAKA	pos=n,g=m,c=3,n=p
SAKin	SAKin	pos=n,g=m,c=3,n=p
nftyati	nft	pos=v,p=3,n=s,l=lat
iva	iva	pos=i
hasitam	hasita	pos=n,g=n,c=2,n=s
iva	iva	pos=i
viDatte	viDA	pos=v,p=3,n=s,l=lat
sUciBiH	sUci	pos=n,g=f,c=3,n=p
ketakInAm	ketakI	pos=n,g=f,c=6,n=p
nava	nava	pos=a,comp=y
salila	salila	pos=n,comp=y
nizeka	nizeka	pos=n,comp=y
Cinna	Cid	pos=va,comp=y,f=part
tApaH	tApa	pos=n,g=m,c=1,n=s
vana	vana	pos=n,comp=y
antaH	anta	pos=n,g=m,c=1,n=s

# id = Rtu.2.25
Sirasi	Siras	pos=n,g=n,c=7,n=s
bakula	bakula	pos=n,comp=y
mAlAm	mAlA	pos=n,g=f,c=2,n=s
mAlatIBiH	mAlatI	pos=n,g=f,c=3,n=p
sametAm	same	pos=va,g=f,c=2,n=s,f=part
vikasita	vikas	pos=va,comp=y,f=part
nava	nava	pos=a,comp=y
puzpEH	puzpa	pos=n,g=m,c=3,n=p
yUTikA	yUTikA	pos=n,comp=y
kuqmalEH	kuqmala	pos=n,g=m,c=3,n=p
ca	ca	pos=i
vikaca	vikaca	pos=a,comp=y
nava	nava	pos=a,comp=y
kadambEH	kadamba	pos=n,g=m,c=3,n=p
karRapUram	karRapUra	pos=n,g=m,c=2,n=s
vaDUnAm	vaDU	pos=n,g=f,c=6,n=p
racayati	racay	pos=v,p=3,n=s,l=lat
jalada	jalada	pos=n,comp=y
oGaH	oGa	pos=n,g=m,c=1,n=s
kAnta	kAnta	pos=n,comp=y
vat	vat	pos=i
kAlaH	kAla	pos=n,g=m,c=1,n=s
ezaH	etad	pos=n,g=m,c=1,n=s

# id = Rtu.2.26
daDati	DA	pos=v,p=3,n=s,l=lat
vara	vara	pos=a,comp=y
kucAgrEH	kucAgra	pos=n,g=m,c=3,n=p
unnatEH	unnam	pos=va,g=m,c=3,n=p,f=part
hAra	hAra	pos=n,comp=y
yazwim	yazwi	pos=n,g=f,c=2,n=s
pratanu	pratanu	pos=a,comp=y
sita	sita	pos=a,comp=y
dukUlAni	dukUla	pos=n,g=n,c=2,n=p
AyatEH	Ayam	pos=va,g=m,c=3,n=p,f=part
SroRi	SroRi	pos=n,comp=y
bimbEH	bimba	pos=n,g=m,c=3,n=p
nava	nava	pos=a,comp=y
jala	jala	pos=n,comp=y
kaRa	kaRa	pos=n,comp=y
sekAt	seka	pos=n,g=m,c=5,n=s
udgatAm	udgam	pos=va,g=f,c=2,n=s,f=part
romarAjIm	romarAjI	pos=n,g=f,c=2,n=s
lalita	lalita	pos=n,comp=y
vali	vali	pos=n,comp=y
viBaNgEH	viBaNga	pos=n,g=m,c=3,n=p
maDyadeSEH	maDyadeSa	pos=n,g=m,c=3,n=p
ca	ca	pos=i
nAryaH	nArI	pos=n,g=f,c=1,n=p

# id = Rtu.2.27
nava	nava	pos=a,comp=y
jala	jala	pos=n,comp=y
kaRa	kaRa	pos=n,comp=y
saNgataH	saNga	pos=n,g=m,c=5,n=s
SIta	SIta	pos=a,comp=y
tAm	tA	pos=n,g=f,c=2,n=s
AdaDAnaH	ADA	pos=va,g=m,c=1,n=s,f=part
kusuma	kusuma	pos=n,comp=y
Bara	Bara	pos=n,comp=y
natAnAm	nam	pos=va,g=m,c=6,n=p,f=part
lAsakaH	lAsaka	pos=a,g=m,c=1,n=s
pAdapAnAm	pAdapa	pos=n,g=m,c=6,n=p
janita	janay	pos=va,comp=y,f=part
rucira	rucira	pos=a,comp=y
ganDaH	ganDa	pos=n,g=m,c=1,n=s
ketakInAm	ketakI	pos=n,g=f,c=6,n=p
rajoBiH	rajas	pos=n,g=n,c=3,n=p
pariharati	parihf	pos=v,p=3,n=s,l=lat
naBasvAn	naBasvant	pos=n,g=m,c=1,n=s
prozitAnAm	pravas	pos=va,g=m,c=6,n=p,f=part
manAMsi	manas	pos=n,g=n,c=2,n=p

# id = Rtu.2.28
jala	jala	pos=n,comp=y
Bara	Bara	pos=n,comp=y
namitAnAm	namay	pos=va,g=m,c=6,n=p,f=part
ASrayo	ASraya	pos=n,g=m,c=1,n=s
'smAkam	mad	pos=n,g=,c=6,n=p
uccEs	uccEs	pos=i
ayam	idam	pos=n,g=m,c=1,n=s
iti	iti	pos=i
jala	jala	pos=n,comp=y
sekEH	seka	pos=n,g=m,c=3,n=p
toyadAH	toyada	pos=n,g=m,c=1,n=p
toya	toya	pos=n,comp=y
namrAH	namra	pos=a,g=m,c=1,n=p
atiSaya	atiSaya	pos=n,comp=y
paruzABiH	paruza	pos=a,g=f,c=3,n=p
grIzma	grIzma	pos=n,comp=y
vahneH	vahni	pos=n,g=m,c=6,n=s
SiKABiH	SiKA	pos=n,g=f,c=3,n=p
samupajanay	samupajanay	pos=va,comp=y,f=part
tApam	tApa	pos=n,g=m,c=2,n=s
hlAdayanti	hlAday	pos=v,p=3,n=p,l=lat
iva	iva	pos=i
vinDyam	vinDya	pos=n,g=m,c=2,n=s

# id = Rtu.2.29
bahuguRa	bahuguRa	pos=a,comp=y
ramaRIyaH	ramaRIya	pos=a,g=m,c=1,n=s
kAminI	kAminI	pos=n,comp=y
citta	citta	pos=n,comp=y
hArI	hArin	pos=a,g=m,c=1,n=s
taru	taru	pos=n,comp=y
viwapa	viwapa	pos=n,comp=y
latAnAm	latA	pos=n,g=f,c=6,n=p
bAnDavo	bAnDava	pos=n,g=m,c=1,n=s
nirvikAraH	nirvikAra	pos=a,g=m,c=1,n=s
jalada	jalada	pos=n,comp=y
samayaH	samaya	pos=n,g=m,c=1,n=s
eza	etad	pos=n,g=m,c=1,n=s
prARinAm	prARin	pos=n,g=m,c=6,n=p
prARa	prARa	pos=n,comp=y
BUtaH	BU	pos=va,g=m,c=1,n=s,f=part
diSatu	diS	pos=v,p=3,n=s,l=lot
tava	tvad	pos=n,g=,c=6,n=s
hitAni	hita	pos=n,g=n,c=2,n=p
prAyaSo	prAyaSas	pos=i
vAYCitAni	vAYC	pos=va,g=n,c=2,n=p,f=part

# id = Rtu.3.1
kASa	kASa	pos=n,comp=y
aMSukA	aMSuka	pos=n,g=f,c=1,n=s
vikaca	vikaca	pos=a,comp=y
padma	padma	pos=n,comp=y
manojYa	manojYa	pos=a,comp=y
vaktrA	vaktra	pos=n,g=f,c=1,n=s
sa	sa	pos=i
unmAda	unmAda	pos=n,comp=y
haMsa	haMsa	pos=n,comp=y
rava	rava	pos=n,comp=y
nUpura	nUpura	pos=n,comp=y
nAda	nAda	pos=n,comp=y
ramyA	ramya	pos=a,g=f,c=1,n=s
Apakva	Apakva	pos=a,comp=y
SAli	SAli	pos=n,comp=y
rucira	rucira	pos=a,comp=y
Anata	Anam	pos=va,comp=y,f=part
gAtrayazwiH	gAtrayazwi	pos=n,g=f,c=1,n=s
prAptA	prAp	pos=va,g=f,c=1,n=s,f=part
Sarad	Sarad	pos=n,g=f,c=1,n=s
nava	nava	pos=a,comp=y
vaDUH	vaDU	pos=n,g=f,c=1,n=s
iva	iva	pos=i
rUpa	rUpa	pos=n,comp=y
ramyA	ramya	pos=a,g=f,c=1,n=s

# id = Rtu.3.2
kASEH	kASa	pos=n,g=m,c=3,n=p
mahI	mahI	pos=n,g=f,c=1,n=s
SiSiradIDitinA	SiSiradIDiti	pos=n,g=m,c=3,n=s
rajanyo	rajanI	pos=n,g=f,c=1,n=p
haMsEH	haMsa	pos=n,g=m,c=3,n=p
jalAni	jala	pos=n,g=n,c=1,n=p
saritAm	sarit	pos=n,g=f,c=6,n=p
kumudEH	kumuda	pos=n,g=m,c=3,n=p
sarAMsi	saras	pos=n,g=n,c=1,n=p
saptacCadEH	saptacCada	pos=n,g=n,c=3,n=p
kusuma	kusuma	pos=n,comp=y
BAra	BAra	pos=n,comp=y
natEH	nam	pos=va,g=m,c=3,n=p,f=part
vanAntAH	vanAnta	pos=n,g=m,c=1,n=p
SuklIkftAni	SuklIkfta	pos=a,g=n,c=1,n=p
upavanAni	upavana	pos=n,g=n,c=1,n=p
ca	ca	pos=i
mAlatIBiH	mAlatI	pos=n,g=f,c=3,n=p

# id = Rtu.3.3
caYcat	caYc	pos=va,comp=y,f=part
manojYa	manojYa	pos=a,comp=y
SaParI	SaParI	pos=n,comp=y
rasanA	rasanA	pos=n,comp=y
kalApa	kalApa	pos=n,g=f,c=1,n=p
paryanta	paryanta	pos=n,comp=y
saMsTita	saMsTA	pos=va,comp=y,f=part
sita	sita	pos=a,comp=y
aRqaja	aRqaja	pos=n,comp=y
paNkti	paNkti	pos=n,comp=y
hArAH	hAra	pos=n,g=f,c=1,n=p
nadyo	nadI	pos=n,g=f,c=1,n=p
viSAla	viSAla	pos=a,comp=y
pulina	pulina	pos=n,comp=y
anta	anta	pos=n,comp=y
nitamba	nitamba	pos=n,comp=y
bimba	bimba	pos=n,g=f,c=1,n=p
mandam	manda	pos=a,g=n,c=2,n=s
prayAnti	prayA	pos=v,p=3,n=p,l=lat
samadAH	samada	pos=a,g=f,c=1,n=p
pramadA	pramadA	pos=n,g=f,c=1,n=p
iva	iva	pos=i
adya	adya	pos=i

# id = Rtu.3.4
vyoma	vyoman	pos=n,g=n,c=1,n=s
kvacid	kvacid	pos=i
rajata	rajata	pos=n,comp=y
SaNKa	SaNKa	pos=n,comp=y
mfRAla	mfRAla	pos=n,comp=y
gOrEH	gOra	pos=a,g=n,c=3,n=p
tyakta	tyaj	pos=va,comp=y,f=part
ambuBiH	ambu	pos=n,g=n,c=3,n=p
laGutayA	laGutA	pos=n,g=f,c=3,n=s
SataSaH	SataSas	pos=i
prayAtEH	prayA	pos=va,g=m,c=3,n=p,f=part
saMlakzyate	saMlakzay	pos=v,p=3,n=s,l=lat
pavana	pavana	pos=n,comp=y
vega	vega	pos=n,comp=y
calEH	cala	pos=a,g=m,c=3,n=p
rAjA	rAjan	pos=n,g=m,c=1,n=s
iva	iva	pos=i
cAmara	cAmara	pos=n,comp=y
SatEH	Sata	pos=n,g=m,c=3,n=p
cAmaraSatEH	upavIj	pos=va,g=m,c=1,n=s,f=part

# id = Rtu.3.5
BinnAYjana	BinnAYjana	pos=n,comp=y
pracaya	pracaya	pos=n,comp=y
kAnti	kAnti	pos=n,g=n,c=1,n=s
naBo	naBas	pos=n,g=n,c=1,n=s
manojYam	manojYa	pos=a,g=n,c=1,n=s
banDUka	banDUka	pos=n,comp=y
puzpa	puzpa	pos=n,comp=y
rajasA	rajas	pos=n,g=n,c=3,n=s
aruRitA	aruRita	pos=a,g=f,c=1,n=s
ca	ca	pos=i
BUmiH	BUmi	pos=n,g=f,c=1,n=s
vaprAH	vapra	pos=n,g=m,c=1,n=p
ca	ca	pos=i
pakva	pakva	pos=a,comp=y
kalama	kalama	pos=n,comp=y
Avfta	Avf	pos=va,comp=y,f=part
BUmi	BUmi	pos=n,comp=y
BAgAH	BAga	pos=n,g=m,c=1,n=p
protkaRWayanti	protkaRWay	pos=v,p=3,n=p,l=lat
na	na	pos=i
mano	manas	pos=n,g=n,c=2,n=s
Buvi	BU	pos=n,g=f,c=7,n=s
kasya	ka	pos=n,g=m,c=6,n=s
yUnaH	yuvan	pos=n,g=m,c=6,n=s

# id = Rtu.3.6
manda	manda	pos=a,comp=y
anila	anila	pos=n,comp=y
Akulita	Akulita	pos=a,comp=y
cArutara	cArutara	pos=a,comp=y
agra	agra	pos=n,comp=y
SAKaH	SAKA	pos=n,g=m,c=1,n=s
puzpa	puzpa	pos=n,comp=y
udgama	udgama	pos=n,comp=y
pracaya	pracaya	pos=n,comp=y
komala	komala	pos=a,comp=y
pallava	pallava	pos=n,comp=y
agraH	agra	pos=n,g=m,c=1,n=s
matta	mad	pos=va,comp=y,f=part
dvirePa	dvirePa	pos=n,comp=y
paripA	paripA	pos=va,comp=y,f=part
maDu	maDu	pos=n,comp=y
prasekaH	praseka	pos=n,g=m,c=1,n=s
cittam	citta	pos=n,g=n,c=2,n=s
vidArayati	vidAray	pos=v,p=3,n=s,l=lat
kasya	ka	pos=n,g=m,c=6,n=s
na	na	pos=i
kovidAraH	kovidAra	pos=n,g=m,c=1,n=s

# id = Rtu.3.7
tArA	tArA	pos=n,comp=y
gaRa	gaRa	pos=n,comp=y
pravara	pravara	pos=a,comp=y
BUzaRam	BUzaRa	pos=n,g=n,c=2,n=s
udvahantI	udvah	pos=va,g=f,c=1,n=s,f=part
meGa	meGa	pos=n,comp=y
avaroDa	avaroDa	pos=n,comp=y
parimukta	parimuc	pos=va,comp=y,f=part
SaSANka	SaSANka	pos=n,comp=y
vaktrA	vaktra	pos=n,g=f,c=1,n=s
jyotsnA	jyotsnA	pos=n,comp=y
dukUlam	dukUla	pos=n,g=n,c=2,n=s
amalam	amala	pos=a,g=n,c=2,n=s
rajanI	rajanI	pos=n,g=f,c=1,n=s
daDAnA	DA	pos=va,g=f,c=1,n=s,f=part
vfdDim	vfdDi	pos=n,g=f,c=2,n=s
prayAti	prayA	pos=v,p=3,n=s,l=lat
anudinam	anudinam	pos=i
pramadA	pramadA	pos=n,g=f,c=1,n=s
iva	iva	pos=i
bAlA	bAlA	pos=n,g=f,c=1,n=s

# id = Rtu.3.8
kAraRqava	kAraRqava	pos=n,comp=y
Anana	Anana	pos=n,comp=y
viGawway	viGawway	pos=va,comp=y,f=part
vIci	vIci	pos=n,comp=y
mAlAH	mAlA	pos=n,g=f,c=1,n=p
kAdamba	kAdamba	pos=n,comp=y
sArasa	sArasa	pos=n,comp=y
kula	kula	pos=n,comp=y
Akula	Akula	pos=a,comp=y
tIra	tIra	pos=n,comp=y
deSa	deSa	pos=n,g=f,c=1,n=p
kurvanti	kf	pos=v,p=3,n=p,l=lat
haMsa	haMsa	pos=n,comp=y
virutEH	viruta	pos=n,g=n,c=3,n=p
parito	paritas	pos=i
janasya	jana	pos=n,g=m,c=6,n=s
prItim	prIti	pos=n,g=f,c=2,n=s
saroruha	saroruha	pos=n,comp=y
rajaH	rajas	pos=n,comp=y
aruRita	aruRita	pos=a,g=f,c=1,n=p
tawinyaH	tawinI	pos=n,g=f,c=1,n=p

# id = Rtu.3.9
netra	netra	pos=n,comp=y
utsavaH	utsava	pos=n,g=m,c=1,n=s
hfdaya	hfdaya	pos=n,comp=y
hAri	hArin	pos=a,comp=y
marIci	marIci	pos=n,comp=y
mAlaH	mAlA	pos=n,g=m,c=1,n=s
prahlAdakaH	prahlAdaka	pos=a,g=,c=1,n=s
SiSira	SiSira	pos=a,comp=y
sIkara	sIkara	pos=n,comp=y
vAri	vAri	pos=n,comp=y
varzI	varzin	pos=a,g=m,c=1,n=s
patyuH	pati	pos=n,g=,c=6,n=s
viyoga	viyoga	pos=n,comp=y
viza	viza	pos=n,comp=y
dagDa	dah	pos=va,comp=y,f=part
Sara	Sara	pos=n,comp=y
kzatAnAm	kzan	pos=va,g=f,c=6,n=p,f=part
candro	candra	pos=n,g=m,c=1,n=s
dahati	dah	pos=v,p=3,n=s,l=lat
atitarAm	atitarAm	pos=i
tanum	tanu	pos=n,g=f,c=2,n=s
aNganAnAm	aNganA	pos=n,g=f,c=6,n=p

# id = Rtu.3.10
Akampayan	Akampay	pos=va,g=m,c=1,n=s,f=part
Pala	Pala	pos=n,comp=y
Bara	Bara	pos=n,comp=y
Anata	Anam	pos=va,comp=y,f=part
SAli	SAli	pos=n,comp=y
jAlAni	jAla	pos=n,g=n,c=2,n=p
Anartay	Anartay	pos=va,g=m,c=1,n=s,f=part
taruvarAn	taruvara	pos=n,g=m,c=2,n=p
kusuma	kusuma	pos=n,comp=y
avanamrAn	avanamra	pos=a,g=m,c=2,n=p
utPulla	utPulla	pos=a,comp=y
paNkaja	paNkaja	pos=n,comp=y
vanAm	vana	pos=n,g=f,c=2,n=s
nalinIm	nalinI	pos=n,g=f,c=2,n=s
viDUnvan	viDU	pos=va,g=m,c=1,n=s,f=part
yUnAm	yuvan	pos=n,g=m,c=6,n=p
manaH	manas	pos=n,g=n,c=2,n=s
calayati	calay	pos=v,p=3,n=s,l=lat
prasaBam	prasaBam	pos=i
naBasvAn	naBasvant	pos=n,g=m,c=1,n=s

# id = Rtu.3.11
sa	sa	pos=i
unmAda	unmAda	pos=n,comp=y
haMsa	haMsa	pos=n,comp=y
miTunEH	miTuna	pos=n,g=n,c=3,n=p
upaSoBitAni	upaSoBay	pos=va,g=n,c=1,n=p,f=part
svacCa	svacCa	pos=a,comp=y
praPulla	praPulla	pos=a,comp=y
kamala	kamala	pos=n,comp=y
utpala	utpala	pos=n,comp=y
BUzitAni	BUzay	pos=va,g=n,c=1,n=p,f=part
manda	manda	pos=a,comp=y
praBAta	praBAta	pos=n,comp=y
pavana	pavana	pos=n,comp=y
udgata	udgam	pos=va,comp=y,f=part
vIci	vIci	pos=n,comp=y
mAlA	mAlA	pos=n,g=n,c=1,n=p
utkaRWayanti	utkaRWay	pos=v,p=3,n=p,l=lat
sahasA	sahas	pos=n,g=n,c=3,n=s
hfdayam	hfdaya	pos=n,g=n,c=2,n=s
sarAMsi	saras	pos=n,g=n,c=1,n=p

# id = Rtu.3.12
nazwam	naS	pos=va,g=n,c=1,n=s,f=part
DanuH	Danus	pos=n,g=n,c=1,n=s
balaBid	balaBid	pos=n,g=m,c=1,n=p
jalada	jalada	pos=n,comp=y
udarezu	udara	pos=n,g=n,c=7,n=p
sOdAminI	sOdAminI	pos=n,g=f,c=1,n=s
sPurati	sPur	pos=v,p=3,n=s,l=lat
na	na	pos=i
adya	adya	pos=i
viyatpatAkA	viyatpatAkA	pos=n,g=f,c=1,n=s
Dunvanti	DU	pos=v,p=3,n=p,l=lat
pakza	pakza	pos=n,comp=y
pavanEH	pavana	pos=n,g=m,c=3,n=p
na	na	pos=i
naBo	naBas	pos=n,g=n,c=2,n=s
balAkAH	balAkA	pos=n,g=f,c=1,n=p
paSyanti	dfS	pos=v,p=3,n=p,l=lat
na	na	pos=i
unnata	unnam	pos=va,comp=y,f=part
muKAH	muKa	pos=n,g=m,c=1,n=p
gaganam	gagana	pos=n,g=n,c=2,n=s
mayUrAH	mayUra	pos=n,g=m,c=1,n=p

# id = Rtu.3.13
nftya	nftya	pos=n,comp=y
prayoga	prayoga	pos=n,comp=y
rahitAn	rahita	pos=a,g=m,c=2,n=p
SiKin	SiKin	pos=n,g=m,c=2,n=p
vihAya	vihA	pos=vi
haMsAn	haMsa	pos=n,g=m,c=2,n=p
upEti	upe	pos=v,p=3,n=s,l=lat
madano	madana	pos=n,g=m,c=1,n=s
maDura	maDura	pos=a,comp=y
pragItAn	pragA	pos=va,g=m,c=2,n=p,f=part
muktvA	muc	pos=vi
kadamba	kadamba	pos=n,comp=y
kuwaja	kuwaja	pos=n,comp=y
arjuna	arjuna	pos=n,comp=y
sarja	sarja	pos=n,comp=y
nIpAn	nIpa	pos=n,g=m,c=2,n=p
saptacCadAn	saptacCada	pos=n,g=m,c=2,n=p
upagatA	upagam	pos=va,g=f,c=1,n=s,f=part
kusuma	kusuma	pos=n,comp=y
udgama	udgama	pos=n,comp=y
SrIH	SrI	pos=n,g=f,c=1,n=s

# id = Rtu.3.14
SePAlikA	SePAlikA	pos=n,comp=y
kusuma	kusuma	pos=n,comp=y
ganDa	ganDa	pos=n,comp=y
manoharAni	manohara	pos=a,g=n,c=1,n=p
svasTa	svasTa	pos=a,comp=y
sTita	sTA	pos=va,comp=y,f=part
aRqaja	aRqaja	pos=a,comp=y
kula	kula	pos=n,comp=y
pratinAditAni	pratinAday	pos=va,g=n,c=1,n=p,f=part
paryanta	paryanta	pos=n,comp=y
saMsTita	saMsTA	pos=va,comp=y,f=part
mfgI	mfgI	pos=n,comp=y
nayana	nayana	pos=n,comp=y
utpalAni	utpala	pos=n,g=n,c=1,n=p
protkaRWayanti	protkaRWay	pos=v,p=3,n=p,l=lat
upavanAni	upavana	pos=n,g=n,c=1,n=p
manAMsi	manas	pos=n,g=n,c=2,n=p
puMsAm	puMs	pos=n,g=m,c=6,n=p

# id = Rtu.3.15
kahlAra	kahlAra	pos=n,comp=y
padma	padma	pos=n,comp=y
kumudAni	kumuda	pos=n,g=n,c=2,n=p
muhuH	muhur	pos=i
viDUnvan	viDU	pos=va,g=m,c=1,n=s,f=part
tad	tad	pos=n,comp=y
saMgamAt	saMgama	pos=n,g=m,c=5,n=s
aDika	aDika	pos=a,comp=y
SItalatAm	SItalatA	pos=n,g=f,c=2,n=s
upetaH	upe	pos=va,g=m,c=1,n=s,f=part
utkaRWayati	utkaRWay	pos=v,p=3,n=s,l=lat
atitarAm	atitarAm	pos=i
pavanaH	pavana	pos=n,g=m,c=1,n=s
praBAte	praBAta	pos=n,g=n,c=7,n=s

# id = Rtu.3.16
sampanna	sampad	pos=va,comp=y,f=part
SAli	SAli	pos=n,comp=y
nicaya	nicaya	pos=n,comp=y
Avfta	Avf	pos=va,comp=y,f=part
BU	BU	pos=n,comp=y
talAni	tala	pos=n,g=n,c=1,n=p
svasTa	svasTa	pos=a,comp=y
sTita	sTA	pos=va,comp=y,f=part
pracura	pracura	pos=a,comp=y
go	go	pos=i
kula	kula	pos=n,comp=y
SoBitAni	SoBay	pos=va,g=n,c=1,n=p,f=part
haMsEH	haMsa	pos=n,g=m,c=3,n=p
sasArasa	sasArasa	pos=a,comp=y
kulEH	kula	pos=n,g=m,c=3,n=p
pratinAditAni	pratinAday	pos=va,g=n,c=1,n=p,f=part
sImAntarARi	sImAntara	pos=n,g=n,c=1,n=p
janayanti	janay	pos=v,p=3,n=p,l=lat
nfRAm	nf	pos=n,g=,c=6,n=p
pramodam	pramoda	pos=n,g=m,c=2,n=s

# id = Rtu.3.17
haMsEH	haMsa	pos=n,g=m,c=3,n=p
jitA	ji	pos=va,g=f,c=1,n=s,f=part
su	su	pos=i
lalitA	lalita	pos=a,g=f,c=1,n=s
gatiH	gati	pos=n,g=f,c=1,n=s
aNganA	aNganA	pos=n,g=m,c=6,n=p
amBoruhEH	amBoruha	pos=n,g=n,c=3,n=p
vikasitEH	vikas	pos=va,g=m,c=3,n=p,f=part
muKa	muKa	pos=n,comp=y
candra	candra	pos=n,comp=y
kAntiH	kAnti	pos=n,g=f,c=1,n=s
nIlotpalEH	nIlotpala	pos=n,g=n,c=3,n=p
mada	mada	pos=n,comp=y
kalAni	kala	pos=a,g=n,c=1,n=p
vilocanAni	vilocana	pos=n,g=n,c=1,n=p
BrU	BrU	pos=n,comp=y
viBramAH	viBrama	pos=n,g=m,c=1,n=p
ca	ca	pos=i
rucirAs	rucira	pos=a,g=m,c=1,n=p
tanuBis	tanu	pos=n,g=f,c=3,n=p
taraMgEH	taraMga	pos=n,g=m,c=3,n=p

# id = Rtu.3.18
SyAmA	SyAma	pos=a,g=f,c=1,n=p
latAH	latA	pos=n,g=f,c=1,n=p
kusuma	kusuma	pos=n,comp=y
BAra	BAra	pos=n,comp=y
nata	nam	pos=va,comp=y,f=part
pravAlAH	pravAla	pos=n,g=f,c=1,n=p
strIRAm	strI	pos=n,g=f,c=6,n=p
haranti	hf	pos=v,p=3,n=p,l=lat
Dfta	Df	pos=va,comp=y,f=part
BUzaRa	BUzaRa	pos=n,comp=y
bAhu	bAhu	pos=n,comp=y
kAntim	kAnti	pos=n,g=f,c=2,n=s
danta	danta	pos=n,comp=y
avaBAsa	avaBAsa	pos=n,comp=y
viSada	viSada	pos=a,comp=y
smita	smita	pos=n,comp=y
candra	candra	pos=n,comp=y
kAntim	kAnti	pos=n,g=f,c=2,n=s
kaNkeli	kaNkeli	pos=n,comp=y
puzpa	puzpa	pos=n,comp=y
rucirA	rucira	pos=a,g=f,c=1,n=s
nava	nava	pos=a,comp=y
mAlatI	mAlatI	pos=n,g=f,c=1,n=s
ca	ca	pos=i

# id = Rtu.3.19
keSAn	keSa	pos=n,g=m,c=2,n=p
nitAnta	nitAnta	pos=a,comp=y
Gana	Gana	pos=a,comp=y
nIla	nIla	pos=a,comp=y
vikuYcita	vikuYcita	pos=a,comp=y
agrAn	agra	pos=n,g=m,c=2,n=p
ApUrayanti	ApUray	pos=v,p=3,n=p,l=lat
vanitA	vanitA	pos=n,g=f,c=1,n=s
nava	nava	pos=a,comp=y
mAlatI	mAlatI	pos=n,g=f,c=3,n=p
karRezu	karRa	pos=n,g=m,c=7,n=p
ca	ca	pos=i
pravara	pravara	pos=a,comp=y
kAYcana	kAYcana	pos=n,comp=y
kuRqalezu	kuRqala	pos=n,g=n,c=7,n=p
nIlotpalAni	nIlotpala	pos=n,g=n,c=2,n=p
viviDAni	viviDa	pos=a,g=n,c=2,n=p
niveSayanti	niveSay	pos=v,p=3,n=p,l=lat

# id = Rtu.3.20
hArEH	hAra	pos=n,g=m,c=3,n=p
sacandana	sacandana	pos=a,comp=y
rasEH	rasa	pos=n,g=m,c=3,n=p
stana	stana	pos=n,comp=y
maRqalAni	maRqala	pos=n,g=n,c=2,n=p
SroRI	SroRI	pos=n,comp=y
tawam	tawa	pos=n,g=n,c=2,n=s
su	su	pos=i
vipulam	vipula	pos=a,g=n,c=2,n=s
rasanA	rasanA	pos=n,comp=y
kalApEH	kalApa	pos=n,g=m,c=3,n=p
pAda	pAda	pos=n,comp=y
ambujAni	ambuja	pos=n,g=n,c=2,n=p
kala	kala	pos=a,comp=y
nUpura	nUpura	pos=n,comp=y
SeKarEH	SeKara	pos=n,g=m,c=3,n=p
ca	ca	pos=i
nAryaH	nArI	pos=n,g=f,c=1,n=p
prahfH	prahfz	pos=va,comp=y,f=part
manasaH	manas	pos=n,g=f,c=1,n=p
'dya	adya	pos=i
viBUzayanti	viBUzay	pos=v,p=3,n=p,l=lat

# id = Rtu.3.21
sPuwa	sPuwa	pos=a,comp=y
kumuda	kumuda	pos=n,comp=y
citAnAm	cita	pos=a,g=m,c=6,n=p
rAjahaMsa	rAjahaMsa	pos=n,comp=y
ASritAnAm	ASri	pos=va,g=m,c=6,n=p,f=part
marakata	marakata	pos=n,comp=y
maRi	maRi	pos=n,comp=y
BAsA	BAs	pos=n,g=n,c=3,n=s
vAriRA	vAri	pos=n,g=n,c=3,n=s
BUzitAnAm	BUzay	pos=va,g=m,c=6,n=p,f=part
Sriyam	SrI	pos=n,g=f,c=2,n=s
atiSaya	atiSaya	pos=n,comp=y
rUpAm	rUpa	pos=n,g=f,c=2,n=s
vyoma	vyoman	pos=n,g=n,c=2,n=s
toyASayAnAm	toyASaya	pos=n,g=m,c=6,n=p
vahati	vah	pos=v,p=3,n=s,l=lat
vigata	vigam	pos=va,comp=y,f=part
meGam	meGa	pos=n,g=n,c=1,n=s
candra	candra	pos=n,comp=y
tArA	tArA	pos=n,comp=y
avakIrRam	avakf	pos=va,g=n,c=1,n=s,f=part

# id = Rtu.3.22
Saradi	Sarad	pos=n,g=f,c=7,n=s
kumuda	kumuda	pos=n,comp=y
saNgataH	saNga	pos=n,g=m,c=5,n=s
vAyavaH	vAyu	pos=n,g=m,c=1,n=p
vAnti	vA	pos=v,p=3,n=p,l=lat
SItA	SIta	pos=a,g=m,c=1,n=p
vigata	vigam	pos=va,comp=y,f=part
jalada	jalada	pos=n,comp=y
vfndAH	vfnda	pos=n,g=m,c=1,n=p
diH	diS	pos=n,comp=y
viBAgAH	viBAga	pos=n,g=m,c=1,n=p
manojYAH	manojYa	pos=a,g=m,c=1,n=p
vigata	vigam	pos=va,comp=y,f=part
kaluzam	kaluza	pos=n,g=n,c=1,n=s
amBaH	amBas	pos=n,g=n,c=1,n=s
SyA	SyA	pos=va,comp=y,f=part
paNkA	paNka	pos=n,g=f,c=1,n=s
DaritrI	DaritrI	pos=n,g=f,c=1,n=s
vimala	vimala	pos=a,comp=y
kiraRa	kiraRa	pos=n,comp=y
candram	candra	pos=n,g=n,c=1,n=s
vyoma	vyoman	pos=n,g=n,c=1,n=s
tArA	tArA	pos=n,comp=y
vicitram	vicitra	pos=a,g=n,c=1,n=s

# id = Rtu.3.23
kara	kara	pos=n,comp=y
kamala	kamala	pos=n,comp=y
manojYa	manojYa	pos=a,g=f,c=1,n=p
kAnta	kAnta	pos=n,comp=y
saMsakta	saMsaYj	pos=va,comp=y,f=part
hastAH	hasta	pos=n,g=f,c=1,n=p
vadana	vadana	pos=n,comp=y
vijita	viji	pos=va,comp=y,f=part
candra	candra	pos=n,g=f,c=1,n=p
kAScid	kaScit	pos=n,g=f,c=1,n=p
anyAH	anya	pos=n,g=f,c=1,n=p
taruRyaH	taruRa	pos=a,g=f,c=1,n=p
racita	racay	pos=va,comp=y,f=part
kusuma	kusuma	pos=n,comp=y
ganDi	ganDi	pos=a,g=n,c=2,n=s
prAyaSo	prAyaSas	pos=i
yAnti	yA	pos=v,p=3,n=p,l=lat
veSma	veSman	pos=n,g=n,c=2,n=s
prabala	prabala	pos=a,comp=y
madana	madana	pos=n,comp=y
hetoH	hetu	pos=n,g=m,c=5,n=s
tyakta	tyaj	pos=va,comp=y,f=part
saMgIta	saMgIta	pos=n,comp=y
rAgAH	rAga	pos=n,g=f,c=1,n=p

# id = Rtu.3.24
surata	surata	pos=n,comp=y
rasa	rasa	pos=n,comp=y
vilAsa	vilAsa	pos=n,g=f,c=1,n=p
sat	as	pos=va,comp=y,f=part
saKIBiH	saKI	pos=n,g=f,c=3,n=p
sametA	same	pos=va,g=f,c=1,n=p,f=part
asamaSara	asamaSara	pos=n,comp=y
vinodam	vinoda	pos=n,g=m,c=2,n=s
sUcayanti	sUcay	pos=v,p=3,n=p,l=lat
prakAmam	prakAma	pos=n,g=m,c=2,n=s
anupama	anupama	pos=a,comp=y
muKa	muKa	pos=n,comp=y
rAgAH	rAga	pos=n,g=f,c=1,n=p
rAtri	rAtri	pos=n,comp=y
maDye	maDya	pos=n,g=n,c=7,n=s
vinodam	vinoda	pos=n,g=m,c=2,n=s
Saradi	Sarad	pos=n,g=f,c=7,n=s
taruRa	taruRa	pos=a,comp=y
kAnta	kAnta	pos=n,g=f,c=1,n=p
sUcayanti	sUcay	pos=v,p=3,n=p,l=lat
pramodAn	pramoda	pos=n,g=m,c=2,n=p

# id = Rtu.3.25
divasakara	divasakara	pos=n,comp=y
mayUKEH	mayUKa	pos=n,g=m,c=3,n=p
bADyamAnam	bAD	pos=va,g=n,c=1,n=s,f=part
praBAte	praBAta	pos=n,g=n,c=7,n=s
vara	vara	pos=a,comp=y
yuvati	yuvati	pos=n,comp=y
muKa	muKa	pos=n,comp=y
ABam	ABa	pos=a,g=n,c=1,n=s
paNkajam	paNkaja	pos=n,g=n,c=1,n=s
jfmBate	jfmB	pos=v,p=3,n=s,l=lat
adya	adya	pos=i
kumudam	kumuda	pos=n,g=n,c=1,n=s
api	api	pos=i
gate	gam	pos=va,g=m,c=7,n=s,f=part
astam	asta	pos=n,g=m,c=2,n=s
lIyate	lI	pos=v,p=3,n=s,l=lat
candra	candra	pos=n,comp=y
bimbe	bimba	pos=n,g=m,c=7,n=s
hasitam	has	pos=va,g=n,c=1,n=s,f=part
iva	iva	pos=i
vaDUnAm	vaDU	pos=n,g=f,c=6,n=p
prozitezu	pravas	pos=va,g=m,c=7,n=p,f=part
priyezu	priya	pos=a,g=m,c=7,n=p

# id = Rtu.3.26
asita	asita	pos=a,comp=y
nayana	nayana	pos=n,comp=y
lakzmyam	lakzmI	pos=n,g=f,c=2,n=s
lakzayitvA	lakzay	pos=vi
utpalezu	utpala	pos=n,g=m,c=7,n=p
kvaR	kvaR	pos=va,comp=y,f=part
kanaka	kanaka	pos=n,comp=y
kAYcIm	kAYcI	pos=n,g=f,c=2,n=s
matta	mad	pos=va,comp=y,f=part
haMsa	haMsa	pos=n,comp=y
svanezu	svana	pos=n,g=m,c=7,n=p
aDara	aDara	pos=n,comp=y
rucira	rucira	pos=a,comp=y
SoBAm	SoBA	pos=n,g=f,c=2,n=s
banDujIve	banDujIva	pos=n,g=m,c=7,n=s
priyARAm	priya	pos=a,g=f,c=6,n=p
paTika	paTika	pos=n,comp=y
janaH	jana	pos=n,g=m,c=1,n=s
idAnIm	idAnIm	pos=i
roditi	rud	pos=v,p=3,n=s,l=lat
BrAnta	Bram	pos=va,comp=y,f=part
cittaH	citta	pos=n,g=m,c=1,n=s

# id = Rtu.3.27
strIRAm	strI	pos=n,g=f,c=6,n=p
vihAya	vihA	pos=vi
vadanezu	vadana	pos=n,g=n,c=7,n=p
SaSANka	SaSANka	pos=n,comp=y
lakzmyam	lakzmI	pos=n,g=f,c=2,n=s
kAmyam	kAmya	pos=a,g=n,c=2,n=s
ca	ca	pos=i
haMsa	haMsa	pos=n,comp=y
vacanam	vacana	pos=n,g=n,c=2,n=s
maRi	maRi	pos=n,comp=y
nUpurezu	nUpura	pos=n,g=m,c=7,n=p
banDUka	banDUka	pos=n,comp=y
kAntim	kAnti	pos=n,g=f,c=2,n=s
aDarezu	aDara	pos=n,g=m,c=7,n=p
manoharezu	manohara	pos=a,g=m,c=7,n=p
kvApi	kvApi	pos=i
prayAti	prayA	pos=v,p=3,n=s,l=lat
suBagA	suBaga	pos=a,g=f,c=1,n=s
Sarad	Sarad	pos=n,comp=y
Agama	Agama	pos=n,comp=y
SrIH	SrI	pos=n,g=f,c=1,n=s

# id = Rtu.3.28
vikaca	vikaca	pos=a,comp=y
kamala	kamala	pos=n,comp=y
vaktrA	vaktra	pos=n,g=f,c=1,n=s
Pulla	Pulla	pos=a,comp=y
nIlotpala	nIlotpala	pos=n,comp=y
akzI	akzI	pos=n,g=f,c=1,n=s
vikasita	vikas	pos=va,comp=y,f=part
nava	nava	pos=a,comp=y
kASa	kASa	pos=n,comp=y
Sveta	Sveta	pos=a,comp=y
vAsaH	vAsas	pos=n,g=n,c=2,n=s
vasAnA	vas	pos=va,g=f,c=1,n=s,f=part
kumuda	kumuda	pos=n,comp=y
rucira	rucira	pos=a,comp=y
kAntiH	kAnti	pos=n,g=f,c=1,n=s
kAminI	kAminI	pos=n,g=f,c=1,n=s
iva	iva	pos=i
unmadA	unmada	pos=a,g=f,c=1,n=s
iyam	idam	pos=n,g=f,c=1,n=s
pratidiSatu	pratidiS	pos=v,p=3,n=s,l=lot
Sarad	Sarad	pos=n,g=f,c=1,n=s
vaH	tvad	pos=n,g=,c=6,n=p
cetasaH	cetas	pos=n,g=n,c=6,n=s
prItim	prIti	pos=n,g=f,c=2,n=s
agryAm	agrya	pos=a,g=f,c=2,n=s

# id = Rtu.4.1
nava	nava	pos=a,comp=y
pravAla	pravAla	pos=n,comp=y
udgama	udgama	pos=n,comp=y
sasya	sasya	pos=n,comp=y
ramyaH	ramya	pos=a,g=m,c=1,n=s
praPulla	praPulla	pos=a,comp=y
loDraH	loDra	pos=n,g=m,c=1,n=s
paripakva	paripakva	pos=a,comp=y
SAliH	SAli	pos=n,g=m,c=1,n=s
vilIna	vilI	pos=va,comp=y,f=part
padmaH	padma	pos=n,g=m,c=1,n=s
prapat	prapat	pos=va,comp=y,f=part
tuzAraH	tuzAra	pos=n,g=m,c=1,n=s
hemanta	hemanta	pos=n,comp=y
kAlaH	kAla	pos=n,g=m,c=1,n=s
samupAgataH	samupAgam	pos=va,g=m,c=1,n=s,f=part
ayam	idam	pos=n,g=m,c=1,n=s

# id = Rtu.4.2
manoharEH	manohara	pos=a,g=m,c=3,n=p
candana	candana	pos=n,comp=y
rAga	rAga	pos=n,comp=y
gOrEH	gOra	pos=a,g=m,c=3,n=p
tuzAra	tuzAra	pos=n,comp=y
kunda	kunda	pos=n,comp=y
indu	indu	pos=n,comp=y
niBEH	niBa	pos=a,g=m,c=3,n=p
ca	ca	pos=i
hArEH	hAra	pos=n,g=m,c=3,n=p
vilAsinInAm	vilAsinI	pos=n,g=f,c=6,n=p
stana	stana	pos=n,comp=y
SAlin	SAlin	pos=a,g=f,c=6,n=p
na	na	pos=i
alaMkriyante	alaMkf	pos=v,p=3,n=p,l=lat
stana	stana	pos=n,comp=y
maRqalAni	maRqala	pos=n,g=n,c=1,n=p

# id = Rtu.4.3
na	na	pos=i
bAhu	bAhu	pos=n,comp=y
yugmezu	yugma	pos=n,g=n,c=7,n=p
vilAsinInAm	vilAsinI	pos=n,g=f,c=6,n=p
prayAnti	prayA	pos=v,p=3,n=p,l=lat
saNgam	saNga	pos=n,g=m,c=2,n=s
valaya	valaya	pos=n,comp=y
aNgadAni	aNgada	pos=n,g=n,c=1,n=p
nitamba	nitamba	pos=n,comp=y
bimbezu	bimba	pos=n,g=m,c=7,n=p
navam	nava	pos=a,g=n,c=1,n=s
dukUlam	dukUla	pos=n,g=n,c=1,n=s
tanu	tanu	pos=a,g=n,c=1,n=s
aMSukam	aMSuka	pos=n,g=n,c=1,n=s
pIna	pIna	pos=a,comp=y
payoDarezu	payoDara	pos=n,g=m,c=7,n=p

# id = Rtu.4.4
kAYcI	kAYcI	pos=n,comp=y
guREH	guRa	pos=n,g=m,c=3,n=p
kAYcana	kAYcana	pos=n,comp=y
ratna	ratna	pos=n,comp=y
citrEH	citra	pos=a,g=m,c=3,n=p
no	no	pos=i
BUzayanti	BUzay	pos=v,p=3,n=p,l=lat
pramadA	pramadA	pos=n,g=f,c=1,n=p
nitambAn	nitamba	pos=n,g=m,c=2,n=p
na	na	pos=i
nUpurEH	nUpura	pos=n,g=m,c=3,n=p
haMsa	haMsa	pos=n,comp=y
rutam	ruta	pos=n,g=n,c=1,n=s
BajadBiH	Baj	pos=va,g=m,c=3,n=p,f=part
pAda	pAda	pos=n,comp=y
ambujAni	ambuja	pos=n,g=n,c=1,n=p

# id = Rtu.4.5
gAtrARi	gAtra	pos=n,g=n,c=2,n=p
kAlIyaka	kAlIyaka	pos=n,comp=y
carcitAni	carcay	pos=va,g=n,c=2,n=p,f=part
sa	sa	pos=i
pattra	pattra	pos=n,comp=y
leKA	leKA	pos=n,g=n,c=2,n=p
muKa	muKa	pos=n,comp=y
ambujAni	ambuja	pos=n,g=n,c=2,n=p
SirAMsi	Siras	pos=n,g=n,c=2,n=p
kAlAguru	kAlAguru	pos=n,comp=y
DUpitAni	DUpay	pos=va,g=n,c=2,n=p,f=part
kurvanti	kf	pos=v,p=3,n=p,l=lat
nAryaH	nArI	pos=n,g=f,c=1,n=p
surata	surata	pos=n,comp=y
utsavAya	utsava	pos=n,g=m,c=4,n=s

# id = Rtu.4.6
rati	rati	pos=n,comp=y
Srama	Srama	pos=n,comp=y
kzAma	kzAma	pos=a,comp=y
vipARqu	vipARqu	pos=a,comp=y
vaktrAH	vaktra	pos=n,g=f,c=1,n=p
samprApta	samprAp	pos=va,comp=y,f=part
harza	harza	pos=n,comp=y
aByudaya	aByudaya	pos=n,g=f,c=1,n=p
taruRyaH	taruRa	pos=a,g=f,c=1,n=p
hasanti	has	pos=v,p=3,n=p,l=lat
na	na	pos=i
uccEs	uccEs	pos=i
daSana	daSana	pos=n,comp=y
agra	agra	pos=n,comp=y
BinnAn	Bid	pos=va,g=m,c=2,n=p,f=part
prapIqyamAnAn	prapIqay	pos=va,g=m,c=2,n=p,f=part
aDarAn	aDara	pos=n,g=m,c=2,n=p
avekzya	avekz	pos=vi

# id = Rtu.4.7
pIna	pIna	pos=a,comp=y
stana	stana	pos=n,comp=y
uraHsTala	uraHsTala	pos=n,comp=y
BAga	BAga	pos=n,comp=y
SoBAm	SoBA	pos=n,g=f,c=2,n=s
AsAdya	AsAday	pos=vi
tad	tad	pos=n,comp=y
pIqana	pIqana	pos=n,comp=y
jAta	jan	pos=va,comp=y,f=part
KedaH	Keda	pos=n,g=m,c=1,n=s
tfRa	tfRa	pos=n,comp=y
agra	agra	pos=n,comp=y
lagnEH	lag	pos=va,g=n,c=3,n=p,f=part
tuhinEH	tuhina	pos=n,g=n,c=3,n=p
patadBiH	pat	pos=va,g=n,c=3,n=p,f=part
Akrandati	Akrand	pos=v,p=3,n=s,l=lat
iva	iva	pos=i
uzasi	uzas	pos=n,g=f,c=7,n=s
SIta	SIta	pos=n,comp=y
kAlaH	kAla	pos=n,g=m,c=1,n=s

# id = Rtu.4.8
praBU	praBU	pos=va,comp=y,f=part
SAli	SAli	pos=n,comp=y
prasavEH	prasava	pos=n,g=m,c=3,n=p
citAni	cita	pos=a,g=n,c=1,n=p
mfga	mfga	pos=n,comp=y
aNganA	aNganA	pos=n,comp=y
yUTa	yUTa	pos=n,comp=y
viBUzitAni	viBUzay	pos=va,g=n,c=1,n=p,f=part
manohara	manohara	pos=a,comp=y
krOYca	krOYca	pos=n,comp=y
ninAditAni	ninAday	pos=va,g=n,c=1,n=p,f=part
sImAntarARy	sImAntara	pos=n,g=n,c=1,n=p
utsukayanti	utsukay	pos=v,p=3,n=p,l=lat
cetaH	cetas	pos=n,g=n,c=2,n=s

# id = Rtu.4.9
praPulla	praPulla	pos=a,comp=y
nIlotpala	nIlotpala	pos=n,comp=y
SoBitAni	SoBay	pos=va,g=n,c=1,n=p,f=part
sa	sa	pos=i
unmAda	unmAda	pos=n,comp=y
kAdamba	kAdamba	pos=n,comp=y
viBUzitAni	viBUzay	pos=va,g=n,c=1,n=p,f=part
prasanna	prasad	pos=va,comp=y,f=part
toyAni	toya	pos=n,g=n,c=1,n=p
suSItalAni	suSItala	pos=a,g=n,c=1,n=p
sarAMsi	saras	pos=n,g=n,c=1,n=p
cetAMsi	cetas	pos=n,g=n,c=2,n=p
haranti	hf	pos=v,p=3,n=p,l=lat
puMsAm	puMs	pos=n,g=m,c=6,n=p

# id = Rtu.4.10
mArgam	mArga	pos=n,g=m,c=2,n=s
samIkzya	samIkz	pos=vi
ati	ati	pos=i
nirasta	niras	pos=va,comp=y,f=part
nIram	nIra	pos=n,g=m,c=2,n=s
pravAsa	pravAsa	pos=n,comp=y
Kinnam	Kid	pos=va,g=m,c=2,n=s,f=part
patim	pati	pos=n,g=m,c=2,n=s
udvah	udvah	pos=va,g=f,c=1,n=p,f=part
avekzyamARA	avekz	pos=va,g=f,c=1,n=p,f=part
hariRa	hariRa	pos=n,comp=y
IkzaRa	IkzaRa	pos=n,comp=y
akzI	akzI	pos=n,g=f,c=1,n=p
praboDayanti	praboDay	pos=v,p=3,n=p,l=lat
iva	iva	pos=i
manoraTAni	manoraTa	pos=n,g=n,c=2,n=p

# id = Rtu.4.11
pAkam	pAka	pos=n,g=m,c=2,n=s
vrajantI	vraj	pos=va,g=f,c=1,n=s,f=part
hima	hima	pos=n,comp=y
jAta	jan	pos=va,comp=y,f=part
SItEH	SIta	pos=a,g=m,c=3,n=p
ADUyamAnA	ADU	pos=va,g=f,c=1,n=s,f=part
satatam	satatam	pos=i
marudBiH	marut	pos=n,g=,c=3,n=p
priye	priya	pos=a,g=f,c=8,n=s
priyaNguH	priyaNgu	pos=n,g=f,c=1,n=s
priya	priya	pos=a,comp=y
viprayuktA	viprayuj	pos=va,g=f,c=1,n=s,f=part
vipARqutAm	vipARqutA	pos=n,g=f,c=2,n=s
yAti	yA	pos=v,p=3,n=s,l=lat
vilAsinI	vilAsinI	pos=n,g=f,c=1,n=s
iva	iva	pos=i

# id = Rtu.4.12
puzpAsava	puzpAsava	pos=n,comp=y
Amoda	Amoda	pos=n,comp=y
suganDi	suganDi	pos=a,comp=y
vaktraH	vaktra	pos=n,g=m,c=1,n=s
niHSvAsa	niHSvAsa	pos=n,comp=y
vAtEH	vAta	pos=n,g=m,c=3,n=p
suraBIkf	suraBIkf	pos=va,comp=y,f=part
aNgaH	aNga	pos=n,g=m,c=1,n=s
paraspara	paraspara	pos=n,comp=y
aNga	aNga	pos=n,comp=y
vyatizaNga	vyatizaNga	pos=n,comp=y
SAyI	SAyin	pos=a,g=m,c=1,n=s
Sete	SI	pos=v,p=3,n=s,l=lat
janaH	jana	pos=n,g=m,c=1,n=s
kAma	kAma	pos=n,comp=y
rasa	rasa	pos=n,comp=y
anuvidDaH	anuvyaD	pos=va,g=m,c=1,n=s,f=part

# id = Rtu.4.13
dantacCadEH	dantacCada	pos=n,g=m,c=3,n=p
sa	sa	pos=i
vraRa	vraRa	pos=n,comp=y
danta	danta	pos=n,comp=y
cihnEH	cihna	pos=n,g=m,c=3,n=p
stanEH	stana	pos=n,g=m,c=3,n=p
ca	ca	pos=i
pARi	pARi	pos=n,comp=y
agra	agra	pos=n,comp=y
kfta	kf	pos=va,comp=y,f=part
aBileKEH	aBileKa	pos=n,g=m,c=3,n=p
saMsUcyate	saMsUcay	pos=v,p=3,n=s,l=lat
nirdayam	nirdaya	pos=a,g=n,c=2,n=s
aNganAnAm	aNganA	pos=n,g=f,c=6,n=p
rata	rata	pos=n,comp=y
upaBogaH	upaBoga	pos=n,g=m,c=1,n=s
nava	nava	pos=a,comp=y
yOvanAnAm	yOvana	pos=n,g=f,c=6,n=p

# id = Rtu.4.14
kAcid	kaScit	pos=n,g=f,c=1,n=s
viBUzayati	viBUzay	pos=v,p=3,n=s,l=lat
darpaRa	darpaRa	pos=n,comp=y
sakta	saYj	pos=va,comp=y,f=part
hastA	hasta	pos=n,g=f,c=1,n=s
bAla	bAla	pos=n,comp=y
Atapezu	Atapa	pos=n,g=m,c=7,n=p
vanitA	vanitA	pos=n,g=f,c=1,n=s
vadana	vadana	pos=n,comp=y
aravindam	aravinda	pos=n,g=n,c=2,n=s
dantacCadam	dantacCada	pos=n,g=m,c=2,n=s
priyatamena	priyatama	pos=a,g=m,c=3,n=s
nipIta	nipA	pos=va,comp=y,f=part
sAram	sAra	pos=n,g=m,c=2,n=s
danta	danta	pos=n,comp=y
agra	agra	pos=n,comp=y
Binnam	Bid	pos=va,g=m,c=2,n=s,f=part
avakfzya	avakfz	pos=vi
nirIkzate	nirIkz	pos=v,p=3,n=s,l=lat
ca	ca	pos=i

# id = Rtu.4.15
anyA	anya	pos=n,g=f,c=1,n=s
prakAma	prakAma	pos=n,comp=y
surata	surata	pos=n,comp=y
Srama	Srama	pos=n,comp=y
Kinna	Kid	pos=va,comp=y,f=part
dehA	deha	pos=n,g=f,c=1,n=s
rAtri	rAtri	pos=n,comp=y
prajAgara	prajAgara	pos=n,comp=y
vipAwala	vipAwala	pos=a,comp=y
netra	netra	pos=n,comp=y
padmA	padma	pos=n,g=f,c=1,n=s
srasta	sraMs	pos=va,comp=y,f=part
aMsa	aMsa	pos=n,comp=y
deSa	deSa	pos=n,comp=y
lalita	lalita	pos=a,comp=y
Akula	Akula	pos=a,comp=y
keSapASA	keSapASa	pos=n,g=f,c=1,n=s
nidrAm	nidrA	pos=n,g=f,c=2,n=s
prayAti	prayA	pos=v,p=3,n=s,l=lat
mfdu	mfdu	pos=a,comp=y
sUrya	sUrya	pos=n,comp=y
kara	kara	pos=n,comp=y
aBitaptA	aBitap	pos=va,g=f,c=1,n=s,f=part

# id = Rtu.4.16
nirmAlya	nirmAlya	pos=n,comp=y
dAma	dAman	pos=n,g=n,c=2,n=s
pariBukta	pariBuj	pos=va,comp=y,f=part
manojYa	manojYa	pos=a,comp=y
ganDam	ganDa	pos=n,g=n,c=2,n=s
mUrDno	mUrDan	pos=n,g=m,c=5,n=s
'panIya	apanI	pos=vi
Gana	Gana	pos=n,comp=y
nIla	nIla	pos=a,comp=y
Siroruha	Siroruha	pos=n,comp=y
antAH	anta	pos=n,g=f,c=1,n=p
pIna	pIna	pos=a,comp=y
unnata	unnam	pos=va,comp=y,f=part
stana	stana	pos=n,comp=y
Bara	Bara	pos=n,comp=y
Anata	Anam	pos=va,comp=y,f=part
gAtra	gAtra	pos=n,comp=y
yazwI	yazwI	pos=n,g=f,c=1,n=p
kurvanti	kf	pos=v,p=3,n=p,l=lat
keSa	keSa	pos=n,comp=y
racanAm	racanA	pos=n,g=f,c=2,n=s
aparAH	apara	pos=n,g=f,c=1,n=p
taruRyaH	taruRa	pos=a,g=f,c=1,n=p

# id = Rtu.4.17
anyA	anya	pos=n,g=f,c=1,n=s
priyeRa	priya	pos=a,g=m,c=3,n=s
pariBuktam	pariBuj	pos=va,g=n,c=2,n=s,f=part
avekzya	avekz	pos=vi
gAtram	gAtra	pos=n,g=n,c=2,n=s
harza	harza	pos=n,comp=y
anvitA	anvita	pos=a,g=f,c=1,n=s
viracita	viracay	pos=va,comp=y,f=part
aDara	aDara	pos=n,comp=y
cAru	cAru	pos=a,comp=y
SoBA	SoBA	pos=n,g=f,c=1,n=s
kUrpAsakam	kUrpAsaka	pos=n,g=m,c=2,n=s
paridaDAti	pariDA	pos=v,p=3,n=s,l=lat
naKa	naKa	pos=n,comp=y
kzata	kzata	pos=n,comp=y
aNgI	aNga	pos=a,g=f,c=1,n=s
vyAlambi	vyAlambin	pos=a,comp=y
nIla	nIla	pos=a,comp=y
lalita	lalita	pos=a,comp=y
alaka	alaka	pos=n,comp=y
kuYc	kuYc	pos=va,comp=y,f=part
akzI	akza	pos=a,g=f,c=1,n=s

# id = Rtu.4.18
anyAH	anya	pos=n,g=f,c=1,n=p
ciram	ciram	pos=i
surata	surata	pos=n,comp=y
keli	keli	pos=n,comp=y
pariSrameRa	pariSrama	pos=n,g=m,c=3,n=s
Kedam	Keda	pos=n,g=m,c=2,n=s
gatAH	gam	pos=va,g=f,c=1,n=p,f=part
praSiTilIkfta	praSiTilIkfta	pos=a,comp=y
gAtra	gAtra	pos=n,comp=y
yazwI	yazwI	pos=n,g=f,c=1,n=p
saMhfH	saMhfz	pos=va,comp=y,f=part
pulaka	pulaka	pos=n,comp=y
uru	uru	pos=a,comp=y
payoDara	payoDara	pos=n,comp=y
antAH	anta	pos=n,g=f,c=1,n=p
aByaYjanam	aByaYjana	pos=n,g=n,c=2,n=s
vidaDati	viDA	pos=v,p=3,n=p,l=lat
pramadAH	pramadA	pos=n,g=f,c=1,n=p
suSoBAH	suSoBa	pos=a,g=f,c=1,n=p

# id = Rtu.4.19
bahuguRa	bahuguRa	pos=a,comp=y
ramaRIyaH	ramaRIya	pos=a,g=m,c=1,n=s
yozitAm	yozit	pos=n,g=f,c=6,n=p
citta	citta	pos=n,comp=y
hArI	hArin	pos=a,g=m,c=1,n=s
pariRata	pariRam	pos=va,comp=y,f=part
bahu	bahu	pos=a,comp=y
SAli	SAli	pos=n,comp=y
vyAkula	vyAkula	pos=a,comp=y
grAma	grAma	pos=n,comp=y
sImA	sIman	pos=n,g=m,c=1,n=s
vinipatita	vinipat	pos=va,comp=y,f=part
tuzAraH	tuzAra	pos=n,g=m,c=1,n=s
krOYca	krOYca	pos=n,comp=y
nAda	nAda	pos=n,comp=y
upagItaH	upagA	pos=va,g=m,c=1,n=s,f=part
pradiSatu	pradiS	pos=v,p=3,n=s,l=lot
hima	hima	pos=n,comp=y
yuktaH	yuj	pos=va,g=m,c=1,n=s,f=part
kAla	kAla	pos=n,g=m,c=1,n=s
ezaH	etad	pos=n,g=m,c=1,n=s
suKam	suKa	pos=n,g=n,c=2,n=s
vaH	tvad	pos=n,g=,c=6,n=p

# id = Rtu.5.1
prarUQa	praruh	pos=va,comp=y,f=part
SAli	SAli	pos=n,comp=y
ikzu	ikzu	pos=n,comp=y
caya	caya	pos=n,comp=y
Avfta	Avf	pos=va,comp=y,f=part
kzitim	kziti	pos=n,g=m,c=2,n=s
kvacid	kvacid	pos=i
sTita	sTA	pos=va,comp=y,f=part
krOYca	krOYca	pos=n,comp=y
ninAda	ninAda	pos=n,comp=y
rAjitam	rAj	pos=va,g=m,c=2,n=s,f=part
prakAma	prakAma	pos=n,comp=y
kAmam	kAma	pos=n,g=m,c=2,n=s
pramadAH	pramadA	pos=n,g=f,c=1,n=p
jana	jana	pos=n,comp=y
priyam	priya	pos=a,g=m,c=2,n=s
vara	vara	pos=a,comp=y
Uru	Uru	pos=n,g=f,c=8,n=s
kAlam	kAla	pos=n,g=m,c=2,n=s
SiSira	SiSira	pos=n,comp=y
Ahvayam	Ahvaya	pos=n,g=m,c=2,n=s
SfRu	Sru	pos=v,p=2,n=s,l=lot

# id = Rtu.5.2
nirudDa	niruD	pos=va,comp=y,f=part
vAtAyana	vAtAyana	pos=n,comp=y
mandira	mandira	pos=n,comp=y
udaram	udara	pos=n,g=n,c=1,n=s
hutASano	hutASana	pos=n,g=m,c=1,n=s
BAnumato	BAnumant	pos=n,g=m,c=6,n=s
gaBastayaH	gaBasti	pos=n,g=m,c=1,n=p
gurURi	guru	pos=a,g=n,c=1,n=p
vAsAMsi	vAsas	pos=n,g=n,c=1,n=p
abalAH	abalA	pos=n,g=f,c=1,n=p
sayOvanAH	sayOvana	pos=a,g=f,c=1,n=p
prayAnti	prayA	pos=v,p=3,n=p,l=lat
kAle	kAla	pos=n,g=m,c=7,n=s
'tra	atra	pos=i
janasya	jana	pos=n,g=m,c=6,n=s
sevyatAm	sevyatA	pos=n,g=f,c=2,n=s

# id = Rtu.5.3
na	na	pos=i
candanam	candana	pos=n,g=n,c=1,n=s
candra	candra	pos=n,comp=y
marIci	marIci	pos=n,comp=y
SItalam	SItala	pos=a,g=n,c=1,n=s
na	na	pos=i
harmya	harmya	pos=n,comp=y
pfzWam	pfzWa	pos=n,g=n,c=1,n=s
Sarad	Sarad	pos=n,comp=y
indu	indu	pos=n,comp=y
nirmalam	nirmala	pos=a,g=n,c=1,n=s
na	na	pos=i
vAyavaH	vAyu	pos=n,g=m,c=1,n=p
sAndra	sAndra	pos=a,comp=y
tuzAra	tuzAra	pos=a,comp=y
SItalAH	SItala	pos=a,g=m,c=1,n=p
janasya	jana	pos=n,g=m,c=6,n=s
cittam	citta	pos=n,g=n,c=2,n=s
ramayanti	ramay	pos=v,p=3,n=p,l=lat
sAmpratam	sAMpratam	pos=i

# id = Rtu.5.4
tuzAra	tuzAra	pos=n,comp=y
saMGAta	saMGAta	pos=n,comp=y
nipAta	nipAta	pos=n,comp=y
SItalAH	SItala	pos=a,g=f,c=1,n=p
SaSANka	SaSANka	pos=n,comp=y
BABiH	BA	pos=n,g=f,c=3,n=p
SiSirIkftAH	SiSirIkf	pos=va,g=f,c=1,n=p,f=part
punaH	punar	pos=i
vipARqu	vipARqu	pos=a,comp=y
tArA	tArA	pos=n,comp=y
gaRa	gaRa	pos=n,comp=y
cAru	cAru	pos=a,comp=y
BUzaRa	BUzaRa	pos=n,g=f,c=1,n=p
janasya	jana	pos=n,g=m,c=6,n=s
sevyA	sev	pos=va,g=f,c=1,n=p,f=krtya
na	na	pos=i
Bavanti	BU	pos=v,p=3,n=p,l=lat
rAtrayaH	rAtri	pos=n,g=f,c=1,n=p

# id = Rtu.5.5
gfhIta	grah	pos=va,comp=y,f=part
tAmbUla	tAmbUla	pos=n,comp=y
vilepana	vilepana	pos=n,comp=y
srajaH	sraj	pos=n,g=f,c=1,n=p
puzpa	puzpa	pos=n,comp=y
Asava	Asava	pos=n,comp=y
Amodita	Amoday	pos=va,comp=y,f=part
vaktra	vaktra	pos=n,comp=y
paNkaja	paNkaja	pos=n,g=f,c=1,n=p
prakAma	prakAma	pos=n,comp=y
kAlAguru	kAlAguru	pos=n,comp=y
DUpa	DUpa	pos=n,comp=y
vAsitam	vAsay	pos=va,g=n,c=2,n=s,f=part
viSanti	viS	pos=v,p=3,n=p,l=lat
SayyA	SayyA	pos=n,comp=y
gfham	gfha	pos=n,g=n,c=2,n=s
utsuka	utsuka	pos=a,g=f,c=1,n=p
striyaH	strI	pos=n,g=f,c=1,n=p

# id = Rtu.5.6
kfta	kf	pos=va,comp=y,f=part
aparADAn	aparADa	pos=n,g=m,c=2,n=p
bahuSas	bahuSas	pos=i
'BitarjitAn	aBitarjay	pos=va,g=m,c=2,n=p,f=part
sa	sa	pos=i
vepaTUn	vepaTu	pos=n,g=m,c=2,n=p
sADvasa	sADvasa	pos=n,comp=y
lupta	lup	pos=va,comp=y,f=part
cetasaH	cetas	pos=n,g=m,c=2,n=p
nirIkzya	nirIkz	pos=va,g=m,c=8,n=s,f=krtya
BartFn	Bartf	pos=n,g=m,c=2,n=p
surata	surata	pos=n,comp=y
aBilAzin	aBilAzin	pos=a,g=m,c=2,n=p
striyaH	strI	pos=n,g=f,c=2,n=p
aparADAn	aparADa	pos=n,g=m,c=2,n=p
samadA	samada	pos=a,g=f,c=1,n=s
visasmaruH	vismf	pos=v,p=3,n=p,l=lit

# id = Rtu.5.7
prakAma	prakAma	pos=n,comp=y
kAmEH	kAma	pos=n,g=m,c=3,n=p
yuvaBiH	yuvan	pos=n,g=m,c=3,n=p
sunirdayam	sunirdaya	pos=a,g=n,c=2,n=s
niSAsu	niSA	pos=n,g=f,c=7,n=p
dIrGa	dIrGa	pos=a,g=f,c=7,n=p
aBirAmay	aBirAmay	pos=va,g=f,c=1,n=p,f=part
ciram	ciram	pos=i
Bramanti	Bram	pos=v,p=3,n=p,l=lat
mandam	manda	pos=a,g=n,c=2,n=s
Srama	Srama	pos=n,comp=y
Keday	Keday	pos=va,comp=y,f=part
Uru	Uru	pos=n,g=f,c=1,n=p
kzapA	kzapA	pos=n,comp=y
avasAne	avasAna	pos=n,g=n,c=7,n=s
nava	nava	pos=a,comp=y
yOvana	yOvana	pos=n,g=f,c=1,n=p
striyaH	strI	pos=n,g=f,c=1,n=p

# id = Rtu.5.8
manojYa	manojYa	pos=a,comp=y
kUrpAsaka	kUrpAsaka	pos=n,comp=y
pIqita	pIqay	pos=va,comp=y,f=part
stana	stana	pos=n,g=f,c=1,n=p
sa	sa	pos=i
rAga	rAga	pos=n,comp=y
kOSeyaka	kOSeyaka	pos=n,comp=y
BUzita	BUzay	pos=va,comp=y,f=part
Uru	Uru	pos=n,g=f,c=1,n=p
niveSita	niveSay	pos=va,comp=y,f=part
antaH	antar	pos=i
kusumEH	kusuma	pos=n,g=n,c=3,n=p
SiroruhEH	Siroruha	pos=n,g=m,c=3,n=p
viBUzayanti	viBUzay	pos=v,p=3,n=p,l=lat
iva	iva	pos=i
hima	hima	pos=n,comp=y
Agamam	Agama	pos=n,g=m,c=2,n=s
striyaH	strI	pos=n,g=f,c=1,n=p

# id = Rtu.5.9
payoDarEH	payoDara	pos=n,g=m,c=3,n=p
kuNkuma	kuNkuma	pos=n,comp=y
rAga	rAga	pos=n,comp=y
piYjarEH	piYjara	pos=a,g=m,c=3,n=p
suKa	suKa	pos=n,comp=y
upasev	upasev	pos=va,g=m,c=3,n=p,f=krtya
nava	nava	pos=a,comp=y
yOvana	yOvana	pos=n,comp=y
Uzman	Uzman	pos=n,g=m,c=3,n=p
vilAsinIBiH	vilAsinI	pos=n,g=f,c=3,n=p
paripIqay	paripIqay	pos=va,comp=y,f=part
uras	uras	pos=n,g=m,c=1,n=p
svapanti	svap	pos=v,p=3,n=p,l=lat
SItam	SIta	pos=n,g=n,c=2,n=s
pariBUya	pariBU	pos=vi
kAminaH	kAmin	pos=n,g=m,c=1,n=p

# id = Rtu.5.10
suganDi	suganDi	pos=a,comp=y
niHSvAsa	niHSvAsa	pos=n,comp=y
vikampay	vikampay	pos=va,comp=y,f=part
utpalam	utpala	pos=n,g=n,c=2,n=s
manoharam	manohara	pos=a,g=n,c=2,n=s
kAma	kAma	pos=n,comp=y
rati	rati	pos=n,comp=y
praboDakam	praboDaka	pos=a,g=n,c=2,n=s
niSAsu	niSA	pos=n,g=f,c=7,n=p
hfzwA	hfz	pos=va,g=f,c=1,n=s,f=part
saha	saha	pos=i
kAmiBiH	kAmin	pos=n,g=m,c=3,n=p
striyaH	strI	pos=n,g=f,c=1,n=p
pibanti	pA	pos=v,p=3,n=p,l=lat
madyam	madya	pos=n,g=n,c=2,n=s
madanIyam	mad	pos=va,g=n,c=2,n=s,f=krtya
uttamam	uttama	pos=a,g=n,c=2,n=s

# id = Rtu.5.11
apagata	apagam	pos=va,comp=y,f=part
mada	mada	pos=n,comp=y
rAgA	rAga	pos=n,g=f,c=1,n=s
yozit	yozit	pos=n,comp=y
ekA	eka	pos=n,g=f,c=1,n=s
praBAte	praBAta	pos=n,g=n,c=7,n=s
kfta	kf	pos=va,comp=y,f=part
nibiqa	nibiqa	pos=a,comp=y
kuca	kuca	pos=n,comp=y
agrA	agra	pos=n,g=f,c=1,n=s
patyuH	pati	pos=n,g=,c=6,n=s
AliNganena	AliNgana	pos=n,g=n,c=3,n=s
priyatama	priyatama	pos=a,comp=y
pariBuktam	pariBuj	pos=va,g=n,c=2,n=s,f=part
vIkzamARA	vIkz	pos=va,g=f,c=1,n=s,f=part
sva	sva	pos=a,comp=y
deham	deha	pos=n,g=n,c=2,n=s
vrajati	vraj	pos=v,p=3,n=s,l=lat
Sayana	Sayana	pos=n,comp=y
vAsAt	vAsa	pos=n,g=m,c=5,n=s
vAsam	vAsa	pos=n,g=m,c=2,n=s
anyam	anya	pos=n,g=m,c=2,n=s
hasantI	has	pos=va,g=f,c=1,n=s,f=part

# id = Rtu.5.12
aguru	aguru	pos=n,comp=y
suraBi	suraBi	pos=a,comp=y
DUpa	DUpa	pos=n,comp=y
Amoditam	Amoday	pos=va,g=m,c=2,n=s,f=part
keSapASam	keSapASa	pos=n,g=m,c=2,n=s
galita	gal	pos=va,comp=y,f=part
kusuma	kusuma	pos=n,comp=y
mAlam	mAlA	pos=n,g=n,c=2,n=s
kuYc	kuYc	pos=va,comp=y,f=part
agram	agra	pos=n,g=n,c=2,n=s
vahantI	vah	pos=va,g=f,c=1,n=s,f=part
tyajati	tyaj	pos=v,p=3,n=s,l=lat
guru	guru	pos=a,comp=y
nitambA	nitamba	pos=n,g=f,c=1,n=s
nimna	nimna	pos=a,comp=y
nABiH	nABi	pos=n,g=f,c=1,n=s
sumaDyA	sumaDya	pos=a,g=f,c=1,n=s
uzasi	uzas	pos=n,g=f,c=7,n=s
Sayanam	Sayana	pos=n,g=n,c=2,n=s
anyA	anya	pos=n,g=f,c=1,n=s
kAminI	kAminI	pos=n,g=f,c=1,n=s
cAru	cAru	pos=a,comp=y
SoBAm	SoBA	pos=n,g=f,c=2,n=s

# id = Rtu.5.13
kanaka	kanaka	pos=n,comp=y
kamala	kamala	pos=n,comp=y
kAntEH	kAnta	pos=a,g=m,c=3,n=p
cAru	cAru	pos=a,comp=y
tAmra	tAmra	pos=a,comp=y
aDarozWEH	aDarozWa	pos=n,g=m,c=3,n=p
SravaRa	SravaRa	pos=n,comp=y
tawa	tawa	pos=n,comp=y
nizaktEH	nizaYj	pos=va,g=m,c=3,n=p,f=part
pAwala	pAwala	pos=a,comp=y
upAnta	upAnta	pos=n,comp=y
netrEH	netra	pos=n,g=m,c=3,n=p
uzasi	uzas	pos=n,g=f,c=7,n=s
vadana	vadana	pos=n,comp=y
bimbEH	bimba	pos=n,g=m,c=3,n=p
aMsa	aMsa	pos=n,comp=y
saMsakta	saMsaYj	pos=va,comp=y,f=part
keSEH	keSa	pos=n,g=m,c=3,n=p
Sriya	SrI	pos=n,g=f,c=1,n=p
iva	iva	pos=i
gfha	gfha	pos=n,comp=y
maDye	maDya	pos=n,g=n,c=7,n=s
saMsTitA	saMsTA	pos=va,g=f,c=1,n=p,f=part
yozito	yozit	pos=n,g=f,c=1,n=p
'dya	adya	pos=i

# id = Rtu.5.14
pfTu	pfTu	pos=a,comp=y
jaGana	jaGana	pos=n,comp=y
Bara	Bara	pos=n,comp=y
Arta	Arta	pos=a,g=f,c=1,n=p
kiMcid	kaScit	pos=n,g=n,c=2,n=s
Anamra	Anamra	pos=a,comp=y
maDya	maDya	pos=n,g=f,c=1,n=p
stana	stana	pos=n,comp=y
Bara	Bara	pos=n,comp=y
pariKedAt	pariKeda	pos=n,g=m,c=5,n=s
mandamandam	mandamandam	pos=i
vrajantyaH	vraj	pos=va,g=f,c=1,n=p,f=part
surata	surata	pos=n,comp=y
samaya	samaya	pos=n,comp=y
vezam	veza	pos=n,g=m,c=2,n=s
nESam	nESa	pos=a,g=m,c=2,n=s
ASu	ASu	pos=a,g=n,c=2,n=s
prahAya	prahA	pos=vi
daDati	DA	pos=v,p=3,n=s,l=lat
divasa	divasa	pos=n,comp=y
yogyam	yogya	pos=a,g=m,c=2,n=s
veSam	veSa	pos=n,g=m,c=2,n=s
anyAH	anya	pos=n,g=f,c=1,n=p
taruRyaH	taruRa	pos=a,g=f,c=1,n=p

# id = Rtu.5.15
naKa	naKa	pos=n,comp=y
pada	pada	pos=n,comp=y
cita	cita	pos=a,comp=y
BAgAn	BAga	pos=n,g=m,c=2,n=p
vIkzamARAH	vIkz	pos=va,g=f,c=1,n=p,f=part
stana	stana	pos=n,comp=y
antAn	anta	pos=n,g=m,c=2,n=p
aDara	aDara	pos=n,comp=y
kisalaya	kisalaya	pos=n,comp=y
agram	agra	pos=n,g=n,c=2,n=s
danta	danta	pos=n,comp=y
Binnam	Bid	pos=va,g=n,c=2,n=s,f=part
spfSantyaH	spfS	pos=va,g=f,c=1,n=p,f=part
aBimata	aBiman	pos=va,comp=y,f=part
ram	ram	pos=va,comp=y,f=part
vezam	veza	pos=n,g=m,c=2,n=s
nanday	nanday	pos=va,g=f,c=1,n=p,f=part
taruRyaH	taruRa	pos=a,g=f,c=1,n=p
savituH	savitf	pos=n,g=m,c=6,n=s
udaya	udaya	pos=n,comp=y
kAle	kAla	pos=n,g=m,c=7,n=s
BUzayanti	BUzay	pos=v,p=3,n=p,l=lat
AnanAni	Anana	pos=n,g=n,c=2,n=p

# id = Rtu.5.16
pracura	pracura	pos=a,comp=y
guqa	guqa	pos=n,comp=y
vikAraH	vikAra	pos=n,g=m,c=1,n=s
svAdu	svAdu	pos=a,comp=y
SAli	SAli	pos=n,comp=y
ikzu	ikzu	pos=n,comp=y
ramyaH	ramya	pos=a,g=m,c=1,n=s
prabala	prabala	pos=a,comp=y
surata	surata	pos=n,comp=y
keli	keli	pos=n,g=m,c=1,n=s
jAta	jan	pos=va,comp=y,f=part
kandarpa	kandarpa	pos=n,comp=y
darpaH	darpa	pos=n,g=m,c=1,n=s
priya	priya	pos=a,comp=y
jana	jana	pos=n,comp=y
rahitAnAm	rahita	pos=a,g=m,c=6,n=p
cita	cita	pos=a,comp=y
saMtApa	saMtApa	pos=n,comp=y
hetuH	hetu	pos=n,g=m,c=1,n=s
SiSira	SiSira	pos=n,comp=y
samayaH	samaya	pos=n,g=m,c=1,n=s
eza	etad	pos=n,g=m,c=1,n=s
Sreyase	Sreyas	pos=n,g=n,c=4,n=s
vo	tvad	pos=n,g=,c=4,n=p
'stu	as	pos=v,p=3,n=s,l=lot
nityam	nityam	pos=i

# id = Rtu.6.1
praPulla	praPulla	pos=a,comp=y
cUta	cUta	pos=n,comp=y
aNkura	aNkura	pos=n,comp=y
tIkzRa	tIkzRa	pos=a,comp=y
sAyakaH	sAyaka	pos=n,g=m,c=1,n=s
dvirePa	dvirePa	pos=n,comp=y
mAlA	mAlA	pos=n,comp=y
vilasat	vilas	pos=va,comp=y,f=part
DanuH	Danus	pos=n,comp=y
guRaH	guRa	pos=n,g=m,c=1,n=s
manAMsi	manas	pos=n,g=n,c=2,n=p
Bettum	Bid	pos=vi
surata	surata	pos=n,comp=y
prasaNgin	prasaNgin	pos=a,g=m,c=6,n=p
vasanta	vasanta	pos=n,comp=y
yodDA	yodDf	pos=n,g=m,c=1,n=s
samupAgataH	samupAgam	pos=va,g=m,c=1,n=s,f=part
priye	priya	pos=a,g=f,c=8,n=s

# id = Rtu.6.2
drumAH	druma	pos=n,g=m,c=1,n=p
sa	sa	pos=i
puzpAH	puzpa	pos=n,g=m,c=1,n=p
salilam	salila	pos=n,g=n,c=1,n=s
sa	sa	pos=i
padmam	padma	pos=n,g=n,c=1,n=s
striyaH	strI	pos=n,g=f,c=1,n=p
sa	sa	pos=i
kAmAH	kAma	pos=n,g=f,c=1,n=p
pavanaH	pavana	pos=n,g=m,c=1,n=s
suganDiH	suganDi	pos=a,g=m,c=1,n=s
suKAH	suKa	pos=a,g=m,c=1,n=p
pradozA	pradoza	pos=n,g=m,c=1,n=p
divasAH	divasa	pos=n,g=m,c=1,n=p
ca	ca	pos=i
ramyAH	ramya	pos=a,g=m,c=1,n=p
sarvam	sarva	pos=n,g=n,c=1,n=s
priye	priya	pos=a,g=f,c=8,n=s
cArutaram	cArutara	pos=a,g=n,c=1,n=s
vasante	vasanta	pos=n,g=m,c=7,n=s

# id = Rtu.6.3
Izat	Izat	pos=i
tuzArEH	tuzAra	pos=n,g=m,c=3,n=p
kfta	kf	pos=va,comp=y,f=part
SIta	SIta	pos=n,comp=y
harmyaH	harmya	pos=n,g=m,c=1,n=s
su	su	pos=i
vAsitam	vAsay	pos=va,g=n,c=1,n=s,f=part
cAru	cAru	pos=a,comp=y
SiraH	Siras	pos=n,g=n,c=1,n=s
ca	ca	pos=i
campakEH	campaka	pos=n,g=m,c=3,n=p
kurvanti	kf	pos=v,p=3,n=p,l=lat
nAryaH	nArI	pos=n,g=f,c=1,n=p
api	api	pos=i
vasanta	vasanta	pos=n,comp=y
kAle	kAla	pos=n,g=m,c=7,n=s
stanam	stana	pos=n,g=m,c=2,n=s
sahAram	sahAra	pos=a,g=m,c=2,n=s
kusumEH	kusuma	pos=n,g=n,c=3,n=p
manoharEH	manohara	pos=a,g=n,c=3,n=p

# id = Rtu.6.4
vApI	vApI	pos=n,comp=y
jalAnAm	jala	pos=n,g=n,c=6,n=p
maRi	maRi	pos=n,comp=y
meKalA	meKalA	pos=n,g=n,c=6,n=p
SaSANka	SaSANka	pos=n,comp=y
BAs	BAs	pos=n,g=n,c=6,n=p
pramadA	pramadA	pos=n,comp=y
janAnAm	jana	pos=n,g=m,c=6,n=p
cUta	cUta	pos=n,comp=y
drumARAm	druma	pos=n,g=m,c=6,n=p
kusuma	kusuma	pos=n,comp=y
anvitAnAm	anvita	pos=a,g=m,c=6,n=p
dadAti	dA	pos=v,p=3,n=s,l=lat
sOBAgyam	sOBAgya	pos=n,g=n,c=2,n=s
ayam	idam	pos=n,g=m,c=1,n=s
vasantaH	vasanta	pos=n,g=m,c=1,n=s

# id = Rtu.6.5
kusumBa	kusumBa	pos=n,comp=y
rAga	rAga	pos=n,comp=y
aruRitEH	aruRita	pos=a,g=n,c=3,n=p
dukUlEH	dukUla	pos=n,g=n,c=3,n=p
nitamba	nitamba	pos=n,comp=y
bimbAni	bimba	pos=n,g=n,c=1,n=p
vilAsinInAm	vilAsinI	pos=n,g=f,c=6,n=p
tanu	tanu	pos=a,comp=y
aMSukEH	aMSuka	pos=n,g=m,c=3,n=p
kuNkuma	kuNkuma	pos=n,comp=y
rAga	rAga	pos=n,comp=y
gOrEH	gOra	pos=a,g=m,c=3,n=p
alaMkriyante	alaMkf	pos=v,p=3,n=p,l=lat
stana	stana	pos=n,comp=y
maRqalAni	maRqala	pos=n,g=n,c=1,n=p

# id = Rtu.6.6
karRezu	karRa	pos=n,g=m,c=7,n=p
yogyam	yogya	pos=a,g=m,c=2,n=s
nava	nava	pos=a,comp=y
karRikAram	karRikAra	pos=n,g=m,c=2,n=s
calezu	cala	pos=a,g=m,c=7,n=p
nIlezu	nIla	pos=a,g=m,c=7,n=p
alakezu	alaka	pos=n,g=m,c=7,n=p
aSokam	aSoka	pos=n,g=m,c=2,n=s
puzpam	puzpa	pos=n,g=n,c=2,n=s
ca	ca	pos=i
Pullam	Pulla	pos=n,g=n,c=2,n=s
navamallikAyAH	navamallikA	pos=n,g=f,c=6,n=s
prayAnti	prayA	pos=v,p=3,n=p,l=lat
kAntim	kAnti	pos=n,g=f,c=2,n=s
pramadA	pramadA	pos=n,comp=y
janAnAm	jana	pos=n,g=m,c=6,n=p

# id = Rtu.6.7
stanezu	stana	pos=n,g=n,c=7,n=p
hArAH	hAra	pos=n,g=m,c=1,n=p
sita	sita	pos=a,comp=y
candana	candana	pos=n,comp=y
ArdrAH	Ardra	pos=a,g=m,c=1,n=p
Bujezu	Buja	pos=n,g=m,c=7,n=p
saNgam	saNga	pos=n,g=m,c=2,n=s
valaya	valaya	pos=n,comp=y
aNgadAni	aNgada	pos=n,g=n,c=1,n=p
prayAnti	prayA	pos=v,p=3,n=p,l=lat
anaNga	anaNga	pos=n,comp=y
Atura	Atura	pos=a,comp=y
mAnasAnAm	mAnasa	pos=n,g=f,c=6,n=p
nitambinInAm	nitambinI	pos=n,g=f,c=6,n=p
jaGanezu	jaGana	pos=n,g=m,c=7,n=p
kAYcyaH	kAYcI	pos=n,g=f,c=1,n=p

# id = Rtu.6.8
sa	sa	pos=i
pattra	pattra	pos=n,comp=y
leKA	leKA	pos=n,g=n,c=7,n=p
vilAsinInAm	vilAsinI	pos=n,g=f,c=6,n=p
vaktrezu	vaktra	pos=n,g=n,c=7,n=p
hema	heman	pos=n,comp=y
amburuha	amburuha	pos=n,comp=y
upamezu	upama	pos=a,g=n,c=7,n=p
ratna	ratna	pos=n,comp=y
antare	antara	pos=a,g=n,c=7,n=s
mOktika	mOktika	pos=n,comp=y
saNga	saNga	pos=n,comp=y
ramyaH	ramya	pos=a,g=m,c=1,n=s
sveda	sveda	pos=n,comp=y
AgamaH	Agama	pos=n,g=m,c=1,n=s
vistaratAm	vistaratA	pos=n,g=f,c=2,n=s
upEti	upe	pos=v,p=3,n=s,l=lat

# id = Rtu.6.9
ucCvAsayantyaH	ucCvAsay	pos=va,g=f,c=1,n=p,f=part
SlaTa	SlaTa	pos=a,comp=y
banDanAni	banDana	pos=n,g=n,c=2,n=p
gAtrARi	gAtra	pos=n,g=n,c=2,n=p
kandarpa	kandarpa	pos=n,comp=y
samAkulAni	samAkula	pos=a,g=n,c=2,n=p
samIpa	samIpa	pos=n,comp=y
vartin	vartin	pos=a,g=m,c=7,n=p
aDunA	aDunA	pos=i
priyezu	priya	pos=a,g=n,c=7,n=p
samutsukA	samutsuka	pos=a,g=f,c=1,n=p
eva	eva	pos=i
Bavanti	BU	pos=v,p=3,n=p,l=lat
nAryaH	nArI	pos=n,g=f,c=1,n=p

# id = Rtu.6.10
tanUni	tanu	pos=a,g=n,c=2,n=p
pARqUni	pARqu	pos=a,g=n,c=2,n=p
mada	mada	pos=n,comp=y
alasAni	alasa	pos=a,g=n,c=2,n=p
muhuH	muhur	pos=i
muhuH	muhur	pos=i
jfmBaRa	jfmBaRa	pos=n,comp=y
tatparAni	tatpara	pos=a,g=n,c=2,n=p
aNgAni	aNga	pos=n,g=n,c=2,n=p
anaNgaH	anaNga	pos=n,g=m,c=1,n=s
pramadA	pramadA	pos=n,comp=y
janasya	jana	pos=n,g=m,c=6,n=s
karoti	kf	pos=v,p=3,n=s,l=lat
lAvaRya	lAvaRya	pos=n,comp=y
sa	sa	pos=i
samBramAni	samBrama	pos=n,g=n,c=2,n=p

# id = Rtu.6.11
CAyAm	CAyA	pos=n,g=f,c=2,n=s
janaH	jana	pos=n,g=m,c=1,n=s
samaBivAYCati	samaBivAYC	pos=v,p=3,n=s,l=lat
pAdapAnAm	pAdapa	pos=n,g=m,c=6,n=p
naktam	nakta	pos=n,g=n,c=2,n=s
taTA	taTA	pos=i
icCati	iz	pos=v,p=3,n=s,l=lat
punaH	punar	pos=i
kiraRam	kiraRa	pos=n,g=m,c=2,n=s
suDAMSoH	suDAMSu	pos=n,g=m,c=6,n=s
harmyam	harmya	pos=n,g=n,c=2,n=s
prayAti	prayA	pos=v,p=3,n=s,l=lat
Sayitum	SI	pos=vi
suKa	suKa	pos=a,comp=y
SItalam	SItala	pos=a,g=n,c=2,n=s
ca	ca	pos=i
kAntAm	kAntA	pos=n,g=f,c=2,n=s
ca	ca	pos=i
gAQam	gAQam	pos=i
upagUhati	upaguh	pos=v,p=3,n=s,l=lat
SItala	SItala	pos=a,comp=y
tvAt	tva	pos=n,g=n,c=5,n=s

# id = Rtu.6.12
netrezu	netra	pos=n,g=m,c=7,n=p
lolo	lola	pos=a,g=m,c=1,n=s
madirA	madirA	pos=n,comp=y
alasezu	alasa	pos=a,g=m,c=7,n=p
gaRqezu	gaRqa	pos=n,g=m,c=7,n=p
pARquH	pARqu	pos=a,g=m,c=1,n=s
kaWinaH	kaWina	pos=a,g=m,c=1,n=s
stanezu	stana	pos=n,g=m,c=7,n=p
maDyezu	maDya	pos=n,g=n,c=7,n=p
nimno	nimna	pos=a,g=m,c=1,n=s
jaGanezu	jaGana	pos=n,g=m,c=7,n=p
pInaH	pIna	pos=a,g=m,c=1,n=s
strIRAm	strI	pos=n,g=f,c=6,n=p
anaNgaH	anaNga	pos=n,g=m,c=1,n=s
bahuDA	bahuDA	pos=i
sTitaH	sTA	pos=va,g=m,c=1,n=s,f=part
adya	adya	pos=i

# id = Rtu.6.13
aNgAni	aNga	pos=n,g=n,c=2,n=p
nidrA	nidrA	pos=n,comp=y
alasa	alasa	pos=a,comp=y
viBramAni	viBrama	pos=n,g=n,c=2,n=p
vAkyAni	vAkya	pos=n,g=n,c=2,n=p
kiMcid	kaScit	pos=n,g=n,c=2,n=s
madirA	madirA	pos=n,comp=y
alasAni	alasa	pos=a,g=n,c=2,n=p
BrU	BrU	pos=n,comp=y
kzepa	kzepa	pos=n,comp=y
jihmAni	jihma	pos=a,g=n,c=2,n=p
ca	ca	pos=i
vIkzitAni	vIkzita	pos=n,g=n,c=2,n=p
cakAra	kf	pos=v,p=3,n=s,l=lit
kAmaH	kAma	pos=n,g=m,c=1,n=s
pramadA	pramadA	pos=n,comp=y
janAnAm	jana	pos=n,g=m,c=6,n=p

# id = Rtu.6.14
priyaNgu	priyaNgu	pos=n,comp=y
kAlIyaka	kAlIyaka	pos=n,comp=y
kuNkuma	kuNkuma	pos=n,comp=y
aktam	aYj	pos=va,g=n,c=1,n=s,f=part
stanezu	stana	pos=n,g=m,c=7,n=p
gOrezu	gOra	pos=a,g=m,c=7,n=p
vilAsinIBiH	vilAsinI	pos=n,g=f,c=3,n=p
Alipyate	Alip	pos=v,p=3,n=s,l=lat
candanam	candana	pos=n,g=n,c=1,n=s
aNganABiH	aNganA	pos=n,g=f,c=3,n=p
mada	mada	pos=n,comp=y
alasABiH	alasa	pos=a,g=f,c=3,n=p
mfganABi	mfganABi	pos=n,comp=y
yuktam	yuj	pos=va,g=n,c=1,n=s,f=part

# id = Rtu.6.15
gurURi	guru	pos=a,g=n,c=2,n=p
vAsAMsi	vAsas	pos=n,g=n,c=2,n=p
vihAya	vihA	pos=vi
tUrRam	tUrRam	pos=i
tanUni	tanu	pos=a,g=n,c=2,n=p
lAkzA	lAkzA	pos=n,comp=y
rasa	rasa	pos=n,comp=y
raYjitAni	raYjay	pos=va,g=n,c=2,n=p,f=part
suganDi	suganDi	pos=a,comp=y
kAlAguru	kAlAguru	pos=n,comp=y
DUpitAni	DUpay	pos=va,g=n,c=2,n=p,f=part
Datte	DA	pos=v,p=3,n=s,l=lat
janaH	jana	pos=n,g=m,c=1,n=s
kAma	kAma	pos=n,comp=y
mada	mada	pos=n,comp=y
alasa	alasa	pos=a,comp=y
aNgaH	aNga	pos=n,g=m,c=1,n=s

# id = Rtu.6.16
puMskokilaH	puMskokila	pos=n,g=m,c=1,n=s
cUta	cUta	pos=n,comp=y
rasa	rasa	pos=n,comp=y
Asavena	Asava	pos=n,g=m,c=3,n=s
mattaH	mad	pos=va,g=m,c=1,n=s,f=part
priyAm	priya	pos=a,g=f,c=2,n=s
cumbati	cumb	pos=va,g=n,c=1,n=p,f=part
rAga	rAga	pos=n,comp=y
hfzwaH	hfz	pos=va,g=m,c=1,n=s,f=part
kUjat	kUj	pos=va,comp=y,f=part
dvirePa	dvirePa	pos=n,comp=y
apyayam	apyaya	pos=n,g=m,c=2,n=s
ambuja	ambuja	pos=n,comp=y
sTaH	sTa	pos=a,g=m,c=1,n=s
priyam	priya	pos=a,g=m,c=2,n=s
priyAyAH	priya	pos=a,g=f,c=6,n=s
prakaroti	prakf	pos=v,p=3,n=s,l=lat
cAwu	cAwu	pos=n,g=n,c=2,n=s

# id = Rtu.6.17
tAmra	tAmra	pos=a,comp=y
pravAla	pravAla	pos=n,comp=y
stabaka	stabaka	pos=n,comp=y
avanamrAH	avanamra	pos=a,g=m,c=1,n=p
cUta	cUta	pos=n,comp=y
drumAH	druma	pos=n,g=m,c=1,n=p
puzpita	puzpita	pos=a,comp=y
cAru	cAru	pos=a,comp=y
SAKA	SAKA	pos=n,g=m,c=1,n=p
kurvanti	kf	pos=v,p=3,n=p,l=lat
kAmam	kAma	pos=n,g=m,c=2,n=s
pavana	pavana	pos=n,comp=y
avaDUtAH	avaDU	pos=va,g=m,c=1,n=p,f=part
paryutsukam	paryutsuka	pos=a,g=n,c=2,n=s
mAnasam	mAnasa	pos=n,g=n,c=2,n=s
aNganAnAm	aNganA	pos=n,g=f,c=6,n=p

# id = Rtu.6.18
AmUlato	AmUlataH	pos=i
vidruma	vidruma	pos=n,comp=y
rAga	rAga	pos=n,comp=y
tAmram	tAmra	pos=a,g=m,c=2,n=s
sa	sa	pos=i
pallavAH	pallava	pos=n,g=m,c=1,n=p
puzpa	puzpa	pos=n,comp=y
cayam	caya	pos=n,g=m,c=2,n=s
daDAnAH	DA	pos=va,g=m,c=1,n=p,f=part
kurvanti	kf	pos=v,p=3,n=p,l=lat
aSokAH	aSoka	pos=n,g=m,c=1,n=p
hfdayam	hfdaya	pos=n,g=n,c=2,n=s
sa	sa	pos=i
Sokam	Soka	pos=n,g=n,c=2,n=s
nirIkzyamARA	nirIkz	pos=va,g=m,c=1,n=p,f=part
nava	nava	pos=a,comp=y
yOvanAnAm	yOvana	pos=n,g=f,c=6,n=p

# id = Rtu.6.19
matta	mad	pos=va,comp=y,f=part
dvirePa	dvirePa	pos=n,comp=y
paricumbita	paricumbita	pos=a,comp=y
cAru	cAru	pos=a,comp=y
puzpAH	puzpa	pos=n,g=m,c=1,n=p
manda	manda	pos=a,comp=y
anila	anila	pos=n,comp=y
Akulita	Akulita	pos=a,comp=y
namra	namra	pos=a,comp=y
mfdu	mfdu	pos=a,comp=y
pravAlAH	pravAla	pos=n,g=m,c=1,n=p
kurvanti	kf	pos=v,p=3,n=p,l=lat
kAmin	kAmin	pos=n,comp=y
manasAm	manas	pos=n,g=n,c=6,n=p
sahasA	sahas	pos=n,g=n,c=3,n=s
utsuka	utsuka	pos=a,comp=y
tvam	tva	pos=n,g=n,c=2,n=s
bAlA	bAlA	pos=n,comp=y
atimukta	atimukta	pos=n,comp=y
latikAH	latikA	pos=n,g=f,c=1,n=p
samavekzyamARAH	samavekz	pos=va,g=f,c=1,n=p,f=part

# id = Rtu.6.20
kAntA	kAntA	pos=n,comp=y
muKa	muKa	pos=n,comp=y
dyuti	dyuti	pos=n,comp=y
juH	juz	pos=a,g=f,c=6,n=p
acira	acira	pos=a,comp=y
udgatAnAm	udgam	pos=va,g=f,c=6,n=p,f=part
SoBAm	SoBa	pos=a,g=f,c=2,n=s
parAm	para	pos=n,g=f,c=2,n=s
kurabaka	kurabaka	pos=n,comp=y
druma	druma	pos=n,comp=y
maYjarI	maYjarI	pos=n,g=f,c=6,n=p
dfzwvA	dfS	pos=vi
priye	priya	pos=a,g=f,c=8,n=s
sahfdayasya	sahfdaya	pos=a,g=m,c=6,n=s
Bavet	BU	pos=v,p=3,n=s,l=vidhilin
na	na	pos=i
kasya	ka	pos=n,g=m,c=6,n=s
kandarpa	kandarpa	pos=n,comp=y
bARa	bARa	pos=n,comp=y
patana	patana	pos=n,comp=y
vyaTitam	vyaT	pos=va,g=n,c=1,n=s,f=part
hi	hi	pos=i
cetaH	cetas	pos=n,g=n,c=1,n=s

# id = Rtu.6.21
AdIpta	AdIp	pos=va,comp=y,f=part
vahni	vahni	pos=n,comp=y
sadfSEH	sadfSa	pos=a,g=n,c=3,n=p
marut	marut	pos=n,g=m,c=3,n=s
avaDUtEH	avaDU	pos=va,g=n,c=3,n=p,f=part
sarvatra	sarvatra	pos=i
kiMSuka	kiMSuka	pos=n,comp=y
vanEH	vana	pos=n,g=n,c=3,n=p
kusuma	kusuma	pos=n,comp=y
avanamrEH	avanamra	pos=a,g=n,c=3,n=p
sadyo	sadyas	pos=i
vasanta	vasanta	pos=n,comp=y
samayena	samaya	pos=n,g=m,c=3,n=s
samAcitA	samAci	pos=va,g=f,c=1,n=s,f=part
iyam	idam	pos=n,g=f,c=1,n=s
rakta	rakta	pos=a,comp=y
aMSukA	aMSuka	pos=n,g=f,c=1,n=s
nava	nava	pos=a,comp=y
vaDUH	vaDU	pos=n,g=f,c=1,n=s
iva	iva	pos=i
BAti	BA	pos=v,p=3,n=s,l=lat
BUmiH	BUmi	pos=n,g=f,c=1,n=s

# id = Rtu.6.22
kim	ka	pos=n,g=n,c=1,n=s
kiMSukEH	kiMSuka	pos=n,g=m,c=3,n=p
Suka	Suka	pos=n,comp=y
muKa	muKa	pos=n,comp=y
Cavi	Cavi	pos=n,g=f,c=3,n=p
na	na	pos=i
Binnam	Bid	pos=va,g=n,c=1,n=s,f=part
kim	ka	pos=n,g=n,c=1,n=s
karRikAra	karRikAra	pos=n,comp=y
kusumEH	kusuma	pos=n,g=n,c=3,n=p
na	na	pos=i
kftam	kf	pos=va,g=n,c=1,n=s,f=part
nu	nu	pos=i
dagDam	dah	pos=va,g=n,c=1,n=s,f=part
yat	yat	pos=i
kokilaH	kokila	pos=n,g=m,c=1,n=s
punaH	punar	pos=i
ayam	idam	pos=n,g=m,c=1,n=s
maDurEH	maDura	pos=a,g=n,c=3,n=p
vacoBiH	vacas	pos=n,g=n,c=3,n=p
yUnAm	yuvan	pos=n,g=m,c=6,n=p
manaH	manas	pos=n,g=n,c=2,n=s
suvadanA	suvadanA	pos=n,comp=y
nihitam	niDA	pos=va,g=n,c=2,n=s,f=part
nihanti	nihan	pos=v,p=3,n=s,l=lat

# id = Rtu.6.23
puMskokilEH	puMskokila	pos=n,g=m,c=3,n=p
kala	kala	pos=a,comp=y
vacoBiH	vacas	pos=n,g=n,c=3,n=p
upAtta	upadA	pos=va,comp=y,f=part
harzEH	harza	pos=n,g=m,c=3,n=p
kUj	kUj	pos=va,g=m,c=3,n=p,f=part
unmada	unmada	pos=n,comp=y
kalAni	kala	pos=a,g=n,c=2,n=p
vacAMsi	vacas	pos=n,g=n,c=2,n=p
BfNgEH	BfNga	pos=n,g=m,c=3,n=p
lajjA	lajjA	pos=n,comp=y
anvitam	anvita	pos=a,g=n,c=1,n=s
sa	sa	pos=i
vinayam	vinaya	pos=n,g=n,c=1,n=s
hfdayam	hfdaya	pos=n,g=n,c=1,n=s
kzaRena	kzaRa	pos=n,g=m,c=3,n=s
paryAkulam	paryAkula	pos=a,g=n,c=1,n=s
kula	kula	pos=n,comp=y
gfhe	gfha	pos=n,g=m,c=7,n=s
api	api	pos=i
kftam	kf	pos=va,g=n,c=1,n=s,f=part
vaDUnAm	vaDU	pos=n,g=f,c=6,n=p

# id = Rtu.6.24
Akampay	Akampay	pos=va,g=m,c=1,n=s,f=part
kusumitAH	kusumita	pos=a,g=f,c=2,n=p
sahakAra	sahakAra	pos=n,comp=y
SAKAH	SAKA	pos=n,g=f,c=2,n=p
vistAray	vistAray	pos=va,g=m,c=1,n=s,f=part
paraBftasya	paraBfta	pos=n,g=m,c=6,n=s
vacAMsi	vacas	pos=n,g=n,c=2,n=p
dikzu	diS	pos=n,g=f,c=7,n=p
vAyuH	vAyu	pos=n,g=m,c=1,n=s
vivAti	vivA	pos=v,p=3,n=s,l=lat
hfdayAni	hfdaya	pos=n,g=n,c=2,n=p
hf	hf	pos=va,comp=y,f=part
narARAm	nara	pos=n,g=m,c=6,n=p
nIhAra	nIhAra	pos=n,comp=y
pAta	pAta	pos=n,comp=y
vigamAt	vigama	pos=n,g=m,c=5,n=s
suBagaH	suBaga	pos=a,g=m,c=1,n=s
vasante	vasanta	pos=n,g=m,c=7,n=s

# id = Rtu.6.25
kundEH	kunda	pos=n,g=m,c=3,n=p
sa	sa	pos=i
viBrama	viBrama	pos=n,comp=y
vaDU	vaDU	pos=n,comp=y
hasita	hasita	pos=n,comp=y
avadAtEH	avadAta	pos=a,g=m,c=3,n=p
uddyotitAni	uddyotay	pos=va,g=n,c=1,n=p,f=part
upavanAni	upavana	pos=n,g=n,c=1,n=p
manoharARi	manohara	pos=a,g=n,c=1,n=p
cittam	citta	pos=n,g=n,c=2,n=s
muneH	muni	pos=n,g=m,c=6,n=s
api	api	pos=i
haranti	hf	pos=v,p=3,n=p,l=lat
nivftta	nivft	pos=va,comp=y,f=part
rAgam	rAga	pos=n,g=n,c=2,n=s
prAk	prAYc	pos=a,g=n,c=2,n=s
eva	eva	pos=i
rAga	rAga	pos=n,comp=y
malinAni	malina	pos=a,g=n,c=2,n=p
manAMsi	manas	pos=n,g=n,c=2,n=p
yUnAm	yuvan	pos=n,g=m,c=6,n=p

# id = Rtu.6.26
Alambin	Alambin	pos=a,comp=y
hema	heman	pos=n,comp=y
rasanAH	rasanA	pos=n,g=f,c=1,n=p
stana	stana	pos=n,comp=y
sakta	saYj	pos=va,comp=y,f=part
hArAH	hAra	pos=n,g=m,c=1,n=p
kandarpa	kandarpa	pos=n,comp=y
darpa	darpa	pos=n,comp=y
SiTilIkfta	SiTilIkf	pos=va,comp=y,f=part
gAtra	gAtra	pos=n,comp=y
yazwI	yazwI	pos=n,g=f,c=1,n=p
mAse	mAsa	pos=n,g=m,c=7,n=s
maDO	maDu	pos=n,g=m,c=7,n=s
maDura	maDura	pos=a,comp=y
kokila	kokila	pos=n,comp=y
BfNga	BfNga	pos=n,comp=y
nAdEH	nAda	pos=n,g=m,c=3,n=p
nAryAH	nArI	pos=n,g=f,c=6,n=s
haranti	hf	pos=v,p=3,n=p,l=lat
hfdayam	hfdaya	pos=n,g=n,c=2,n=s
prasaBam	prasaBam	pos=i
narARAm	nara	pos=n,g=m,c=6,n=p

# id = Rtu.6.27
nAnA	nAnA	pos=i
manojYa	manojYa	pos=a,comp=y
kusuma	kusuma	pos=n,comp=y
druma	druma	pos=n,comp=y
BUzitAn	BUzay	pos=va,g=m,c=2,n=p,f=part
tAn	tad	pos=n,g=m,c=2,n=p
hfzwa	hfz	pos=va,comp=y,f=part
anyapuzwa	anyapuzwa	pos=n,comp=y
ninada	ninada	pos=n,comp=y
Akula	Akula	pos=a,comp=y
sAnu	sAnu	pos=n,comp=y
deSAn	deSa	pos=n,g=m,c=2,n=p
SEleya	SEleya	pos=a,comp=y
jAla	jAla	pos=n,comp=y
pariRadDa	pariRah	pos=va,comp=y,f=part
SilA	SilA	pos=n,comp=y
talAn	tala	pos=n,g=m,c=2,n=p
tAn	tad	pos=n,g=m,c=2,n=p
dfzwvA	dfS	pos=vi
janaH	jana	pos=n,g=m,c=1,n=s
kzitiBfto	kzitiBft	pos=n,g=m,c=2,n=p
mudam	mud	pos=n,g=f,c=2,n=s
eti	i	pos=v,p=3,n=s,l=lat
sarvaH	sarva	pos=n,g=m,c=1,n=s

# id = Rtu.6.28
netre	netra	pos=n,g=n,c=2,n=d
nimIlayati	nimIlay	pos=v,p=3,n=s,l=lat
roditi	rud	pos=v,p=3,n=s,l=lat
yAti	yA	pos=v,p=3,n=s,l=lat
Sokam	Soka	pos=n,g=m,c=2,n=s
GrARam	GrARa	pos=n,g=m,c=2,n=s
kareRa	kara	pos=n,g=m,c=3,n=s
viruRadDi	viruD	pos=v,p=3,n=s,l=lat
virOti	viru	pos=v,p=3,n=s,l=lat
ca	ca	pos=i
uccEs	uccEs	pos=i
kAntA	kAntA	pos=n,comp=y
viyoga	viyoga	pos=n,comp=y
pariKeday	pariKeday	pos=va,comp=y,f=part
cittavftti	cittavftti	pos=n,g=m,c=1,n=s
dfzwvA	dfS	pos=vi
aDvagaH	aDvaga	pos=n,g=m,c=1,n=s
kusumitAn	kusumita	pos=a,g=m,c=2,n=p
sahakAra	sahakAra	pos=n,comp=y
vfkzAn	vfkza	pos=n,g=m,c=2,n=p

# id = Rtu.6.29
samada	samada	pos=a,comp=y
maDukarAnAm	maDukara	pos=n,g=m,c=6,n=p
kokilAnAm	kokila	pos=n,g=m,c=6,n=p
ca	ca	pos=i
nAdEH	nAda	pos=n,g=m,c=3,n=p
kusumita	kusumita	pos=a,comp=y
sahakArEH	sahakAra	pos=n,g=m,c=3,n=p
karRikArEH	karRikAra	pos=n,g=m,c=3,n=p
ca	ca	pos=i
ramyaH	ramya	pos=a,g=m,c=1,n=s
izuBiH	izu	pos=n,g=m,c=3,n=p
iva	iva	pos=i
su	su	pos=i
tIkzREH	tIkzRa	pos=a,g=m,c=3,n=p
mAnasam	mAnasa	pos=n,g=n,c=2,n=s
mAninInAm	mAninI	pos=n,g=f,c=6,n=p
tudati	tud	pos=v,p=3,n=s,l=lat
kusuma	kusuma	pos=n,comp=y
mAsaH	mAsa	pos=n,g=m,c=1,n=s
manmaTa	manmaTa	pos=n,comp=y
uddIpanAya	uddIpana	pos=n,g=n,c=4,n=s

# id = Rtu.6.30
muYcataH	muc	pos=va,g=m,c=2,n=p,f=part
puzpa	puzpa	pos=n,comp=y
rASi	rASi	pos=n,g=m,c=2,n=p
mfdu	mfdu	pos=a,comp=y
pavana	pavana	pos=n,comp=y
viDUtAn	viDU	pos=va,g=m,c=2,n=p,f=part
puzpitAn	puzpita	pos=a,g=m,c=2,n=p
cUta	cUta	pos=n,comp=y
vfkzAn	vfkza	pos=n,g=m,c=2,n=p
aBimuKam	aBimuKa	pos=a,g=n,c=2,n=s
aBivIkzya	aBivIkz	pos=vi
kzAma	kzAma	pos=a,comp=y
dehaH	deha	pos=n,g=m,c=1,n=s
'pi	api	pos=i
mArge	mArga	pos=n,g=m,c=7,n=s
madana	madana	pos=n,comp=y
Sara	Sara	pos=n,comp=y
niGAtEH	niGAta	pos=n,g=m,c=3,n=p
moham	moha	pos=n,g=m,c=2,n=s
eti	i	pos=v,p=3,n=s,l=lat
pravAsI	pravAsin	pos=a,g=m,c=1,n=s

# id = Rtu.6.31
paraBfta	paraBfta	pos=n,comp=y
kala	kala	pos=a,comp=y
gItEH	gIta	pos=n,g=n,c=3,n=p
hlAdiBiH	hlAdin	pos=a,g=n,c=3,n=p
sat	as	pos=va,comp=y,f=part
vacAMsi	vacas	pos=n,g=n,c=2,n=p
smita	smita	pos=n,comp=y
daSana	daSana	pos=n,comp=y
mayUKAn	mayUKa	pos=n,g=m,c=2,n=p
kunda	kunda	pos=n,comp=y
puzpa	puzpa	pos=n,comp=y
praBABiH	praBA	pos=n,g=f,c=3,n=p
kara	kara	pos=n,comp=y
kisalaya	kisalaya	pos=n,comp=y
kAntim	kAnti	pos=n,g=f,c=2,n=s
pallavEH	pallava	pos=n,g=m,c=3,n=p
vidruma	vidruma	pos=n,comp=y
ABEH	ABa	pos=a,g=m,c=3,n=p
upahasati	upahas	pos=v,p=3,n=s,l=lat
vasantaH	vasanta	pos=n,g=m,c=1,n=s
kAminI	kAminI	pos=n,g=f,c=6,n=p
idAnIm	idAnIm	pos=i

# id = Rtu.6.32
kanaka	kanaka	pos=n,comp=y
kamala	kamala	pos=n,comp=y
kAntEH	kAnta	pos=a,g=n,c=3,n=p
AnanEH	Anana	pos=n,g=n,c=3,n=p
pARqu	pARqu	pos=a,comp=y
gaRqEH	gaRqa	pos=n,g=m,c=3,n=p
upariniDA	upariniDA	pos=va,comp=y,f=part
hArEH	hAra	pos=n,g=m,c=3,n=p
candana	candana	pos=n,comp=y
ArdrEH	Ardra	pos=a,g=m,c=3,n=p
stana	stana	pos=n,comp=y
antEH	anta	pos=n,g=m,c=3,n=p
mada	mada	pos=n,comp=y
janita	janay	pos=va,comp=y,f=part
vilAsEH	vilAsa	pos=n,g=m,c=3,n=p
dfzwipAtEH	dfzwipAta	pos=n,g=m,c=3,n=p
muni	muni	pos=n,comp=y
indrAn	indra	pos=n,g=m,c=2,n=p
stana	stana	pos=n,comp=y
Bara	Bara	pos=n,comp=y
nata	nam	pos=va,comp=y,f=part
nAryaH	nArI	pos=n,g=f,c=1,n=p
kAmayanti	kAmay	pos=v,p=3,n=p,l=lat
praSAntAn	praSam	pos=va,g=m,c=2,n=p,f=part

# id = Rtu.6.33
maDu	maDu	pos=a,comp=y
suraBi	suraBi	pos=a,g=n,c=1,n=s
muKa	muKa	pos=n,comp=y
abjam	abja	pos=n,g=n,c=1,n=s
locane	locana	pos=n,g=n,c=1,n=d
loDra	loDra	pos=n,comp=y
tAmre	tAmra	pos=a,g=n,c=1,n=d
nava	nava	pos=a,comp=y
kurabaka	kurabaka	pos=n,comp=y
pUrRaH	pUrRa	pos=a,g=m,c=1,n=s
keSapASo	keSapASa	pos=n,g=m,c=1,n=s
manojYaH	manojYa	pos=a,g=m,c=1,n=s
gurutara	gurutara	pos=a,comp=y
kuca	kuca	pos=n,comp=y
yugmam	yugma	pos=n,g=n,c=1,n=s
SroRi	SroRi	pos=n,comp=y
bimbam	bimba	pos=n,g=n,c=1,n=s
taTA	taTA	pos=i
eva	eva	pos=i
na	na	pos=i
Bavati	BU	pos=v,p=3,n=s,l=lat
kim	ka	pos=n,g=n,c=1,n=s
idAnIm	idAnIm	pos=i
yozitAm	yozit	pos=n,g=f,c=6,n=p
manmaTAya	manmaTa	pos=n,g=m,c=4,n=s

# id = Rtu.6.34
AkampitAni	Akampay	pos=va,g=n,c=1,n=p,f=part
hfdayAni	hfdaya	pos=n,g=n,c=1,n=p
manasvinInAm	manasvinI	pos=n,g=f,c=6,n=p
vAtEH	vAta	pos=n,g=m,c=3,n=p
praPulla	praPulla	pos=a,comp=y
sahakAra	sahakAra	pos=n,comp=y
kfta	kf	pos=va,comp=y,f=part
aDivAsEH	aDivAsa	pos=n,g=m,c=3,n=p
utkUjitEH	utkUjita	pos=n,g=n,c=3,n=p
paraBftasya	paraBfta	pos=n,g=m,c=6,n=s
mada	mada	pos=n,comp=y
Akulasya	Akula	pos=a,g=m,c=6,n=s
Srotra	Srotra	pos=n,comp=y
priyEH	priya	pos=a,g=m,c=3,n=p
maDukarasya	maDukara	pos=n,g=m,c=6,n=s
ca	ca	pos=i
gIta	gIta	pos=n,comp=y
nAdEH	nAda	pos=n,g=m,c=3,n=p

# id = Rtu.6.35
ramyaH	ramya	pos=a,g=m,c=1,n=s
pradoza	pradoza	pos=n,comp=y
samayaH	samaya	pos=n,g=m,c=1,n=s
sPuwa	sPuwa	pos=a,comp=y
candra	candra	pos=n,comp=y
BAsaH	BAsa	pos=n,g=m,c=1,n=s
puMskokilasya	puMskokila	pos=n,g=m,c=6,n=s
virutam	viruta	pos=n,g=n,c=1,n=s
pavanaH	pavana	pos=n,g=m,c=1,n=s
suganDiH	suganDi	pos=a,g=m,c=1,n=s
matta	mad	pos=va,comp=y,f=part
ali	ali	pos=n,comp=y
yUTa	yUTa	pos=n,comp=y
virutam	viruta	pos=n,g=n,c=1,n=s
niSi	niS	pos=n,g=f,c=7,n=s
sIDu	sIDu	pos=n,comp=y
pAnam	pAna	pos=n,g=n,c=1,n=s
sarvam	sarva	pos=n,g=n,c=1,n=s
rasAyanam	rasAyana	pos=n,g=n,c=1,n=s
idam	idam	pos=n,g=n,c=1,n=s
kusumAyuDasya	kusumAyuDa	pos=n,g=m,c=6,n=s

# id = Rtu.6.36
raktASoka	raktASoka	pos=n,comp=y
vikalpay	vikalpay	pos=va,comp=y,f=part
aDara	aDara	pos=n,comp=y
maDuH	maDu	pos=n,g=m,c=1,n=s
matta	mad	pos=va,comp=y,f=part
dvirePa	dvirePa	pos=n,comp=y
svanaH	svana	pos=n,g=m,c=1,n=s
kunda	kunda	pos=n,comp=y
ApIqa	ApIqa	pos=n,comp=y
viSudDa	viSuD	pos=va,comp=y,f=part
danta	danta	pos=n,comp=y
nikaraH	nikara	pos=n,g=m,c=1,n=s
protPulla	protPulla	pos=a,comp=y
padma	padma	pos=n,comp=y
AnanaH	Anana	pos=n,g=m,c=1,n=s
cUta	cUta	pos=n,comp=y
Amoda	Amoda	pos=n,comp=y
suganDi	suganDi	pos=a,comp=y
manda	manda	pos=a,comp=y
pavanaH	pavana	pos=n,g=m,c=1,n=s
SfNgAra	SfNgAra	pos=n,comp=y
dIkzA	dIkzA	pos=n,comp=y
guruH	guru	pos=n,g=m,c=1,n=s
kalpAntam	kalpAnta	pos=n,g=m,c=2,n=s
madana	madana	pos=n,comp=y
priyaH	priya	pos=a,g=m,c=1,n=s
diSatu	diS	pos=v,p=3,n=s,l=lot
vaH	tvad	pos=n,g=,c=4,n=p
puzpAgamo	puzpAgama	pos=n,g=m,c=1,n=s
maNgalam	maNgala	pos=n,g=n,c=2,n=s

# id = Rtu.6.37
malaya	malaya	pos=n,comp=y
pavana	pavana	pos=n,comp=y
vidDaH	vyaD	pos=va,g=m,c=1,n=s,f=part
kokila	kokila	pos=n,comp=y
AlApa	AlApa	pos=n,comp=y
ramyaH	ramya	pos=a,g=m,c=1,n=s
suraBi	suraBi	pos=a,comp=y
maDu	maDu	pos=n,comp=y
nizekAt	nizeka	pos=n,g=m,c=5,n=s
labDa	laB	pos=va,comp=y,f=part
ganDa	ganDa	pos=n,comp=y
prabanDaH	prabanDa	pos=n,g=m,c=1,n=s
viviDa	viviDa	pos=a,comp=y
maDupa	maDupa	pos=n,comp=y
yUTEH	yUTa	pos=n,g=m,c=3,n=p
vezwyamAnaH	vezw	pos=va,g=m,c=1,n=s,f=part
samantAd	samantAt	pos=i
Bavatu	BU	pos=v,p=3,n=s,l=lot
tava	tvad	pos=n,g=,c=6,n=s
vasantaH	vasanta	pos=n,g=m,c=1,n=s
SrezWa	SrezWa	pos=a,comp=y
kAlaH	kAla	pos=n,g=m,c=1,n=s
suKAya	suKa	pos=n,g=n,c=4,n=s

# id = Rtu.6.38
Amro	Amra	pos=n,g=m,c=1,n=s
maYjula	maYjula	pos=n,comp=y
maYjarI	maYjarI	pos=n,g=f,c=1,n=s
vara	vara	pos=a,comp=y
SaraH	Sara	pos=n,g=m,c=1,n=s
sat	as	pos=va,comp=y,f=part
kiMSukam	kiMSuka	pos=n,g=n,c=1,n=s
yat	yad	pos=n,g=n,c=1,n=s
DanuH	Danus	pos=n,comp=y
jyA	jyA	pos=n,g=f,c=1,n=s
yasya	yad	pos=n,g=m,c=6,n=s
ali	ali	pos=n,comp=y
kulam	kula	pos=n,g=n,c=1,n=s
kalaNka	kalaNka	pos=n,comp=y
rahitam	rahita	pos=a,g=n,c=1,n=s
Cattram	Cattra	pos=n,g=n,c=1,n=s
sitAMSuH	sitAMSu	pos=n,g=m,c=1,n=s
sitam	sita	pos=a,g=n,c=1,n=s
matta	mad	pos=va,comp=y,f=part
iBaH	iBa	pos=n,g=m,c=1,n=s
malaya	malaya	pos=n,comp=y
anilaH	anila	pos=n,g=m,c=1,n=s
paraBftA	paraBfta	pos=n,g=m,c=1,n=p
yad	yad	pos=n,comp=y
bandin	bandin	pos=n,g=m,c=1,n=p
lokajit	tad	pos=n,g=m,c=1,n=s
so	idam	pos=n,g=m,c=1,n=s
'yam	tvad	pos=n,g=,c=6,n=p
vitanuH	vitanu	pos=n,g=m,c=1,n=s
Badram	Badra	pos=n,g=n,c=2,n=s
vasanta	vasanta	pos=n,comp=y
anvitaH	anvita	pos=a,g=m,c=1,n=s

